"data_size","cache_size","unique_size","reads","writes","avg_step","avg_reuse_dist","sum_sqrt_count","sum_count","lis","lds","belady","lru","pivot","ld","mru"
13901,119,159,8589,5312,5.86961e+18,104.508,1087.08,13901,70,74,13740,13687,10715,11959,10483
87298,30,282,53981,33317,5.87091e+18,149.888,3115.86,87298,114,127,76200,63341,11661,22375,10716
34737,155,315,21539,13198,5.87223e+18,111.721,2280.82,34737,102,97,34376,34278,32452,32203,31659
60783,69,315,37549,23234,5.87336e+18,157.37,2990.23,60783,134,134,58821,57086,21686,24691,24776
81041,256,302,50003,31038,5.8707e+18,165.443,3111.85,81041,114,122,80739,80649,75215,78363,77163
54825,322,381,33932,20893,5.87087e+18,170.817,2962.43,54825,122,125,54444,54350,49245,52231,49496
45595,218,244,28141,17454,5.87004e+18,137.632,2213.73,45595,91,93,45351,45298,44755,45094,45166
78430,147,315,48401,30029,5.87258e+18,169.053,3318.67,78430,139,138,77769,77275,56285,58437,58248
30900,36,217,19094,11806,5.87033e+18,118.568,1904.64,30900,86,87,27411,23599,7214,9444,8333
28490,67,268,17693,10797,5.87754e+18,187.098,1992.46,28490,127,128,26689,25055,6425,10373,6030
80954,242,291,50026,30928,5.87025e+18,187.902,2994.83,80954,114,121,80663,80640,75804,78735,77976
32966,96,199,20357,12609,5.86943e+18,105.069,1935.75,32966,86,84,32715,32650,23225,22000,21513
19905,121,396,12325,7580,5.87072e+18,154.213,1862.37,19905,94,95,19398,19113,14136,13261,14327
31922,82,263,19778,12144,5.87211e+18,195.169,1912.75,31922,102,112,31062,30421,11227,13588,13415
74066,110,326,45853,28213,5.87305e+18,189.19,3225.7,74066,134,127,73250,72437,39943,38739,51852
15794,94,151,9686,6108,5.87069e+18,88.1499,1112.62,15794,69,74,15609,15486,11012,10301,13245
41067,38,216,25391,15676,5.87007e+18,163.483,1957.06,41067,97,103,38321,35547,8166,12315,10089
29378,74,195,18132,11246,5.87023e+18,100.543,1688.79,29378,80,80,29056,28828,15484,14999,13686
87958,237,293,54319,33639,5.87032e+18,162.417,3055.52,87958,110,118,87665,87626,84893,86518,86496
92485,212,298,57153,35332,5.87059e+18,200.811,3286.31,92485,126,129,92155,91906,82281,86481,85005
84786,45,306,53430,31356,5.89711e+18,236.706,3945.58,84786,211,206,63580,44325,12609,17412,14326
74736,139,315,46122,28614,5.87278e+18,171.858,3249.62,74736,138,136,73992,73365,48424,51698,48428
56336,117,266,34627,21709,5.87129e+18,177.48,2446.51,56336,117,120,55674,55050,29972,28168,30291
59107,65,270,36337,22770,5.87104e+18,165.026,2510.8,59107,115,121,57578,56454,13152,21355,18281
37910,81,286,23356,14554,5.8712e+18,108.692,2109.53,37910,84,89,37472,37251,21371,19851,23258
7694,69,150,4731,2963,5.86821e+18,80.0078,811.046,7694,63,65,7486,7373,4339,4532,4732
81546,173,302,50267,31279,5.87056e+18,161.177,3118.05,81546,114,121,81125,80882,61290,58688,63708
93579,181,277,57612,35967,5.87098e+18,188.462,3189.64,93579,136,141,93115,92685,65357,66839,70038
8353,128,208,5142,3211,5.87119e+18,86.0493,920.96,8353,71,73,8145,8074,6110,6157,5195
17445,230,255,10938,6507,5.89223e+18,187.735,1728.22,17445,139,138,17190,17150,15275,16114,15381
51738,37,290,32004,19734,5.87116e+18,174.059,2457.83,51738,108,122,47573,43458,8030,13210,9362
81091,23,316,50036,31055,5.87282e+18,175.711,3357.5,81091,139,140,64410,48559,10308,18703,10713
12066,42,197,7464,4602,5.86872e+18,97.7623,1210.43,12066,81,77,10974,9659,3648,4016,3482
55966,73,300,34493,21473,5.87149e+18,140.193,2624.15,55966,104,108,54955,54159,22247,24173,27145
36150,22,173,22328,13822,5.86986e+18,99.4396,1795.38,36150,80,86,28610,21547,5490,6804,7333
51897,160,224,32115,19782,5.87014e+18,133.072,2157.39,51897,95,104,51651,51533,40307,44080,47029
15116,126,216,9341,5775,5.86933e+18,97.885,1189.61,15116,75,74,14900,14821,9753,8632,7006
8258,105,126,5073,3185,5.8716e+18,59.4418,819.869,8258,61,64,8132,8132,7575,7824,7638
99412,89,273,61492,37920,5.87017e+18,183.258,3561.82,99412,115,118,98330,97683,46340,42287,50540
33447,60,261,20756,12691,5.87936e+18,192.958,2186.09,33447,146,138,30563,28197,6910,11963,7554
49503,140,269,30876,18627,5.88337e+18,211.755,2764.89,49503,169,169,48353,47221,28589,25779,30368
26611,19,159,16499,10112,5.87e+18,72.6579,1591.47,26611,76,79,18630,11999,3916,5955,4969
88575,15,285,55286,33289,5.88297e+18,245.485,3792.54,88575,198,201,54527,31282,7862,14046,5709
32666,181,250,20184,12482,5.86979e+18,128.726,2016.72,32666,95,96,32400,32246,27042,25561,29422
54975,240,250,33818,21157,5.87045e+18,157.212,2307.06,54975,105,110,54725,54725,53844,54516,54560
67140,100,260,41381,25759,5.87031e+18,129.164,2674.51,67140,96,105,66677,66287,34257,37684,40999
96674,16,302,59628,37046,5.87054e+18,166.916,3362.45,96674,118,128,67299,45559,11254,17419,8784
81718,189,307,50917,30801,5.88512e+18,236.207,3795.04,81718,201,191,81050,80228,56899,60387,59758
48211,188,265,29823,18388,5.87135e+18,164.856,2270.99,48211,109,118,47884,47687,37165,40759,40113
59512,103,203,36678,22834,5.87014e+18,123.464,2446.81,59512,89,94,59181,58941,35925,34157,39500
74524,179,381,46125,28399,5.87071e+18,151.96,3357.39,74524,118,115,74066,73812,65757,66663,66901
80453,272,289,49589,30864,5.87053e+18,145.538,2997.58,80453,102,107,80164,80163,79785,79989,80161
2292,219,1104,1430,862,5.50445e+18,190.497,1448.53,2292,80,91,1115,467,357,379,433
73482,76,273,45145,28337,5.87139e+18,156.129,2762.24,73482,118,125,72157,71194,19856,28948,29842
11150,37,250,6963,4187,5.88309e+18,143.804,1343.46,11150,105,106,8998,7207,2285,3269,2456
4765,109,209,2984,1781,5.87561e+18,110.35,782.458,4765,71,71,4480,4271,2384,2539,2444
3807,391,667,2362,1445,5.77554e+18,115.889,1195.73,3807,113,82,3140,3136,1849,1930,164
91819,200,316,56656,35163,5.87295e+18,191.248,3597.05,91819,148,150,91362,91001,75632,72948,72950
43917,302,306,27271,16646,5.8751e+18,223.947,2554.91,43917,135,142,43611,43610,43583,43589,43605
86355,36,275,53154,33201,5.8743e+18,226.308,3281.74,86355,164,160,77499,69052,11519,23059,15202
87938,260,426,55073,32865,5.88819e+18,241.197,4386.14,87938,204,213,87496,87391,54561,53285,33769
83917,255,426,52325,31592,5.8819e+18,198.463,4462.52,83917,186,189,83477,83380,66242,65215,53374
26549,229,273,16475,10074,5.87483e+18,193.066,1854.32,26549,108,104,26274,26196,24994,25531,25813
52831,17,426,33117,19714,5.88843e+18,229.437,3629.81,52831,183,186,30241,15360,4357,7267,1902
21429,134,204,13249,8180,5.87055e+18,101.496,1585.62,21429,83,83,21225,21149,18721,18471,18916
66239,105,279,40934,25305,5.87002e+18,159.649,2905.38,66239,106,105,65570,65169,37520,32945,35849
25926,237,250,15970,9956,5.87086e+18,116.418,1693.19,25926,86,92,25676,25669,24805,25380,25254
12636,116,143,7810,4826,5.87092e+18,68.7282,1088.17,12636,71,71,12493,12493,11647,12045,10983
87295,276,411,54120,33175,5.87758e+18,183.894,4243.35,87295,176,178,86884,86788,73088,73903,62738
14773,116,135,9077,5696,5.86884e+18,86.7935,1074.91,14773,65,71,14638,14590,13401,14100,14151
17644,96,145,10868,6776,5.86858e+18,90.7,1198.78,17644,69,72,17473,17401,13665,13289,14993
35211,129,217,21654,13557,5.86995e+18,128.579,1786.73,35211,87,91,34943,34730,25359,24043,30441
23475,211,258,14546,8929,5.8781e+18,176.133,1800.79,23475,117,123,23184,23022,19661,21088,20341
64156,239,259,39534,24622,5.87021e+18,133.348,2598.2,64156,95,101,63897,63874,61568,62250,63568
51254,62,226,31539,19715,5.87007e+18,130.775,2168.45,51254,94,99,50295,49713,13043,19672,21612
76077,99,289,47886,28191,5.89592e+18,234.685,3710.21,76077,206,202,70005,62585,27520,26829,31493
47413,120,307,29301,18112,5.87574e+18,227.155,2688.6,47413,149,153,46241,44958,23212,23400,25516
18563,137,154,11435,7128,5.87013e+18,82.1187,1288.45,18563,70,72,18409,18408,17809,18167,17842
4499,63,133,2786,1713,5.86931e+18,58.9509,627.014,4499,54,58,4349,4290,2823,2787,3004
54230,24,226,33542,20688,5.87022e+18,156.129,2241.36,54230,99,105,45216,34833,6982,12317,8829
95922,109,307,59809,36113,5.88606e+18,239.748,4106.54,95922,205,203,91572,86084,37417,38650,39347
46772,163,177,28890,17882,5.87013e+18,104.007,2100.74,46772,82,91,46595,46586,45371,45824,45816
62859,190,220,38835,24024,5.86973e+18,134.33,2625.32,62859,92,91,62639,62625,61530,62136,62361
95326,336,411,59029,36297,5.87378e+18,183.796,4246.68,95326,156,144,94915,94849,92423,92779,90650
79727,65,298,49296,30431,5.87052e+18,198.286,3058.18,79727,117,124,78045,76666,18254,28630,28798
8047,84,140,4940,3107,5.87183e+18,80.8699,783.543,8047,61,63,7877,7775,5701,5261,6704
23122,147,189,14237,8885,5.8701e+18,88.9335,1509.86,23122,80,82,22933,22894,20344,21442,19479
31945,27,162,19652,12293,5.86977e+18,116.939,1629.28,31945,79,85,27248,21308,5238,7214,7226
24345,51,257,15158,9187,5.87965e+18,196.591,1853.84,24345,130,127,21789,20205,4589,7679,4491
25645,109,307,15798,9847,5.873e+18,175.401,1910.17,25645,106,102,25064,24512,14151,14034,15143
55745,102,230,34469,21276,5.87039e+18,122.337,2505.03,55745,90,90,55410,55285,37928,35176,36656
60689,186,266,37359,23330,5.871e+18,182.84,2528.5,60689,117,126,60331,60072,46166,51153,49590
83405,312,342,51530,31875,5.87401e+18,191.27,3640.73,83405,147,142,83063,83029,82345,82602,81743
26495,220,247,16406,10089,5.87013e+18,143.086,1897.67,26495,96,94,26248,26211,25754,26039,26003
81127,259,273,50291,30836,5.87371e+18,229.994,3191.74,81127,163,162,80846,80764,75077,78055,79917
5388,119,135,3343,2045,5.86785e+18,61.6388,662.585,5388,58,60,5253,5253,4867,5070,4735
15883,32,240,9945,5938,5.88727e+18,165.742,1551.41,15883,129,117,12114,9140,2140,3727,2380
97074,276,342,60552,36522,5.88398e+18,196.612,4373.34,97074,191,202,96732,96642,83878,86680,80421
41808,249,290,25846,15962,5.8715e+18,168.571,2275.52,41808,108,116,41518,41485,35104,38854,35168
58172,45,225,35838,22334,5.86997e+18,134.614,2404.88,58172,93,97,55746,52934,12487,19874,19838
57465,117,327,35682,21783,5.87851e+18,167.357,3224.46,57465,149,155,56134,54661,35885,37246,34620
62281,144,315,38651,23630,5.87978e+18,195.855,3260.45,62281,167,172,61148,60004,32343,32480,27619
82383,22,282,51088,31295,5.87345e+18,211.629,3196.09,82383,151,156,65349,50803,9573,19604,8147
74279,171,397,46005,28274,5.87241e+18,174.419,3648.04,74279,145,140,73684,73204,59913,60297,58354
39673,58,220,24408,15265,5.87012e+18,136.626,1900.3,39673,90,95,38721,37961,11825,15429,16391
82585,148,230,50881,31704,5.87026e+18,143.05,2918.15,82585,96,102,82337,82166,63118,63602,70311
74798,233,274,46164,28634,5.8738e+18,208.933,3080.71,74798,163,152,74478,74287,64247,69712,70491
49766,26,196,30725,19041,5.86988e+18,100.035,2286.41,49766,84,84,40506,29404,8582,11584,11039
34254,163,253,21189,13065,5.87077e+18,170.572,1899.5,34254,105,103,33941,33751,23704,22746,22197
50772,11,264,31457,19315,5.87113e+18,159.093,2324.19,50772,111,116,29410,19460,4740,7356,2054
89479,32,281,55461,34018,5.87305e+18,206.903,3317.66,89479,155,160,78347,66105,11801,22151,10585
33422,193,262,20549,12873,5.87231e+18,169.101,1947.28,33422,109,115,33145,32987,26526,29287,24321
13922,34,145,8600,5322,5.87035e+18,69.4225,1131.75,13922,74,75,12213,9647,4492,4856,5314
22001,37,134,13562,8439,5.86979e+18,68.1942,1367.11,22001,73,74,20096,17814,6432,7895,6556
83757,335,381,51825,31932,5.87076e+18,177.766,3476.61,83757,133,136,83376,83309,73544,79425,75019
2274,31,62,1412,862,5.86783e+18,53.949,329.494,2274,47,46,1989,1618,981,959,1314
78074,106,303,48275,29799,5.87092e+18,159.762,3024.94,78074,116,126,77283,76550,38526,41640,40752
81984,49,285,51139,30845,5.88173e+18,231.256,3612.26,81984,196,185,72211,63253,14432,21979,17616
27024,166,178,16646,10378,5.87021e+18,79.6914,1647.34,27024,75,81,26846,26844,26649,26732,26587
76124,287,335,47642,28482,5.88778e+18,201.201,3902.83,76124,190,198,75789,75731,66184,68308,66408
26194,9,190,16106,10088,5.87024e+18,110.155,1568.93,26194,74,80,12785,0,2098,2163,1011
75471,112,285,46507,28964,5.87013e+18,137.228,2910.95,75471,99,104,75052,74647,43626,43670,44313
11537,566,3425,7239,4298,5.59055e+18,795.297,5273.21,11537,189,206,7025,4484,2531,2582,2566
49633,42,257,30564,19069,5.87021e+18,129.834,2304.77,49633,93,94,46991,43418,10367,15621,13434
76766,150,321,48382,28384,5.89747e+18,232.699,3790.67,76766,205,200,74900,71607,40460,39268,48930
58083,188,226,35926,22157,5.87023e+18,143.756,2294.99,58083,98,106,57842,57766,50186,54743,56493
29150,48,273,18111,11039,5.87694e+18,161.896,2038.1,29150,124,124,26648,24391,7295,9972,8109
65518,257,260,40402,25116,5.86996e+18,114.118,2659.31,65518,96,101,65258,65258,65114,65143,65255
15055,175,183,9258,5797,5.86978e+18,87.4188,1114.4,15055,72,73,14872,14872,14841,14855,14872
81222,9,235,50185,31037,5.87018e+18,147.136,3033.74,81222,96,93,37007,0,5855,6669,4564
42858,109,196,26445,16413,5.87e+18,98.3359,2076.85,42858,84,89,42614,42454,30737,28339,30586
8891,151,244,5511,3380,5.86945e+18,122.077,1096.26,8891,78,78,8633,8505,7646,7775,7768
14698,103,142,9044,5654,5.86876e+18,85.5518,1126.64,14698,67,67,14543,14491,11249,11258,11702
65905,4,268,40661,25244,5.87019e+18,147.633,2638.31,65905,103,100,15620,0,4,1523,1352
62574,7,321,38711,23863,5.87043e+18,152.849,2886.59,62574,101,104,22921,0,2466,4090,2959
54233,146,262,33561,20672,5.87127e+18,164.055,2397.64,54233,110,119,53823,53515,32779,29068,32320
14097,276,376,8749,5348,5.8727e+18,132.878,1690.84,14097,98,97,13721,13659,13037,13123,12631
20513,139,140,12727,7786,5.86999e+18,71.1027,1332.75,20513,71,73,20373,20373,20232,20263,20298
36077,64,273,22409,13668,5.87511e+18,173.675,2211.7,36077,129,127,34181,32572,10517,13603,11839
82256,119,342,51346,30910,5.88479e+18,194.097,4078.56,82256,186,195,79593,75896,44311,45936,39720
97037,80,293,59940,37097,5.87047e+18,194.051,3279.56,97037,121,126,95697,94645,26663,36777,26413
75938,60,328,47080,28858,5.87809e+18,188.866,3625.56,75938,166,175,70667,65989,20000,27393,21626
13683,79,149,8393,5290,5.86983e+18,82.0427,1030,13683,66,72,13468,13325,8288,7790,9920
53475,280,314,32989,20486,5.87114e+18,149.985,2616.89,53475,102,105,53161,53146,52998,53030,52886
95351,245,352,58749,36602,5.87036e+18,174.893,3504.16,95351,121,121,94999,94804,78464,84756,81842
10508,131,214,6445,4063,5.86945e+18,97.9492,1011.72,10508,72,75,10294,10219,7012,6710,5505
83065,264,279,51317,31748,5.86998e+18,152.751,3182.75,83065,109,114,82786,82759,81645,82224,78644
17709,117,142,10963,6746,5.87029e+18,96.098,1194.02,17709,67,71,17565,17506,15769,16623,17178
56160,84,290,34729,21431,5.8711e+18,164.823,2579.09,56160,112,120,55147,54266,17695,24337,23067
76911,253,288,47443,29468,5.8701e+18,135.738,2935.08,76911,105,106,76623,76619,74961,75969,75419
42404,166,287,26586,15818,5.89194e+18,214.072,2785.94,42404,180,175,41680,40798,25343,23856,22505
25668,209,260,16020,9648,5.88696e+18,220.057,2065.53,25668,143,148,25345,25154,20629,21710,20198
13963,10,212,8593,5370,5.86915e+18,82.811,1138.05,13963,73,76,7551,5206,1484,1967,1656
28057,181,195,17324,10733,5.86949e+18,110.672,1654.93,28057,79,84,27862,27856,26815,27522,27394
25591,10,282,16048,9543,5.89205e+18,201.527,2193.02,25591,155,153,10705,5633,1270,2104,952
1842,67,71,1129,713,5.86578e+18,56.6287,320.32,1842,47,46,1771,1765,1745,1758,1756
8797,151,224,5434,3363,5.87206e+18,97.3718,1000.33,8797,77,79,8554,8501,6445,6777,6751
28400,201,219,17566,10834,5.87047e+18,165.529,1636.61,28400,92,94,28172,28097,25806,27084,27139
39792,199,260,24637,15155,5.87723e+18,201.597,2328.37,39792,149,139,39430,39113,32312,35170,34007
35036,271,274,21646,13390,5.87474e+18,195.852,2188.8,35036,124,126,34762,34758,34628,34706,34474
91017,141,228,56115,34902,5.86981e+18,140.466,3043.08,91017,98,101,90755,90530,67814,67461,74496
73653,249,342,45458,28195,5.87046e+18,141.813,3130.32,73653,115,111,73311,73196,66684,68899,67083
50251,75,237,31051,19200,5.8702e+18,121.928,2198.89,50251,91,100,49576,49155,16196,21454,24603
16706,133,203,10328,6378,5.86894e+18,108.592,1411.71,16706,79,81,16503,16428,14131,13802,13780
70406,296,317,44113,26293,5.88947e+18,207.962,3686.24,70406,192,198,70089,70074,66312,68521,67525
19572,161,216,12095,7477,5.87028e+18,106.268,1352.82,19572,79,78,19356,19278,17846,18305,18771
76091,274,275,46893,29198,5.87657e+18,218.746,3183.18,76091,164,167,75816,75799,75806,75807,75816
2456,53,126,1504,952,5.86916e+18,49.8575,466.357,2456,48,51,2313,2227,1341,1391,1242
67436,112,314,41642,25794,5.87194e+18,199.309,3071.16,67436,129,123,66596,65733,32813,31130,33308
51204,236,264,31457,19747,5.87165e+18,176.667,2340.03,51204,119,123,50940,50878,45324,48521,47525
3165,31,212,1975,1190,5.88463e+18,113.147,691.45,3165,71,64,2311,1734,579,932,955
15690,159,217,9704,5986,5.87103e+18,96.2677,1235.01,15690,77,79,15473,15436,12830,14119,12797
62219,219,298,38413,23806,5.87084e+18,150.095,2752.94,62219,109,112,61899,61768,56927,59325,56018
94329,25,426,58919,35410,5.88488e+18,213.187,4752.2,94329,199,207,66002,42034,11493,18189,7301
48417,183,194,29896,18521,5.86977e+18,102.587,2263.45,48417,86,86,48223,48219,48012,48112,48129
46284,18,182,28606,17678,5.86976e+18,115.313,2133.03,46284,82,85,32862,20769,5901,7839,6096
83388,151,296,51556,31832,5.87065e+18,150.645,3092.31,83388,117,125,82935,82624,49815,46288,47428
7644,195,227,4726,2918,5.87467e+18,96.9793,965.218,7644,75,75,7417,7404,6450,7000,6592
29869,276,282,18747,11122,5.89165e+18,206.492,2327.11,29869,163,154,29587,29575,29574,29575,29427
75531,258,381,46745,28786,5.87095e+18,172.489,3304.99,75531,130,135,75150,75035,55775,59737,55851
13766,11,169,8479,5287,5.87068e+18,75.2463,1092.01,13766,75,75,7308,4599,1497,1652,1681
77645,73,268,48075,29570,5.87171e+18,194.975,2907.7,77645,131,141,75724,74309,18417,29031,29059
7057,2,184,4337,2720,5.86856e+18,84.057,795.009,7057,62,62,650,0,92,0,57
38184,105,284,23775,14409,5.88343e+18,200.324,2543.98,38184,152,158,36489,34720,18445,19431,17748
21763,139,270,13460,8303,5.87579e+18,129.375,1779.31,21763,112,112,21327,21013,16561,16749,16155
48524,115,264,30048,18476,5.87218e+18,193.949,2349.2,48524,124,127,47766,46994,23180,22313,24007
4957,101,114,3059,1898,5.86827e+18,51.975,598.613,4957,52,55,4843,4843,4636,4760,4760
34549,65,260,21644,12905,5.89034e+18,220.705,2411.49,34549,168,168,30052,25590,7293,11240,10433
62585,220,326,38857,23728,5.87888e+18,173.833,3361.86,62585,160,169,62209,62002,50938,51218,47428
41714,146,180,25662,16052,5.86963e+18,115.86,1993.96,41714,84,85,41534,41488,39913,40724,39924
48318,115,260,29775,18543,5.87239e+18,208.526,2379.32,48318,129,128,47432,46496,23185,23040,22475
35945,281,303,22567,13378,5.89307e+18,181.69,2698.59,35945,165,170,35642,35617,34273,34956,34217
26480,211,258,16270,10210,5.87288e+18,138.962,1728.43,26480,99,97,26212,26123,23079,24723,23258
15282,160,238,9529,5753,5.88554e+18,161.931,1518.12,15282,127,115,14912,14633,11112,11333,11182
27621,123,162,17102,10519,5.86976e+18,107.378,1504.89,27621,73,83,27451,27334,22822,23537,25221
42502,194,290,26281,16221,5.87179e+18,163.619,2294.67,42502,108,113,42179,42012,30333,30285,28695
75102,197,271,46809,28293,5.88538e+18,226.117,3482.84,75102,200,190,74536,73755,57582,62436,61779
80359,138,267,49745,30614,5.87101e+18,181.938,2904.65,80359,129,134,79733,79109,45668,42055,50041
72989,120,216,45011,27978,5.87009e+18,120.943,2752.91,72989,91,95,72703,72483,50065,45648,46316
35582,26,253,22015,13567,5.87141e+18,168.653,1927.09,35582,105,103,30260,24492,4094,8690,3126
26810,68,258,16665,10145,5.87718e+18,187.79,1909.89,26810,124,127,25112,23582,7137,10658,9062
24786,230,254,15249,9537,5.87127e+18,169.858,1658.43,24786,92,100,24532,24496,24172,24390,24241
68363,45,279,42247,26116,5.87036e+18,150.436,2861.72,68363,99,107,65010,61036,13749,21503,16238
35216,268,301,21758,13458,5.87554e+18,171.601,2325.74,35216,131,129,34915,34888,30894,33127,32529
11180,49,128,6876,4304,5.869e+18,66.3676,958.701,11180,63,63,10886,10537,5190,5329,4541
92584,194,216,57143,35441,5.87006e+18,133.451,3108.38,92584,93,100,92368,92350,86618,89767,89659
57433,218,280,35775,21658,5.88108e+18,197.551,2976.27,57433,170,169,57092,56857,47240,51820,47379
51747,109,342,31908,19839,5.87042e+18,160.088,2707.08,51747,113,108,51079,50610,27732,25750,27089
51685,214,266,31812,19873,5.87117e+18,162.486,2344.41,51685,108,119,51406,51258,43942,48153,45622
82535,73,381,51043,31492,5.87062e+18,155.857,3497.87,82535,126,119,81011,79683,36158,38795,39035
12924,88,154,7974,4950,5.86777e+18,64.9458,1086.51,12924,69,70,12770,12744,9043,8485,7446
75795,263,272,47189,28606,5.88371e+18,223.786,3470.78,75795,193,192,75523,75523,74846,75306,74880
76246,97,316,46914,29332,5.87188e+18,188.698,3137.63,76246,123,126,75322,74434,37632,36000,40983
83589,189,225,51594,31995,5.87009e+18,130.756,3020,83589,90,92,83364,83346,80616,81813,82572
50893,25,257,31425,19468,5.8703e+18,150.957,2534.64,50893,101,100,40203,28518,7638,10214,7273
95438,94,279,58645,36793,5.87104e+18,165.218,3188.68,95438,127,132,94300,93156,37521,40837,46739
3493,5,187,2164,1329,5.86982e+18,80.438,643.313,3493,56,62,923,0,21,165,110
57401,59,286,35641,21760,5.88031e+18,206.244,3006.97,57401,169,177,52344,48154,13703,20294,15873
35123,245,287,22116,13007,5.89781e+18,211.234,2522.14,35123,173,174,34836,34804,30189,31930,30708
80395,62,274,49493,30902,5.87054e+18,161.504,2884.14,80395,121,126,78462,77121,18789,28059,26817
20453,15,218,12580,7873,5.86983e+18,110.167,1379.57,20453,79,83,14127,8565,2676,3833,2607
80484,38,277,50130,30354,5.8789e+18,228.771,3450.24,80484,187,179,69408,59677,11844,19974,13010
9493,206,249,5900,3593,5.87762e+18,147.565,1201.55,9493,97,90,9244,9168,8469,8603,8456
26622,59,174,16447,10175,5.86964e+18,81.486,1641.59,26622,79,78,26145,25510,12261,12830,14843
98902,115,227,61059,37843,5.86996e+18,146.392,3259.24,98902,97,102,98533,98218,58947,54360,56788
7247,154,210,4462,2785,5.87177e+18,92.8743,859.874,7247,68,68,7037,7000,5649,6256,5044
62805,88,219,38847,23958,5.8701e+18,133.02,2614.4,62805,88,90,62412,62261,33576,33007,35984
19519,172,245,12271,7248,5.89151e+18,177.572,1793.27,19519,139,139,19137,18776,13526,14086,13377
14322,4,80,8908,5414,5.86992e+18,69.4742,912.162,14322,68,71,3255,0,4,479,632
29710,139,261,18539,11171,5.88251e+18,208.477,2110.21,29710,149,140,28899,28074,17536,15704,19233
75888,157,352,46745,29143,5.87022e+18,170.601,3122.75,75888,113,118,75429,75131,41165,39364,52616
98387,106,276,60724,37663,5.87381e+18,229.368,3546.8,98387,173,165,96210,93890,42173,42850,37951
93380,193,411,57787,35593,5.87889e+18,236.691,4326.95,93380,187,194,92591,91888,51731,50676,41956
32360,150,257,19893,12467,5.87216e+18,170.151,1896.53,32360,99,107,31974,31757,23495,24228,25684
75336,146,258,46433,28903,5.87033e+18,144.142,2803.82,75336,102,110,75041,74810,59812,61363,67280
3534,73,111,2167,1367,5.86959e+18,60.5546,495.675,3534,49,51,3416,3383,2797,2844,3033
57607,238,381,35661,21946,5.87132e+18,172.762,2941.4,57607,123,128,57224,57100,41447,37866,40363
24232,250,342,14915,9317,5.87072e+18,137.344,1831.73,24232,89,97,23890,23801,19074,20894,17607
73080,338,352,45022,28058,5.87042e+18,168.365,3003.25,73080,109,116,72728,72728,72719,72717,72669
73847,341,411,45755,28092,5.8734e+18,165.654,3726.03,73847,136,130,73436,73390,71978,72074,70842
6541,49,218,4053,2488,5.87832e+18,101.57,882.848,6541,78,76,5878,5455,1694,2509,2539
16288,19,247,10128,6160,5.87039e+18,109.876,1458.94,16288,85,91,11073,7040,2361,2966,2239
93121,132,271,57411,35710,5.87011e+18,150.252,3112.49,93121,110,113,92736,92409,58881,61487,71644
56256,72,215,34686,21570,5.87008e+18,122.226,2436.65,56256,89,93,55671,55175,26100,27237,29278
73843,79,229,45481,28362,5.87003e+18,129.848,2706.79,73843,99,102,73116,72601,32252,32643,41726
59994,43,315,37059,22935,5.8735e+18,157.943,2977.01,59994,134,134,55459,50307,12177,18837,15407
81058,212,274,50189,30869,5.87223e+18,201.851,3035.28,81058,142,145,80714,80417,66202,73613,67941
48377,127,211,29875,18502,5.86979e+18,128.47,2196.49,48377,87,91,48134,47953,36357,39294,37878
72818,41,328,45193,27625,5.87721e+18,177.568,3550.78,72818,156,165,64973,56334,13437,21189,13683
28806,200,220,17812,10994,5.87007e+18,122.868,1638.26,28806,86,90,28586,28573,25821,27417,27665
16627,157,187,10225,6402,5.87052e+18,107.458,1287.33,16627,73,79,16440,16406,14206,15462,14315
19964,120,177,12338,7626,5.87008e+18,83.9176,1385.84,19964,70,74,19787,19737,14043,14758,13495
38699,105,182,23879,14820,5.86986e+18,118.956,1952.32,38699,81,83,38464,38303,25894,25068,27131
38660,232,269,24018,14642,5.87531e+18,165.224,2268.32,38660,130,129,38381,38328,33073,36156,33849
93057,154,271,57562,35495,5.87002e+18,186.956,3489.06,93057,118,120,92526,91861,69383,63178,75652
4458,38,115,2740,1718,5.86864e+18,61.651,575.947,4458,50,52,4184,3953,1463,1779,1492
88135,1123,5541,55519,32616,5.82805e+18,349.62,11332.7,88135,349,265,82504,79619,20685,43326,8937
8560,122,225,5336,3224,5.87287e+18,80.0421,1012.35,8560,73,74,8303,8160,7032,7131,6846
94462,68,229,58278,36184,5.87028e+18,140.682,3193.82,94462,92,97,93546,92403,34571,37190,41299
38888,145,199,23988,14900,5.86996e+18,101.523,1991.31,38888,83,90,38689,38635,31200,33503,29768
27443,56,217,16975,10468,5.87098e+18,164.536,1613.77,27443,87,95,26561,25936,7320,10443,10723
95520,142,307,59476,36044,5.88464e+18,246.42,4052.03,95520,202,200,93450,90903,50971,46654,53064
22485,17,134,13913,8572,5.86981e+18,67.6696,1382.28,22485,72,75,15236,9286,3259,4613,4233
50953,202,274,31453,19500,5.87388e+18,201.551,2577.07,50953,128,142,50573,50291,40591,44002,39785
89119,162,411,55231,33888,5.87492e+18,166.87,4162.2,89119,159,151,88415,87722,71334,71992,71538
58280,34,288,35888,22392,5.87081e+18,167.343,2573.69,58280,114,123,52549,44947,8737,14038,8376
40332,164,297,24912,15420,5.87088e+18,139.809,2230.57,40332,92,95,40035,39957,38256,38781,38507
88683,110,285,55142,33541,5.87719e+18,222.01,3591.65,88683,185,180,86230,83346,38856,38678,45130
65802,155,342,41027,24775,5.88447e+18,163.704,3678.68,65802,172,179,64893,63771,46506,45751,41513
38145,271,298,23549,14596,5.8713e+18,128.81,2167.12,38145,101,102,37847,37816,34467,36454,36060
92175,195,271,56825,35350,5.86986e+18,150.587,3106.54,92175,110,112,91904,91783,80471,85821,86932
46331,183,221,28653,17678,5.87023e+18,138.016,2034.72,46331,93,103,46104,46018,40500,43852,44614
69890,282,301,43051,26839,5.87098e+18,161.403,2885.18,69890,112,117,69589,69562,68427,69069,69089
98631,394,426,61588,37043,5.88425e+18,214.178,4834.67,98631,201,207,98205,98166,94404,96519,90059
60157,10,315,37179,22978,5.87324e+18,159.759,2964.15,60157,123,127,30640,20473,5208,5849,2590
57843,36,260,35678,22165,5.8702e+18,119.319,2496.04,57843,96,100,53009,47830,10478,12843,13351
42782,25,285,26869,15913,5.89333e+18,217.684,2783.11,42782,186,176,27876,16526,4400,7545,4460
28060,134,220,17259,10801,5.87008e+18,125.735,1620.43,28060,86,89,27822,27664,18881,16912,18605
8314,115,144,5108,3206,5.87164e+18,83.0852,812.862,8314,60,64,8170,8148,6897,7502,7179
49580,87,300,30597,18983,5.87108e+18,138.046,2498.27,49580,100,103,48851,48297,24236,25423,28507
49542,89,199,30581,18961,5.87003e+18,127.546,2220.54,49542,85,90,49151,48884,28103,26597,33020
91301,35,261,56428,34873,5.87004e+18,173.794,3333.33,91301,107,107,81446,68099,16500,25841,18433
15798,129,252,9820,5978,5.88252e+18,195.949,1532.59,15798,112,114,15192,14611,9166,8698,9722
63077,267,309,39130,23947,5.87938e+18,182.724,3274.67,63077,171,175,62768,62725,55857,59642,55966
42971,39,411,26652,16319,5.87669e+18,178.08,3097.89,42971,139,133,36837,30987,8115,11461,7944
81665,174,302,50341,31324,5.87052e+18,161.814,3121.71,81665,114,123,81247,81002,61243,58513,63675
2649,73,76,1635,1014,5.87193e+18,61.627,394.759,2649,49,53,2573,2548,2499,2540,2573
78811,24,282,48878,29933,5.87342e+18,215.938,3145.72,78811,149,157,64068,49087,9405,18560,9510
10426,192,242,6414,4012,5.87299e+18,82.4237,1083.7,10426,66,70,10184,10174,10100,10103,10096
44587,143,264,27482,17105,5.87238e+18,201.886,2259.62,44587,124,117,44044,43741,25002,23014,23941
22718,94,217,14062,8656,5.87054e+18,103.591,1447.68,22718,81,81,22413,22191,14069,14191,16902
33861,193,226,20940,12921,5.87015e+18,127.826,1774.01,33861,86,93,33635,33617,28440,31525,31150
54942,105,342,33896,21046,5.87153e+18,144.551,2800.38,54942,111,110,54314,53715,32763,30172,33228
4663,181,258,2888,1775,5.87034e+18,74.4885,889.04,4663,76,72,4405,4405,4026,4022,3889
9485,41,193,5838,3647,5.86845e+18,73.3643,955.705,9485,67,70,8873,8042,3459,4236,3155
19551,48,145,12018,7533,5.86955e+18,98.4405,1255.83,19551,70,76,18936,18369,6465,8146,8312
8344,156,191,5138,3206,5.86786e+18,76.9643,896.103,8344,65,70,8153,8117,7861,7973,7872
25725,42,248,16203,9522,5.89851e+18,191.554,2067.42,25725,169,154,18977,12976,3845,5652,5153
59494,34,216,36651,22843,5.87016e+18,126.447,2502.8,59494,91,94,53468,43943,11626,15789,13254
11575,23,74,7213,4362,5.8707e+18,68.5521,805.926,11575,65,67,8927,6332,2599,3545,3861
25962,197,253,16224,9738,5.88698e+18,203.158,2032.9,25962,148,146,25639,25370,21726,23237,22835
69128,194,232,42716,26412,5.86987e+18,157.856,2798.06,69128,94,95,68896,68842,66535,67914,68298
79662,208,277,49374,30288,5.8732e+18,201.609,3131.74,79662,152,156,79241,78870,64511,70537,63704
16675,176,217,10253,6422,5.87035e+18,91.7763,1263.55,16675,76,82,16458,16436,14607,15687,14544
9362,27,239,5770,3592,5.87137e+18,76.4602,1039.53,9362,66,70,7811,5908,1884,2510,2213
89920,110,222,55519,34401,5.87009e+18,154.052,3140.93,89920,98,96,89535,89272,54519,51591,61609
93626,211,411,58021,35605,5.87633e+18,182.229,4341.98,93626,169,169,93124,92845,78833,76936,72803
85550,267,294,52708,32842,5.87019e+18,158.274,3025.71,85550,107,114,85256,85250,82931,84102,84620
43948,54,188,27149,16799,5.87038e+18,112.81,1991.68,43948,85,91,43012,41740,11638,16021,17059
80721,3929,5501,50880,29841,5.82372e+18,362.514,11060.3,80721,344,264,75220,75211,57255,62519,15727
58179,49,230,35975,22204,5.87008e+18,133.346,2574.68,58179,91,91,55616,51678,18677,21397,23102
97698,26,270,60442,37256,5.87006e+18,193.147,3637.45,97698,128,132,76554,52962,16624,22671,16043
20939,76,162,12958,7981,5.86921e+18,103.503,1313.22,20939,75,77,20641,20485,11229,11259,12924
18910,26,185,11651,7259,5.86942e+18,68.6504,1287.83,18910,75,77,15170,10738,3483,5317,2731
39054,113,173,24167,14887,5.87041e+18,96.3079,1951.86,39054,82,80,38865,38829,30718,29484,28187
82592,17,285,51418,31174,5.88017e+18,241.08,3568.02,82592,190,190,55828,35993,8276,14983,4190
18238,12,284,11332,6906,5.88057e+18,126.64,1772.58,18238,109,110,9738,5382,1680,1556,407
98169,73,281,60484,37685,5.8708e+18,162.478,3283.75,98169,123,131,96455,95241,22825,35952,32836
75712,195,215,46679,29033,5.87e+18,135.32,2793.89,75712,92,96,75497,75483,73031,74069,74559
95119,145,273,59027,36092,5.87499e+18,238.19,3530.82,95119,175,173,93838,92777,52689,46072,51219
53475,119,244,33048,20427,5.8703e+18,135.989,2369.59,53475,91,95,53171,52925,38775,36982,44106
95633,324,397,59226,36407,5.87296e+18,211.458,3932.59,95633,154,167,95236,95118,80232,87967,73464
66651,239,300,41200,25451,5.87102e+18,159.652,2844.05,66651,113,122,66351,66270,57429,62154,56547
45589,228,342,28190,17399,5.87349e+18,130.668,2724.26,45589,117,107,45247,45203,43749,43786,42631
78875,115,222,48700,30175,5.87004e+18,138.711,2922.7,78875,92,93,78559,78358,51606,49608,58220
43817,210,261,26947,16870,5.87287e+18,202.213,2241.36,43817,122,122,43504,43328,36324,40184,36791
44058,199,224,27108,16950,5.86981e+18,126.838,2011.12,44058,92,102,43834,43821,38241,41467,41191
89574,25,328,55470,34104,5.87688e+18,207.083,3885.57,89574,175,181,69945,50793,11509,19987,9387
11677,128,151,7196,4481,5.8687e+18,67.7845,956.293,11677,72,74,11526,11505,11433,11450,11368
99635,253,307,62056,37579,5.8848e+18,249.068,4158.17,99635,205,203,99291,99105,90123,94952,94787
69539,17,281,43118,26421,5.87399e+18,218.146,2985.11,69539,149,157,49802,33953,7633,13176,4449
46396,253,285,28887,17509,5.87962e+18,226.443,2686.43,46396,156,145,46105,46019,43944,44648,45311
86346,159,303,53369,32977,5.87076e+18,158.689,3168.02,86346,118,128,85884,85593,57802,53147,62555
58778,75,266,36192,22586,5.87122e+18,164.593,2485.59,58778,111,122,57566,56730,16937,24518,21493
27651,198,251,17118,10533,5.87216e+18,131.903,1729.52,27651,98,99,27386,27290,22544,25208,24134
81240,139,289,50071,31169,5.87041e+18,133.399,3002.5,81240,102,108,80909,80641,50504,45345,49253
92380,68,227,57056,35324,5.87005e+18,152.216,3152.34,92380,97,102,91402,90230,29689,33826,31045
26941,130,217,16565,10376,5.86992e+18,108.555,1561.12,26941,80,87,26695,26569,20736,19983,23792
52444,180,195,32245,20199,5.86996e+18,107.809,2238.17,52444,87,92,52249,52249,51839,52008,51605
82083,283,285,51216,30867,5.88283e+18,241.793,3651.54,82083,199,195,81798,81786,81650,81655,81798
2556,67,102,1572,984,5.8693e+18,51.4085,438.416,2556,49,48,2454,2437,2196,2153,2060
24697,245,249,15208,9489,5.87028e+18,126.687,1615.38,24697,85,86,24448,24448,24216,24408,24388
46645,112,180,28801,17844,5.87009e+18,108.2,2143.7,46645,82,83,46433,46308,33675,33044,37692
4115,10,71,2536,1579,5.87032e+18,60.2066,468.031,4115,55,55,2023,1352,465,539,698
55496,171,279,34285,21211,5.87007e+18,165.063,2698.12,55496,105,100,55133,54916,50060,50520,51396
46136,271,307,28595,17541,5.87919e+18,221.631,2769.36,46136,161,152,45829,45744,44544,44793,44599
85374,367,395,53777,31597,5.89656e+18,232.052,4094.48,85374,211,202,84979,84979,84960,84947,84102
93574,105,304,58394,35180,5.88697e+18,228.893,4040.51,93574,202,206,88739,83015,33129,36947,24048
5964,130,152,3671,2293,5.86869e+18,72.0339,750.135,5964,62,65,5812,5785,5303,5575,5395
11500,138,248,7137,4363,5.88104e+18,176.244,1281.49,11500,99,98,11124,10939,7734,7375,8318
93550,26,302,57679,35871,5.87064e+18,165.829,3317.77,93550,120,127,78477,60773,13647,23303,15770
35214,77,219,21785,13429,5.87086e+18,157.239,1805.91,35214,93,95,34559,34099,12788,15234,19438
29363,209,274,18151,11212,5.87447e+18,185.86,1996.78,29363,113,116,29075,28948,25961,26877,27533
31958,224,260,19995,11963,5.88914e+18,207.984,2290.37,31958,165,157,31686,31541,28401,29469,30321
65260,119,291,40188,25072,5.87068e+18,152.153,2767.69,65260,115,119,64649,64060,38146,38624,36659
70423,190,411,43667,26756,5.87833e+18,190.423,3910.34,70423,171,170,69793,69318,49440,49760,45529
55398,132,290,34738,20660,5.89196e+18,230.166,3177.03,55398,192,190,53422,50646,25319,26311,29167
82393,107,217,50816,31577,5.87008e+18,139.983,2897.57,82393,91,97,82008,81627,50763,49261,59227
30571,59,159,18822,11749,5.87003e+18,86.5523,1667.85,30571,76,80,30095,29497,12500,12934,13452
82361,228,278,50637,31724,5.87132e+18,148.276,3031.16,82361,114,123,82083,82056,68384,76254,68740
52766,29,306,32728,20038,5.87474e+18,205.329,2788.24,52766,140,143,44115,35959,7488,12617,6555
51460,103,328,31957,19503,5.87827e+18,146.597,3047.26,51460,138,148,50027,48530,30088,30035,29711
73555,82,215,45337,28218,5.87019e+18,135.857,2753.47,73555,93,97,72983,72660,36128,34565,41310
70001,392,426,43935,26066,5.89071e+18,241.788,4007.05,70001,201,204,69575,69539,65763,67887,61035
80333,300,426,49928,30405,5.87732e+18,171.892,4232.71,80333,164,162,79907,79843,74751,74519,68072
94857,224,301,58458,36399,5.8711e+18,198.762,3355.03,94857,124,133,94530,94360,86234,89585,87671
40888,317,426,25525,15363,5.88304e+18,167.134,3248.28,40888,157,155,40462,40417,36932,36972,31826
99737,236,329,61816,37921,5.87737e+18,217.163,4117.64,99737,176,189,99331,99065,79528,84656,76587
37456,96,270,23423,14033,5.88568e+18,213.847,2467.53,37456,167,164,35191,32649,15366,15296,13331
31598,12,204,19539,12059,5.86997e+18,102.097,1898.3,31598,84,84,17000,10280,3224,3941,2779
39427,262,263,24464,14963,5.87975e+18,206.964,2381.03,39427,157,151,39164,39164,39160,39161,39140
28396,127,178,17499,10897,5.86959e+18,81.7893,1700.23,28396,78,80,28218,28175,21945,22585,21191
20923,13,191,12897,8026,5.87019e+18,89.9809,1372.97,20923,78,79,12448,7236,2703,2901,854
28496,89,170,17565,10931,5.86924e+18,108.854,1585.11,28496,78,82,28218,28022,16123,15026,16930
5585,27,120,3430,2155,5.87064e+18,54.6052,662.141,5585,56,60,4685,3591,1672,1935,2169
92481,141,279,56923,35558,5.87115e+18,188.643,3176.5,92481,140,140,91751,91158,51267,47578,54373
72404,153,220,44727,27677,5.86975e+18,149.198,2850.18,72404,95,95,72163,71999,59227,62725,62886
87287,120,270,54031,33256,5.87034e+18,225.91,3502.48,87287,134,143,86073,84904,45184,40471,51719
36820,130,175,22756,14064,5.87004e+18,103.59,1883.95,36820,80,81,36645,36590,32581,34322,30523
72388,205,231,44739,27649,5.87019e+18,167.802,2883.68,72388,97,96,72157,72127,71061,71699,71510
30197,268,299,18743,11454,5.87736e+18,168.247,2196.17,30197,128,130,29898,29871,26819,28566,27637
32227,39,260,19953,12274,5.87201e+18,189.155,1917.36,32227,105,109,29682,27136,5686,9184,7425
75570,104,314,46661,28909,5.87248e+18,207.722,3273.27,75570,141,133,74384,73208,34479,34132,35438
98007,45,279,60576,37431,5.87027e+18,149.306,3442.26,98007,109,112,92822,86239,22077,31462,27408
58590,131,273,36340,22250,5.87539e+18,222.506,2771.52,58590,152,153,57523,56430,29843,27019,29962
50558,37,328,31370,19188,5.87741e+18,156.924,2976.11,50558,136,133,44131,37772,9117,14324,11419
58123,239,272,36023,22100,5.87849e+18,187.593,2922.37,58123,165,160,57841,57782,51583,55264,54399
82035,225,279,50679,31356,5.86996e+18,163.559,3184.46,82035,110,115,81756,81597,72155,77579,76904
69772,160,342,43327,26445,5.87994e+18,159.749,3679.47,69772,159,161,69147,68549,55706,55987,53843
26823,54,254,16517,10306,5.8714e+18,139.734,1706.37,26823,95,101,25613,24817,6489,9502,8034
6010,116,135,3704,2306,5.86889e+18,64.609,659.015,6010,56,58,5875,5859,5427,5681,5458
23628,134,157,14614,9014,5.87032e+18,101.422,1377.15,23628,74,77,23471,23394,21288,22604,22977
32234,55,174,19861,12373,5.87e+18,104.857,1764.47,32234,80,82,31548,30499,11736,12739,13205
20027,105,276,12627,7400,5.89758e+18,198.701,1932.92,20027,152,155,18312,16297,7369,7614,5426
44435,229,279,27654,16781,5.88329e+18,201.253,2689.25,44435,167,170,44135,43964,37763,40578,37902
49870,109,309,31006,18864,5.88181e+18,188.111,2988.78,49870,166,172,47947,45859,26123,26967,19678
65790,74,277,41001,24789,5.87956e+18,232.657,3135.79,65790,177,172,61785,58142,15232,23269,19389
69142,228,281,42723,26419,5.87017e+18,157.566,2727.63,69142,102,110,68861,68837,67748,68376,67513
61807,243,273,38435,23372,5.87618e+18,227.672,2913.1,61807,161,160,61511,61382,53315,57938,56888
94563,307,315,58351,36212,5.87206e+18,203.034,3578.2,94563,147,146,94248,94228,93477,93949,93831
75935,72,298,46803,29132,5.87086e+18,161.246,3026.9,75935,118,124,74550,73451,24943,31530,28181
2591,88,118,1593,998,5.86749e+18,53.5083,429.103,2591,43,46,2473,2465,2171,2190,2083
55698,156,235,34321,21377,5.86978e+18,116.645,2327.74,55698,94,97,55463,55384,39471,39477,39198
87890,8,303,54340,33550,5.87068e+18,152.101,3198.62,87890,118,126,39529,0,6141,7439,3473
5453,49,76,3385,2068,5.86771e+18,64.3059,552.757,5453,57,61,5230,4880,3528,3269,4216
91481,67,271,56395,35086,5.87008e+18,149.38,3094.93,91481,109,112,90126,89115,26796,34685,29746
26105,11,217,16064,10041,5.8701e+18,133.342,1540.77,26105,85,88,15345,10044,2894,3585,2499
49690,132,235,30622,19068,5.87008e+18,122.773,2205.31,49690,94,94,49428,49250,30256,26349,27124
86969,198,317,53803,33166,5.87278e+18,192.443,3500.82,86969,149,155,86471,86064,65388,62112,60781
92096,186,303,56785,35311,5.87077e+18,172.789,3282.4,92096,122,126,91708,91457,77982,75183,79460
18368,144,244,11375,6993,5.87375e+18,136.584,1430.33,18368,94,93,18063,17923,11969,11026,11442
68652,211,286,42569,26083,5.87882e+18,225.604,3225.84,68652,177,170,68222,67819,55366,59513,56946
23885,136,217,14685,9200,5.8691e+18,98.8265,1478.53,23885,80,84,23655,23565,18059,17151,20103
47324,141,286,29340,17984,5.87864e+18,216.264,2719.34,47324,160,153,46406,45508,26988,25699,28602
96844,73,314,59741,37103,5.87197e+18,211.398,3601.02,96844,147,145,94466,92580,25562,37223,39948
39462,68,267,24773,14689,5.8934e+18,217.204,2612.51,39462,181,173,34169,28641,8907,12494,12344
47356,31,272,29243,18113,5.87534e+18,213.561,2502.86,47356,145,143,40306,33931,6809,12102,6437
60402,275,286,37478,22924,5.87966e+18,198.794,3066.94,60402,175,174,60116,60109,59225,59843,59543
76512,91,200,47218,29294,5.87022e+18,125.752,2806.75,76512,88,91,76106,75859,41217,37016,48748
88314,143,217,54451,33863,5.87017e+18,142.991,2989.62,88314,93,101,88064,87874,71340,70020,78222
67098,198,216,41400,25698,5.87005e+18,135.552,2644,67098,92,94,66882,66871,65801,66415,66438
13956,16,82,8599,5357,5.86927e+18,71.8852,916.737,13956,70,71,8902,5366,1985,2349,3370
2431,94,122,1498,933,5.86807e+18,49.9506,456.328,2431,46,48,2309,2305,2115,2202,1996
15040,50,253,9379,5661,5.88077e+18,166.422,1482.62,15040,108,111,13364,12023,4231,5413,4571
87093,12,342,53997,33096,5.87818e+18,198.685,4008.95,87093,171,166,47141,26820,7818,8784,7645
11254,30,74,7009,4245,5.86889e+18,67.7146,795.331,11254,65,67,9549,7277,4055,4113,4850
79512,69,269,48996,30516,5.8703e+18,147.631,2885.99,79512,104,110,78363,77425,26531,31216,34285
19057,17,295,11950,7107,5.89087e+18,175.241,1940.59,19057,141,139,10755,5393,1592,2844,1094
25976,90,163,16062,9914,5.86971e+18,94.3602,1532.26,25976,75,76,25783,25750,18250,16991,15704
55386,228,266,34035,21351,5.87131e+18,163.848,2434.85,55386,115,121,55120,55089,46628,51566,47179
33884,213,264,20882,13002,5.87249e+18,205.381,2009.92,33884,112,115,33592,33444,28522,31332,30865
7817,73,127,4804,3013,5.87221e+18,71.2601,779.56,7817,61,59,7665,7631,4370,3784,4044
78852,33,274,48650,30202,5.87372e+18,234.21,3157.44,78852,156,163,68977,58050,11674,20605,9677
53299,90,312,32955,20344,5.87418e+18,161.005,2817.93,53299,131,134,51955,50669,23202,26691,24809
86908,14,262,53546,33362,5.87059e+18,134.294,3038.94,86908,100,106,55146,32390,9659,9415,7088
14387,109,149,8859,5528,5.86937e+18,71.7933,1081.36,14387,74,74,14238,14185,13339,13301,13165
37977,37,261,23803,14174,5.891e+18,219.126,2522.21,37977,177,169,29078,21717,5630,8608,5871
46314,10,224,28457,17857,5.87079e+18,123.954,2066.47,46314,93,100,24629,16841,3928,4919,3847
16657,235,236,10514,6143,5.90077e+18,188.635,1662.21,16657,153,138,16421,16421,16420,16421,16421
96785,57,295,59730,37055,5.87033e+18,169.029,3219.62,96785,117,122,94543,92158,21295,32213,31344
87771,195,318,54432,33339,5.87895e+18,229.322,3827.39,87771,188,190,87124,86416,58702,54601,54456
11223,108,149,6911,4312,5.87e+18,78.3659,938.971,11223,63,65,11074,11038,8735,9240,8788
29488,123,222,18244,11244,5.86948e+18,133.77,1884.04,29488,86,84,29216,29083,20984,21222,20999
42562,54,274,26289,16273,5.87446e+18,176.717,2365.63,42562,127,133,39961,38074,11319,16024,13767
34451,231,282,21468,12983,5.88508e+18,193.924,2433.63,34451,156,155,34151,34001,28790,30102,27888
35745,64,180,22024,13721,5.86977e+18,102.727,1880.66,35745,80,83,35297,34867,15720,16027,15396
75031,26,260,46271,28760,5.87007e+18,143.934,2805.4,75031,101,106,62989,48425,10929,17372,13443
98496,125,246,60756,37740,5.87044e+18,158.342,3289.16,98496,97,103,98134,97807,60300,53058,56706
8024,80,155,4942,3082,5.86835e+18,72.5972,820.407,8024,63,63,7859,7818,5847,5935,5794
61360,169,235,37780,23580,5.86987e+18,130.17,2407.92,61360,98,102,61112,61014,50340,54845,57485
8773,47,144,5388,3385,5.86954e+18,80.799,820.927,8773,63,68,8442,8304,3281,3542,4163
60044,143,214,37120,22924,5.87021e+18,132.482,2497.66,60044,91,93,59807,59691,43000,43920,38796
69909,84,286,43344,26565,5.87892e+18,228.565,3262.88,69909,179,176,66339,62623,20039,28278,26902
51979,169,271,32292,19687,5.88156e+18,216.966,2827.59,51979,166,171,51272,50417,34642,32719,35929
72056,50,216,44455,27601,5.87005e+18,136.712,2729.6,72056,93,96,69840,66613,18130,25437,26088
95511,296,316,59192,36319,5.8782e+18,230.144,3934.43,95511,190,194,95195,95182,88973,92300,91458
22207,244,246,13940,8267,5.89189e+18,183.471,1882.21,22207,145,140,21961,21961,21902,21904,21961
23183,274,307,14491,8692,5.88808e+18,214.592,2069.61,23183,143,148,22876,22856,20752,21893,21388
38763,19,261,24335,14428,5.89052e+18,206.686,2526.26,38763,178,164,24250,13822,3318,6480,2876
75320,78,301,46466,28854,5.87091e+18,159.08,3006.76,75320,114,123,74118,73213,27696,32639,32978
97486,289,397,60409,37077,5.87262e+18,206.565,4003.08,97486,156,169,97089,96970,80492,86910,71320
44191,145,302,27256,16935,5.87474e+18,161.369,2548.75,44191,134,131,43572,43157,25436,24061,23310
69157,11,274,42562,26595,5.87032e+18,162.037,2687.76,69157,118,124,39665,25687,7446,7669,4150
83527,201,302,51510,32017,5.87069e+18,165.037,3153.57,83527,115,122,83165,82952,68997,68530,71805
18563,197,242,11443,7120,5.87209e+18,148.602,1446.67,18563,96,96,18306,18210,16016,17245,16998
77109,97,298,47505,29604,5.87079e+18,161.978,3032.68,77109,119,125,76217,75391,32245,37530,35936
10061,62,149,6193,3868,5.86916e+18,79.6551,890.996,10061,61,64,9817,9686,5115,5227,5958
19701,105,253,12284,7417,5.88441e+18,197.962,1739.75,19701,130,132,18630,17576,8454,8539,9453
27972,26,297,17428,10544,5.88445e+18,127.672,2232.65,27972,135,130,20112,12814,5432,6774,6271
75907,19,268,46622,29285,5.87138e+18,179.831,2812.48,75907,130,130,58361,40503,7584,13378,5470
1942,76,110,1188,754,5.86806e+18,44.8661,381.171,1942,43,43,1832,1818,1469,1542,1469
1726,31,59,1079,647,5.85965e+18,45.2144,280.198,1726,41,42,1516,1242,842,797,1040
87141,74,291,54496,32645,5.88899e+18,237.244,3903.15,87141,207,207,78249,68621,18500,28710,25584
37854,117,180,23299,14555,5.87018e+18,116.092,1911.26,37854,81,83,37649,37512,30127,31399,29047
6713,29,119,4161,2552,5.8673e+18,55.1631,712.217,6713,56,59,5784,4639,2274,2560,3050
18209,192,211,11201,7008,5.86981e+18,99.983,1275.54,18209,74,84,17998,17988,17063,17349,17879
80780,13,301,49701,31079,5.87101e+18,198.783,3077.08,80780,117,122,50058,29719,8493,9930,6817
87182,303,411,54044,33138,5.87593e+18,178.344,4197.07,87182,161,166,86771,86681,81334,82088,74851
97749,103,316,60257,37492,5.87271e+18,200.501,3628.26,97749,146,149,96335,94931,45284,45646,49224
35670,150,177,21987,13683,5.86988e+18,111.029,1865.82,35670,80,81,35493,35447,33420,34601,34638
48451,127,326,29981,18470,5.87273e+18,132.117,2641.02,48451,105,105,48008,47697,36876,39074,39375
87276,175,232,53874,33402,5.87009e+18,127.831,3048.37,87276,93,98,87044,87003,75758,81088,78768
94744,206,286,58979,35765,5.88351e+18,248.266,3963.88,94744,202,206,94170,93411,73450,79570,76270
17886,71,136,11026,6860,5.86881e+18,68.7856,1170.42,17886,73,77,17718,17524,15868,16500,16522
6766,65,131,4198,2568,5.87071e+18,66.9081,737.494,6766,64,67,6591,6407,5545,5702,5878
18901,184,244,11708,7193,5.87189e+18,144.998,1453.77,18901,93,95,18626,18535,15257,16894,15690
67656,169,285,41638,26018,5.8705e+18,149.734,2731.91,67656,103,110,67363,67216,45493,42143,45364
65942,101,200,40719,25223,5.87013e+18,122.837,2596.29,65942,85,93,65626,65418,40750,39573,45223
76013,15,267,47045,28968,5.87107e+18,186.409,2824.63,76013,128,132,52731,33455,8344,13213,4402
96704,124,309,59521,37183,5.87134e+18,229.289,3425.98,96704,131,139,95857,95055,50044,46788,60409
67922,75,285,42264,25658,5.8793e+18,202.824,3224.58,67922,170,174,64066,60271,18815,26413,23447
60089,126,262,37633,22456,5.8882e+18,226.113,3141.63,60089,192,186,57862,54785,28952,26517,33147
59197,37,208,36563,22634,5.87028e+18,114.993,2525.83,59197,88,89,54012,47724,13649,18517,14722
75018,157,232,46237,28781,5.8702e+18,134.162,2842.88,75018,92,97,74778,74669,58800,63948,59583
82302,96,232,50774,31528,5.87026e+18,133.214,2968.49,82302,92,98,81849,81526,40683,36788,41489
35579,31,260,22028,13551,5.87089e+18,145.943,1966.44,35579,103,106,31406,26853,5304,9695,6557
70770,158,225,43699,27071,5.87023e+18,126.036,2788.09,70770,90,91,70545,70443,60714,64169,62979
8563,68,76,5281,3282,5.86818e+18,62.756,681.959,8563,61,63,8478,8430,7832,8198,8315
21985,90,253,13617,8368,5.8724e+18,124.099,1572.4,21985,88,90,21490,21089,12488,12169,14433
42038,242,307,26288,15750,5.89002e+18,177.813,2852.84,42038,166,171,41731,41663,35972,36271,33600
97859,25,329,60621,37238,5.87338e+18,232.926,3786.17,97859,160,151,79069,58910,12066,22480,12184
98440,89,271,60912,37528,5.87014e+18,230.014,3652.13,98440,133,131,96923,95899,39799,35407,41789
51249,61,270,31714,19535,5.87001e+18,174.335,2601.69,51249,110,108,49625,47802,15124,17424,18906
92433,286,411,57205,35228,5.87973e+18,243.39,4235.38,92433,192,199,92022,91911,68654,73859,50084
73505,280,291,46141,27364,5.89305e+18,239.211,3637.92,73505,205,202,73214,73189,72599,72952,72475
86383,260,302,53381,33002,5.8708e+18,149.498,3196.85,86383,116,128,86081,86047,72655,80539,74712
49122,183,224,30393,18729,5.87006e+18,130.118,2108.8,49122,92,103,48898,48844,41507,45678,46354
19337,193,246,11929,7408,5.86963e+18,90.045,1461.25,19337,85,84,19091,19070,17206,18130,17059
13438,32,248,8289,5149,5.87303e+18,105.516,1291.7,13438,83,83,11602,9563,2373,4137,2951
49811,10,192,30726,19085,5.86973e+18,108.37,2168.06,49811,83,92,25924,17668,4571,3597,2580
80891,234,375,50039,30852,5.87028e+18,182.428,3335.67,80891,105,108,80516,80468,80302,80338,80246
80057,250,285,49783,30274,5.87762e+18,215.348,3432.55,80057,176,177,79749,79634,69675,74579,72948
41109,61,426,25729,15380,5.88724e+18,181.86,3288.99,41109,161,167,35822,30577,11336,13010,9251
22289,77,219,13725,8564,5.86954e+18,100.474,1422.42,22289,78,86,21885,21597,9290,9987,11319
83153,14,285,51253,31900,5.87004e+18,144.602,3029.69,83153,105,107,53136,31584,9751,10895,6658
34174,171,190,21103,13071,5.87002e+18,100.785,1820.02,34174,82,86,33984,33969,32270,33129,32682
9154,30,226,5651,3503,5.87408e+18,105.151,1035.66,9154,84,78,7717,6660,1431,2507,2207
98428,288,323,61560,36868,5.88583e+18,207.881,4255.1,98428,202,208,98105,98073,89056,93989,91570
30913,11,181,19006,11907,5.86992e+18,114.594,1610.96,30913,80,88,17789,11506,3391,3502,2748
80516,123,426,50204,30312,5.88243e+18,187.299,4387.98,80516,185,188,78324,75363,44280,43357,38025
55935,61,269,34855,21080,5.88177e+18,213.072,2911.84,55935,170,172,50899,46426,12300,18894,14746
17421,103,158,10772,6649,5.8696e+18,100.65,1200.21,17421,70,71,17237,17121,13446,14057,14857
15469,55,259,9641,5828,5.88544e+18,189.262,1595.51,15469,121,115,13423,11914,3018,4982,3371
24589,125,258,15171,9418,5.8798e+18,178.858,1834.5,24589,128,123,23874,23086,13440,13279,14968
38268,220,266,23582,14686,5.87182e+18,173.965,2059.67,38268,104,111,38001,37929,32197,35601,32657
4904,187,387,3075,1829,5.87933e+18,105.214,1135.24,4904,87,78,4517,4507,3619,3531,2927
98794,237,316,60946,37848,5.87245e+18,195.502,3696.85,98794,149,151,98443,98242,87553,91599,86173
81639,109,281,50753,30886,5.88251e+18,212.957,3601.97,81639,196,190,78455,74663,34577,34980,31813
83959,290,294,52490,31469,5.88901e+18,244.011,3844.51,83959,203,207,83665,83664,83663,83664,83665
16167,111,145,10033,6134,5.86871e+18,67.6539,1181.35,16167,71,71,16022,16014,15314,15631,14193
55375,146,256,34075,21300,5.87074e+18,122.027,2430.08,55375,97,102,55103,54967,36867,33145,33791
73572,266,300,45308,28264,5.87101e+18,160.878,2946.15,73572,112,116,73272,73194,69866,71847,71576
72343,227,307,44581,27762,5.87394e+18,216.229,3176.96,72343,153,156,71983,71767,56799,61805,53605
4961,75,122,3071,1890,5.86864e+18,55.7952,626.323,4961,56,59,4839,4804,4378,4384,4299
18032,200,260,11182,6850,5.8698e+18,154.589,1588.58,18032,88,89,17772,17698,14835,16241,14223
1181,65,71,720,461,5.86517e+18,31.9136,243.742,1181,34,35,1110,1110,1095,1098,1089
31388,3,215,19308,12080,5.87036e+18,158.676,1720.39,31388,92,97,5512,0,17,301,639
46804,174,261,28747,18057,5.87167e+18,171.203,2228.76,46804,114,116,46431,46242,35075,36576,37684
17208,68,150,10622,6586,5.87013e+18,83.3496,1240.81,17208,69,73,16977,16859,8902,8448,9806
12933,39,249,7959,4974,5.87422e+18,94.6269,1269.04,12933,82,81,11740,10485,3412,4218,3580
52045,231,274,32143,19902,5.87477e+18,216.218,2636.3,52045,139,147,51728,51575,43781,47781,44659
95244,182,278,58901,36343,5.87076e+18,151.893,3210.58,95244,120,128,94878,94634,68020,67489,74363
70296,163,241,43450,26846,5.87017e+18,148.48,2834.91,70296,96,93,70042,69843,63629,65512,67180
99238,2925,4263,62526,36712,5.86237e+18,261.137,9104.24,99238,291,233,94975,94955,60353,71528,9527
85274,147,264,52582,32692,5.87008e+18,148.132,2999.02,85274,103,110,84954,84759,59882,60324,68196
94367,90,285,58808,35559,5.87991e+18,240.459,3791.1,94367,199,192,89757,84491,29371,35855,33083
56572,12,266,34768,21804,5.87129e+18,169.987,2439.12,56572,115,119,34656,21813,5391,7745,3545
6635,128,226,4093,2542,5.87333e+18,127.026,902.198,6635,73,72,6386,6259,4917,5229,4555
42700,35,189,26328,16372,5.86994e+18,114.192,1958.61,42700,84,88,39124,34091,7862,10572,12969
80737,82,231,49875,30862,5.87005e+18,145.982,3024.85,80737,98,95,80195,79941,42126,39950,43104
45811,227,262,28920,16891,5.89907e+18,212.438,2801.42,45811,189,184,45537,45413,40972,42384,43644
92932,199,286,57857,35075,5.88345e+18,247.008,3922.01,92932,198,204,92305,91487,70058,75100,72771
10440,63,224,6473,3967,5.87053e+18,73.5508,1026.32,10440,63,70,10165,10053,5603,5499,5947
21472,30,175,13184,8288,5.8703e+18,108.465,1342.35,21472,74,79,19082,16301,4432,5186,5769
10214,106,280,6312,3902,5.8724e+18,140.269,1244.49,10214,83,87,9802,9529,4788,5185,3611
48396,3,284,30081,18315,5.88192e+18,209.101,2813.46,48396,167,173,7607,0,114,444,264
4050,125,182,2564,1486,5.90737e+18,136.289,757.049,4050,93,79,3762,3468,2811,2803,2930
79933,188,302,49392,30541,5.87068e+18,157.54,3068.81,79933,113,125,79554,79356,58805,53963,58419
1765,12,92,1085,680,5.87116e+18,40.3909,334.76,1765,40,41,1146,747,243,282,285
24263,18,215,14934,9329,5.87017e+18,123.035,1489.19,24263,83,85,18391,12661,3313,4804,3134
90085,185,273,55936,34149,5.87494e+18,243.379,3456.52,90085,173,179,89387,88628,60776,62807,66334
9172,61,213,5666,3506,5.87208e+18,103.808,958.145,9172,75,73,8740,8437,3158,3653,3877
86176,19,294,53223,32953,5.87039e+18,164.268,3056.76,86176,108,116,64754,44121,11095,15732,9432
4224,146,169,2617,1607,5.86553e+18,57.1496,651.714,4224,58,61,4055,4044,3922,3985,3839
28216,23,178,17380,10836,5.87023e+18,81.7497,1698.4,28216,77,81,22014,15901,4382,6233,5231
22634,240,245,13947,8687,5.86976e+18,97.8912,1574.68,22634,83,88,22389,22385,22210,22372,22230
76363,363,411,47297,29066,5.88088e+18,249.398,3864.75,76363,185,191,75952,75877,64422,70306,62698
5045,30,75,3133,1912,5.86943e+18,69.1774,543.341,5045,60,60,4184,3087,1634,1744,1936
70379,206,285,43848,26531,5.88145e+18,243.518,3353.19,70379,179,183,69884,69362,54338,59009,54801
54435,130,191,33467,20968,5.87008e+18,113.531,2270.17,54435,89,94,54219,54093,40217,41431,44415
96220,297,301,59245,36975,5.87086e+18,202.339,3347.64,96220,129,128,95919,95914,95627,95648,95672
72794,65,260,44887,27907,5.86983e+18,139.161,2771.32,72794,99,103,71662,70721,25843,30856,32989
18053,99,139,11128,6925,5.87086e+18,70.39,1253.59,18053,69,70,17914,17892,14670,14913,14119
8759,104,125,5425,3334,5.86895e+18,63.6214,805.383,8759,61,62,8634,8620,7634,8189,7957
7133,182,215,4430,2703,5.87988e+18,127.625,959.692,7133,87,85,6918,6856,6146,6477,6374
27898,191,248,17171,10727,5.86996e+18,124.581,1732.7,27898,88,91,27650,27615,23081,25312,21320
22099,90,247,13671,8428,5.87065e+18,116.96,1503.67,22099,89,88,21640,21226,9905,9720,8583
67431,321,342,41676,25755,5.87389e+18,189.792,3318.29,67431,137,132,67089,67061,67049,67073,66401
28460,215,220,17508,10952,5.87017e+18,126.592,1628.75,28460,86,89,28240,28231,28155,28196,28055
96943,27,282,59780,37163,5.87312e+18,228.097,3461.59,96943,159,166,81393,64889,13138,21566,10016
7323,69,135,4543,2780,5.87017e+18,64.2128,764.609,7323,62,64,7182,7115,3926,3768,2814
76435,274,318,47436,28999,5.87968e+18,227.165,3622.95,76435,177,186,76117,76076,65894,71192,68423
49001,91,267,30727,18274,5.89224e+18,218.531,2880.47,49001,185,182,44933,39747,17525,18088,19131
30158,150,426,18930,11228,5.89075e+18,193.9,2852.17,30158,159,162,29294,28267,15291,14187,10868
46163,64,397,28610,17553,5.87291e+18,157.256,2982.11,46163,126,119,44210,42212,17797,19893,18393
19117,99,158,11756,7361,5.86894e+18,91.6661,1246.41,19117,71,77,18928,18806,14270,14114,15043
9559,72,127,5864,3695,5.87099e+18,61.5179,832.486,9559,62,61,9413,9380,6461,5906,7087
59030,206,267,37029,22001,5.88976e+18,229.315,3151.73,59030,190,189,58611,58089,47917,50681,50414
53711,49,290,33670,20041,5.89201e+18,236.826,3132.67,53711,190,189,43511,33915,8689,13751,10275
33858,178,261,21262,12596,5.89091e+18,212.189,2364.83,33858,171,163,33358,32635,24402,25699,26336
44945,160,177,27758,17187,5.87011e+18,107.984,2041.82,44945,82,91,44768,44759,43215,43965,44046
4120,167,173,2547,1573,5.87268e+18,72.8568,631.667,4120,57,56,3947,3947,3888,3927,3911
44958,239,260,27782,17176,5.86976e+18,151.079,2407.01,44958,97,103,44698,44654,44347,44537,44146
85489,165,309,52979,32510,5.87312e+18,206.778,3376.45,85489,153,159,84777,84138,48634,43524,45003
49130,87,202,30305,18825,5.87012e+18,98.5078,2256.12,49130,86,91,48795,48608,29334,27972,30188
6955,92,114,4301,2654,5.86986e+18,56.2761,723.304,6955,59,61,6841,6841,6564,6725,6474
41923,143,321,26037,15886,5.8804e+18,173.701,2779.23,41923,143,153,41100,40364,28562,28989,25232
37320,119,217,23079,14241,5.8703e+18,128.897,1839.5,37320,92,97,37026,36790,26071,24915,31024
4305,61,76,2647,1658,5.86768e+18,58.5714,490.807,4305,54,55,4209,4152,3711,3854,4033
71194,3,342,44317,26877,5.88228e+18,169.88,3783.25,71194,167,180,10984,0,423,597,594
72077,341,411,44726,27351,5.87571e+18,176.912,3867.3,72077,159,151,71666,71597,67764,68786,65458
78268,25,272,48263,30005,5.87315e+18,215.235,3113.73,78268,154,157,64377,49779,10201,18156,9867
44384,19,257,27387,16997,5.87051e+18,129.966,2378.09,44384,100,101,31074,19851,5769,6880,5364
88766,272,302,54852,33914,5.87079e+18,157.885,3214.4,88766,116,127,88464,88423,75776,83212,82010
80372,186,285,49972,30400,5.87857e+18,229.124,3455.01,80372,182,179,79728,79010,54426,55178,55884
25744,127,261,16146,9598,5.88789e+18,200.345,2055.46,25744,159,141,24740,23465,13111,12243,14701
7636,43,76,4711,2925,5.86858e+18,68.4259,659.349,7636,63,64,7193,6531,4195,4004,5140
36494,57,248,22453,14041,5.87058e+18,106.507,1960.52,36494,89,89,35587,34472,16157,18430,18674
84099,272,278,52691,31408,5.88855e+18,223.493,3781.38,84099,203,199,83821,83821,83105,83624,83815
86612,34,285,53923,32689,5.87862e+18,244.627,3630.98,86612,180,190,73112,59409,12271,21351,12330
54810,182,196,33781,21029,5.86993e+18,108.774,2292.72,54810,88,98,54614,54614,54052,54300,53931
18489,81,219,11432,7057,5.86981e+18,102.698,1318.8,18489,79,79,18150,17934,10153,10204,12506
87437,107,307,54379,33058,5.88344e+18,245.568,3860.61,87437,197,197,83755,79433,35466,35792,35789
33846,144,273,20988,12858,5.87359e+18,210.016,2056.08,33846,112,120,33354,33088,21882,20471,22852
59635,242,259,36759,22876,5.8703e+18,133.83,2520.32,59635,95,101,59376,59361,57979,58260,59053
28141,83,209,17378,10763,5.87002e+18,125.137,1819.67,28141,86,85,27803,27668,15739,13965,15359
37875,134,195,23354,14521,5.87022e+18,101.332,2001.87,37875,82,82,37680,37610,31344,32847,30641
4189,21,115,2583,1606,5.8711e+18,56.2783,532.269,4189,55,57,3105,2197,1063,1309,1670
20149,58,128,12509,7640,5.86935e+18,66.6485,1285.79,20149,72,72,19852,19370,10929,11027,8860
9116,139,153,5624,3492,5.8691e+18,68.7758,935.514,9116,71,73,8963,8963,8745,8893,8741
75161,166,309,46600,28561,5.87355e+18,219.092,3163.86,75161,152,158,74470,73856,41776,36920,37134
71697,9,302,44207,27490,5.87066e+18,155.425,2944.68,71697,111,117,35164,0,5911,7365,4814
96586,174,352,59499,37087,5.87046e+18,165.482,3415.54,96586,113,120,96174,95966,54519,46987,67953
70403,138,271,43554,26849,5.87017e+18,201.531,3060.34,70403,113,112,69842,69256,39305,33691,48636
12847,80,122,7904,4943,5.86929e+18,62.982,1011.09,12847,67,68,12725,12724,9632,9375,7808
65301,108,279,40322,24979,5.87023e+18,149.302,2844.74,65301,104,112,64691,64245,35369,30705,37554
1859,25,74,1157,702,5.86753e+18,53.83,331.602,1859,47,45,1475,1078,524,585,699
81181,85,273,50347,30834,5.8743e+18,234.364,3222.68,81181,164,160,78586,76147,22424,30652,24559
60334,158,271,37358,22976,5.87237e+18,206.388,2617.06,60334,127,137,59789,59343,39544,35322,41381
60127,181,210,37192,22935,5.86978e+18,125.514,2522.47,60127,86,90,59917,59905,58662,59213,59596
55491,67,273,34458,21033,5.88063e+18,208.274,2907.22,55491,173,176,51156,46978,12689,20421,15579
79421,125,263,48935,30486,5.87024e+18,132.656,2914.95,79421,98,108,79074,78780,48311,48561,59473
10367,122,154,6411,3956,5.8702e+18,85.9988,938.456,10367,66,68,10213,10187,8509,9434,8401
26684,31,257,16426,10258,5.87164e+18,139.621,1733.08,26684,93,100,23387,19890,4497,7525,5176
57300,20,273,35654,21646,5.87739e+18,232.739,2848.24,57300,166,160,42469,31417,5916,12254,4344
17654,83,274,10939,6715,5.87854e+18,82.2006,1580.4,17654,99,91,17054,16582,15413,15377,14633
13681,213,238,8421,5260,5.87448e+18,133.505,1271.18,13681,93,91,13443,13420,12561,13063,12923
66401,93,264,41109,25292,5.87096e+18,182.683,2643.12,66401,120,125,65375,64379,25890,28832,28931
94487,166,271,58265,36222,5.86999e+18,150.359,3139.81,94487,110,113,94187,94042,74368,73608,81474
88834,122,327,55048,33786,5.87435e+18,206.805,3711.62,88834,159,151,87669,86298,45800,40932,42422
16509,37,121,10167,6342,5.86958e+18,66.7612,1131.42,16509,70,72,15058,13233,4536,5741,4365
98098,192,228,60467,37631,5.87015e+18,144.237,3158.23,98098,99,105,97870,97837,90297,93934,96702
79358,119,260,49042,30316,5.87007e+18,171.705,3168.68,79358,111,112,78778,78294,46613,43053,51706
76052,216,230,46841,29211,5.87025e+18,132.554,2755.29,76052,99,103,75822,75822,74065,75113,75628
94391,116,227,58248,36143,5.87001e+18,140.551,3153.77,94391,94,100,94037,93714,60759,59001,70622
80015,64,285,49819,30196,5.87961e+18,241.541,3527.92,80015,181,186,74291,69012,18133,26907,19542
81282,168,285,50095,31187,5.87036e+18,142.083,3003.41,81282,104,111,80987,80834,57476,53211,57603
70028,160,273,43409,26619,5.87375e+18,209.221,2968.3,70028,148,154,69335,68788,48398,43716,46632
24488,165,242,15465,9023,5.90084e+18,196.53,2022.66,24488,159,157,23982,23316,17826,17979,19729
70300,164,215,43391,26909,5.87022e+18,131.524,2743.77,70300,89,90,70085,70018,63042,66540,67334
63053,236,281,39100,23953,5.87978e+18,202.101,3086.95,63053,167,172,62744,62583,53081,58201,56001
70438,201,276,44027,26411,5.88834e+18,228.295,3426.29,70438,194,195,69931,69238,55513,58425,57645
62924,298,342,38741,24183,5.87051e+18,137.149,2816.36,62924,105,112,62582,62536,52974,58435,57410
85904,278,315,52978,32926,5.87298e+18,189.196,3493.68,85904,149,151,85589,85519,76334,81337,76548
13623,4,150,8371,5252,5.87033e+18,82.1625,1053.41,13623,68,71,3203,0,5,261,548
27868,146,292,17247,10621,5.87565e+18,103.987,2023.6,27868,114,107,27455,27227,22023,21959,20818
11512,20,146,7093,4419,5.86979e+18,68.4581,1015.77,11512,69,73,8189,5741,1533,2580,1111
24425,193,258,15279,9146,5.8903e+18,181.05,1991.41,24425,149,142,24108,23861,19641,20718,20882
48455,106,260,30003,18452,5.87183e+18,197.697,2335.93,48455,126,129,47586,46727,23257,22672,24176
3499,64,75,2148,1351,5.86752e+18,59.074,447.561,3499,54,55,3414,3365,3115,3269,3328
28096,112,260,17537,10559,5.88251e+18,189.302,2039.71,28096,147,136,26916,25581,13102,12497,13839
79349,146,286,49302,30047,5.88157e+18,246.672,3565.4,79349,190,192,77861,76188,43979,40173,46305
55537,281,327,34456,21081,5.87689e+18,158.652,3128.89,55537,145,144,55210,55168,52776,53079,51839
6627,10,109,4074,2553,5.87173e+18,53.4314,680.005,6627,57,55,3380,2257,751,711,272
72817,162,291,45719,27098,5.89316e+18,237.925,3627.45,72817,204,202,71555,69824,43518,42706,48576
62751,197,207,38720,24031,5.87e+18,125.842,2602.69,62751,88,89,62544,62544,62499,62490,62544
14628,236,261,9047,5581,5.87e+18,111.717,1335.74,14628,72,80,14367,14335,13242,13640,11685
25947,100,225,16051,9896,5.87018e+18,119.641,1788.34,25947,87,89,25598,25455,18201,16920,16787
6603,102,128,4118,2485,5.8675e+18,62.2732,707.953,6603,61,63,6475,6473,5314,5644,4550
40837,195,264,25158,15679,5.87289e+18,203.124,2181.57,40837,120,122,40492,40245,33210,36664,35210
88308,69,279,54548,33760,5.87006e+18,147.125,3300.73,88308,108,112,86993,85590,31718,36210,36945
73386,142,267,45438,27948,5.87075e+18,163.465,2741.38,73386,119,127,72884,72499,44705,42596,52187
71248,34,307,44286,26962,5.88255e+18,243.677,3486.68,71248,187,184,57740,44884,10073,16758,10238
22515,49,149,13878,8637,5.86949e+18,96.9136,1374.94,22515,71,76,21889,21199,7542,8968,10366
13486,28,249,8431,5055,5.88041e+18,158.946,1402.79,13486,109,104,10527,8063,1951,3052,2377
15910,27,241,9883,6027,5.87474e+18,156.197,1393.66,15910,100,96,13186,10721,2058,3982,2985
73909,195,277,45982,27927,5.88266e+18,215.051,3404.36,73909,195,183,73355,72645,56295,60579,59625
63645,129,316,39200,24445,5.87246e+18,199.107,2947.22,63645,117,121,63062,62557,38188,33046,34100
4874,30,71,3002,1872,5.86973e+18,57.1851,505.286,4874,54,55,4159,3192,1938,2061,2740
32980,101,261,20463,12517,5.8851e+18,213.104,2251.19,32980,159,153,31222,29363,13794,13232,15395
94977,232,279,58660,36317,5.86992e+18,167.188,3433.32,94977,111,107,94696,94580,93424,94162,94301
26055,74,251,16133,9922,5.87264e+18,129.828,1694.56,26055,97,99,25304,24760,6889,9810,9377
87786,204,291,55018,32768,5.89127e+18,235.365,3944.96,87786,212,205,87230,86486,63463,67585,71853
88270,248,302,54382,33888,5.87058e+18,161.013,3222.38,88270,121,129,87968,87883,76804,83152,75562
73069,142,270,45258,27811,5.87004e+18,223.761,3191.93,73069,127,134,72255,71331,45239,37702,51571
58196,216,260,35957,22239,5.87e+18,167.089,2720.36,58196,104,106,57906,57838,50738,54776,56113
57954,12,272,35748,22206,5.87332e+18,183.042,2689.47,57954,142,141,34659,21420,6398,7529,4593
98860,11,322,60970,37890,5.87065e+18,194.653,3507.11,98860,125,131,55095,35447,9653,10666,4801
85917,187,259,53105,32812,5.86994e+18,156.656,3253.73,85917,108,107,85586,85363,73925,71814,76908
19997,9,247,12338,7659,5.87432e+18,168.311,1552.24,19997,106,110,10202,0,1784,2327,778
67591,32,269,41606,25985,5.87091e+18,163.482,2649.62,67591,114,126,60292,51397,10431,17075,11376
33811,90,262,21039,12772,5.88268e+18,208.734,2269.49,33811,154,154,31716,29310,12683,13581,12590
9107,25,126,5647,3460,5.86837e+18,64.3944,820.028,9107,59,62,7607,5762,1930,2633,2689
94676,86,285,58329,36347,5.87026e+18,153.249,3213.06,94676,104,111,93885,93288,38454,42282,51087
51063,12,266,31636,19427,5.87307e+18,205.981,2453.78,51063,136,132,31421,20078,5252,7219,2758
92555,92,270,57299,35256,5.87011e+18,224.109,3571.37,92555,132,139,90865,89682,40775,34535,39656
79783,2,269,49379,30404,5.87133e+18,186.814,2903.22,79783,133,132,7399,0,560,0,19
68605,258,304,42274,26331,5.8741e+18,202.732,3086.55,68605,151,147,68300,68241,57415,63482,56579
96091,45,281,59541,36550,5.87279e+18,205.778,3405.11,96091,155,163,90105,84596,17429,26599,20182
69480,377,409,43009,26471,5.87179e+18,163.302,3477.94,69480,131,118,69071,69058,69041,69063,68459
36562,207,264,22655,13907,5.87155e+18,166.327,2026.92,36562,102,110,36283,36150,30793,33849,30283
96660,199,285,60232,36428,5.87973e+18,238.833,3828.38,96660,201,192,96023,95215,70238,76540,74839
12710,88,153,7860,4850,5.87003e+18,79.5098,1024.13,12710,68,69,12530,12417,8931,8589,8412
30812,63,268,19158,11654,5.8764e+18,178.775,2063.58,30812,129,129,28871,27234,8132,12114,9700
64169,162,216,39640,24529,5.87004e+18,127.818,2578.31,64169,88,94,63953,63871,50886,57884,49646
20314,5,163,12491,7823,5.86957e+18,101.273,1303.86,20314,73,80,6000,0,219,1021,791
80903,38,291,50747,30156,5.89201e+18,234.26,3799.44,80903,209,202,61419,44966,11490,17892,12692
20888,74,171,12886,8002,5.86969e+18,83.5408,1464.66,20888,77,78,20640,20514,11753,11784,12119
60882,69,274,37572,23310,5.87356e+18,210.285,2772.77,60882,151,146,58300,55950,14930,23062,19949
36978,59,257,22833,14145,5.87048e+18,141.293,2210.13,36978,97,98,35772,34470,10648,13073,13335
13901,52,164,8588,5313,5.86964e+18,87.5196,1048.88,13901,70,70,13476,13207,4566,5566,7362
80502,86,282,49673,30829,5.87005e+18,136.442,2992.68,80502,101,106,79841,79364,32894,35987,40178
57282,57,272,35280,22002,5.87193e+18,203.61,2549.07,57282,127,131,55037,53345,12539,19564,17878
20386,104,145,12615,7771,5.8691e+18,98.0967,1281.29,20386,72,77,20215,20117,16172,17310,17263
35752,244,302,22032,13720,5.87568e+18,179.913,2278.43,35752,134,130,35447,35393,29303,32563,28032
3597,52,171,2212,1385,5.86791e+18,70.6311,593.108,3597,56,57,3332,3202,1604,1825,1841
8716,205,234,5421,3295,5.87605e+18,150.633,1042.34,8716,84,76,8482,8433,8327,8368,8344
58076,193,260,35730,22346,5.86982e+18,129.437,2465.57,58076,98,101,57816,57740,48605,52198,47980
95829,217,302,59176,36653,5.87066e+18,199.437,3366.95,95829,123,132,95493,95276,85377,88464,89704
79212,241,270,49521,29691,5.88528e+18,224.263,3578.64,79212,200,191,78914,78738,70506,75352,74775
27591,144,246,16955,10636,5.87098e+18,128.883,1711.04,27591,86,92,27334,27216,18054,16354,15600
5443,63,80,3379,2064,5.87029e+18,68.747,578.828,5443,60,65,5307,5142,4223,4008,4864
2153,50,95,1319,834,5.86595e+18,41.2819,362.917,2153,43,43,2053,2040,1248,1292,1254
15225,278,293,9432,5793,5.87822e+18,133.365,1621.39,15225,110,105,14932,14922,14599,14763,14629
7248,105,134,4475,2773,5.86858e+18,69.3129,766.833,7248,58,65,7114,7090,5812,6445,5885
56622,249,260,34982,21640,5.87008e+18,143.895,2685.59,56622,103,103,56362,56358,56355,56356,56358
75519,38,293,46665,28854,5.87013e+18,164.048,2854.13,75519,104,112,70313,64665,13436,22120,18818
73967,184,232,45708,28259,5.86978e+18,153.113,2901.47,73967,97,97,73735,73663,70051,71809,72649
48853,75,196,30120,18733,5.86998e+18,118.141,2197.9,48853,88,89,48374,48174,23710,23132,26304
71387,149,290,44744,26643,5.89123e+18,234.63,3564.23,71387,203,197,69698,67211,37702,35995,41953
21124,162,172,13000,8124,5.86957e+18,109.647,1320.49,21124,76,81,20952,20952,20612,20749,20952
15906,72,86,9795,6111,5.86872e+18,69.597,989.862,15906,73,74,15801,15700,14807,15414,15603
18314,53,252,11452,6862,5.88486e+18,194.23,1674.82,18314,134,120,15942,14415,3602,5771,4452
29247,55,220,17995,11252,5.87012e+18,124.661,1645.79,29247,86,89,28418,27735,6874,10647,12615
26404,252,258,16342,10062,5.87738e+18,187.104,1900.62,26404,133,127,26146,26142,25945,26084,26094
26847,84,158,16586,10261,5.87007e+18,93.4868,1566,26847,77,78,26655,26626,16698,16033,16460
94633,65,232,58450,36183,5.87009e+18,133.137,3162.32,94633,93,98,93540,92310,29648,36632,34979
17624,24,145,10831,6793,5.87016e+18,91.7158,1201.12,17624,69,73,14387,10636,3064,4396,3608
7455,56,76,4624,2831,5.87109e+18,67.6539,648.403,7455,60,64,7291,7011,5331,5246,6262
34144,191,245,21118,13026,5.87069e+18,162.949,1829.29,34144,99,101,33880,33774,28187,31185,30250
35839,4,260,22308,13531,5.87946e+18,203.465,2246.23,35839,150,140,8318,0,7,1037,611
36892,245,273,22887,14005,5.87547e+18,173.026,2234.62,36892,130,131,36619,36597,31967,34683,33358
54295,195,342,33473,20822,5.87065e+18,159.345,2754.53,54295,114,109,53915,53728,44614,42391,48058
92237,116,263,56822,35415,5.87028e+18,140.855,3104.19,92237,103,110,91809,91353,55213,52419,61456
84924,151,316,52680,32244,5.87918e+18,232.064,3781.95,84924,185,193,83576,82113,45129,44283,38697
76282,180,301,46923,29359,5.8709e+18,193.899,2949.78,76282,107,117,75908,75737,62126,69330,64290
44592,85,262,27919,16673,5.89061e+18,215.314,2714.34,44592,181,174,40715,36212,14183,16143,17251
22502,73,283,14090,8412,5.88527e+18,149.754,2018.38,22502,132,133,20595,18673,8987,9940,8467
18733,247,262,11600,7133,5.88246e+18,182.217,1686.88,18733,120,120,18471,18455,17219,17889,17458
42312,57,288,26085,16227,5.87146e+18,151.06,2307.39,42312,111,113,40782,39309,14471,17686,17054
40508,208,224,24895,15613,5.87062e+18,121.601,1919.49,40508,89,101,40284,40273,37974,39224,38420
60000,170,266,36940,23060,5.8704e+18,170.176,2514.02,60000,113,120,59615,59333,43834,40638,46663
68661,141,286,42626,26035,5.88034e+18,239.903,3299.87,68661,176,184,67277,65932,36263,35054,34267
83775,142,270,51794,31981,5.87023e+18,187.481,3228.81,83775,107,107,83296,82785,51600,43503,58594
89854,26,231,55399,34455,5.87005e+18,141.656,3024.35,89854,98,103,74637,56018,13754,18730,15494
63205,153,274,39084,24121,5.8762e+18,229.225,2948.23,63205,167,164,62320,61485,39863,35781,42183
88900,128,285,55409,33491,5.88046e+18,246.479,3707.47,88900,199,192,86563,83583,41039,38669,43540
93794,233,298,57890,35904,5.87055e+18,203.719,3338.34,93794,126,130,93478,93316,86221,89907,88611
15586,213,215,9582,6004,5.86927e+18,97.2905,1226.82,15586,75,82,15371,15371,15370,15371,15371
74015,387,411,45830,28185,5.88087e+18,251.949,3826.08,74015,181,192,73604,73565,71158,72730,67346
72162,128,278,44545,27617,5.879e+18,232.723,3205,72162,182,174,70531,68623,34490,31611,35041
70749,104,259,43599,27150,5.8705e+18,133.262,2734.88,70749,99,104,70299,69903,39444,39724,46146
94824,115,285,59159,35665,5.88267e+18,245.554,3905.76,94824,204,204,91513,87459,40815,38723,42549
51215,87,260,32013,19202,5.8884e+18,221.591,2889.73,51215,180,176,47244,42568,17600,19310,19034
74496,60,328,46197,28299,5.87831e+18,190.36,3603.52,74496,166,175,69254,64588,19940,27096,21385
67064,106,342,41313,25751,5.87035e+18,152.175,2976.5,67064,112,114,66331,65710,29439,28151,32551
34369,43,224,21141,13228,5.8701e+18,158.151,1792.78,34369,96,96,32682,30837,7145,10830,11473
81233,218,381,50240,30993,5.87055e+18,157.841,3475.46,81233,126,119,80831,80679,71474,69349,71418
60701,189,270,37563,23138,5.87109e+18,164.008,2538.81,60701,111,123,60382,60201,43434,50701,42223
62301,129,272,38472,23829,5.87476e+18,219.064,2847.63,62301,154,158,61153,59827,31256,30232,31000
44510,119,228,27524,16986,5.86989e+18,147.322,2285.34,44510,91,89,44205,44043,30847,30630,31089
91947,166,281,56685,35262,5.87258e+18,218.16,3349.49,91947,156,166,91207,90524,61984,56075,65443
17704,176,257,10926,6778,5.87244e+18,74.935,1396.22,17704,85,85,17447,17415,16779,16901,16659
20661,11,158,12801,7860,5.86972e+18,95.1067,1295.48,20661,69,76,11741,7678,1924,2678,1840
27678,56,217,17117,10561,5.87145e+18,164.156,1618.94,27678,88,96,26792,26156,7468,10644,11622
8869,122,249,5537,3332,5.88075e+18,148.893,1169.13,8869,96,90,8465,8135,5467,5769,5243
57572,2169,8845,36226,21346,5.73059e+18,537,14233.6,57572,575,287,48727,48122,17955,22026,795
92675,277,327,57399,35276,5.87655e+18,186.311,3913.17,92675,175,182,92348,92267,82090,86298,80644
43912,72,302,27133,16779,5.87437e+18,156.576,2546.81,43912,133,130,42158,40658,16725,22217,18274
85652,267,368,52954,32698,5.87084e+18,171.585,3347.01,85652,117,130,85284,85176,61268,72820,56394
31745,252,260,19654,12091,5.86946e+18,194.382,2125.35,31745,105,107,31485,31473,31446,31456,31391
32531,100,250,20104,12427,5.87003e+18,130.214,2073.13,32531,94,94,32031,31725,21789,20385,20891
85070,98,274,52273,32797,5.87132e+18,169.343,2964.16,85070,124,131,84050,83060,35099,36144,34204
34773,249,258,21512,13261,5.87634e+18,195.058,2149.17,34773,136,133,34515,34503,33743,34002,33927
67332,180,214,41600,25732,5.87009e+18,125.828,2652.21,67332,92,93,67118,67100,61146,64494,62084
38625,133,199,23795,14830,5.86983e+18,102.651,1980.83,38625,84,89,38418,38345,29289,29823,26578
81195,141,272,50130,31065,5.87426e+18,235.948,3250.7,81195,164,168,80051,79186,44330,40567,44062
9221,92,197,5713,3508,5.86936e+18,91.9217,1050,9221,71,77,8984,8902,6594,6167,6354
18408,168,282,11391,7017,5.87382e+18,121.258,1599.94,18408,92,93,18100,18007,13120,12727,12501
54426,300,328,33785,20641,5.87812e+18,145.976,3101.82,54426,140,148,54098,54070,52466,53327,52164
77207,37,342,47702,29505,5.87032e+18,160.196,3214.63,77207,117,114,70012,62008,14938,20840,18717
57987,259,300,35798,22189,5.87085e+18,151.608,2674.55,57987,105,108,57687,57617,54824,56441,55718
47357,238,269,29418,17939,5.87471e+18,177.611,2479.77,47357,145,136,47082,47023,41145,44641,44886
5059,133,193,3116,1943,5.87521e+18,57.7585,688.037,5059,59,63,4866,4865,4810,4814,4789
37127,72,250,22937,14190,5.87039e+18,125.712,2182.42,37127,96,95,36407,35822,17372,18205,19042
36529,259,274,22573,13956,5.87482e+18,170.842,2221.82,36529,121,126,36255,36213,34509,35228,35147
41303,176,263,25436,15867,5.87092e+18,164.065,2116.18,41303,108,112,40976,40765,29480,30091,27829
27930,26,244,17278,10652,5.87092e+18,83.0702,1689.29,27930,85,83,23179,17700,6299,7961,8802
23516,115,253,14571,8945,5.87172e+18,129.912,1608.53,23516,94,97,23103,22718,11991,11733,11543
45205,144,220,27805,17400,5.86997e+18,134.058,2011.66,45205,91,98,44936,44754,34674,33831,39751
26228,179,270,16232,9996,5.86994e+18,178.904,1950.92,26228,104,108,25837,25557,20483,19377,23459
74695,185,285,46502,28193,5.87908e+18,239.727,3407.25,74695,176,184,74028,73352,51466,48977,50492
97704,157,316,60280,37424,5.87243e+18,196.026,3633.71,97704,146,144,97052,96592,62368,64661,61161
71318,184,224,44092,27226,5.86992e+18,129.219,2800.53,71318,89,92,71094,71072,68202,69619,70519
94037,46,301,58677,35360,5.88661e+18,226.71,4053.9,94037,200,206,78625,64456,16549,25561,15214
85812,231,358,53039,32773,5.87101e+18,240.602,3290.18,85812,124,129,85402,85327,55762,48874,37698
70973,220,285,44196,26777,5.87896e+18,227.09,3278.71,70973,180,177,70598,70239,57635,62480,62164
93978,207,271,57948,36030,5.8701e+18,150.847,3132.34,93978,110,113,93707,93596,84719,89300,88509
70243,152,236,43449,26794,5.87011e+18,158.606,2821.49,70243,92,97,69976,69744,54829,57638,56500
42904,91,258,26474,16430,5.8703e+18,119.778,2155.18,42904,92,90,42507,42217,23808,23165,25929
46195,182,226,28561,17634,5.87057e+18,161.568,2068.89,46195,98,106,45932,45819,38271,42404,41195
42794,51,180,26403,16391,5.8702e+18,112.998,2047.84,42794,82,83,41627,39782,14693,18061,18282
33949,214,235,20990,12959,5.87035e+18,129.967,2037.12,33949,89,86,33714,33713,33682,33700,33702
34207,188,274,21123,13084,5.87445e+18,191.5,2141.82,34207,117,125,33848,33648,27518,29120,29962
28700,37,250,17634,11066,5.87079e+18,126.9,1706.46,28700,87,94,26699,24617,4863,6779,6161
61150,284,295,38351,22799,5.89271e+18,225.142,3328.44,61150,193,196,60855,60846,59350,60095,59781
94694,28,327,58686,36008,5.87437e+18,206.457,3832.77,94694,163,157,78298,60547,11594,22767,15499
26401,119,199,16315,10086,5.86996e+18,112.389,1751.08,26401,85,81,26187,26123,19643,20395,18664
75218,61,227,46447,28771,5.86997e+18,140.028,2823.1,75218,92,98,74075,72891,20221,27598,23253
19234,363,376,11918,7316,5.87166e+18,146.783,1937.57,19234,102,101,18858,18847,18756,18788,18510
32395,101,204,20041,12354,5.87047e+18,100.786,1918.27,32395,85,84,32159,32095,24287,22843,21672
29495,97,174,18185,11310,5.87013e+18,105.023,1671.96,29495,77,80,29287,29188,20662,19585,20869
87697,128,282,54223,33474,5.87074e+18,152.612,3080.98,87697,114,128,87100,86518,46804,45016,54036
17123,207,217,10536,6587,5.86933e+18,100.828,1271.22,17123,75,79,16906,16906,16774,16867,16898
35637,145,199,21986,13651,5.86975e+18,104.202,1905.18,35637,83,88,35438,35384,27792,30086,26327
36941,120,220,22865,14076,5.87002e+18,123.607,1827.09,36941,88,93,36648,36440,24609,22827,31931
90986,266,285,56071,34915,5.87022e+18,144.628,3152.42,90986,105,109,90701,90694,88746,89442,90319
80791,269,290,50586,30205,5.89012e+18,241.47,3778.78,80791,204,207,80501,80420,74409,77722,77278
7843,10,122,4825,3018,5.86759e+18,73.9334,757.195,7843,57,60,4329,2989,824,818,733
27895,96,258,17505,10390,5.8909e+18,185.099,2144.21,27895,166,147,25898,23529,11411,10948,12623
69834,84,304,43020,26814,5.87404e+18,198.863,3107.93,69834,148,149,67805,65927,19739,28777,22459
9959,107,129,6170,3789,5.86878e+18,74.8991,890.408,9959,65,67,9830,9800,8191,9020,8279
33636,204,219,20802,12834,5.87066e+18,122.738,1734.3,33636,86,95,33417,33384,30876,32246,33110
47442,91,274,29310,18132,5.8749e+18,220.972,2527.16,47442,136,142,45952,44458,19291,22133,21325
55880,110,259,34379,21501,5.87022e+18,121.491,2451.33,55880,94,105,55520,55176,27919,26618,28427
31193,21,219,19283,11910,5.86991e+18,131.666,1679.41,31193,88,93,25206,19880,3939,7521,4825
72088,251,300,44571,27517,5.87065e+18,181.618,2828.19,72088,105,115,71788,71738,71709,71682,71691
99098,64,307,61253,37845,5.87123e+18,234.046,3483.07,99098,136,144,96558,94418,20659,33536,30694
49261,52,235,30429,18832,5.87017e+18,121.948,2191.85,49261,92,97,47925,46424,10056,16745,14435
74402,194,301,45814,28588,5.871e+18,195.132,2986.05,74402,115,117,74043,73869,61287,65954,64369
14257,21,249,8912,5345,5.88218e+18,190.434,1472.21,14257,119,108,10056,7165,1435,2868,1080
48149,61,227,29580,18569,5.87103e+18,158.984,2116.73,48149,99,109,46972,46168,11529,17096,16770
67745,126,301,41811,25934,5.8711e+18,157.002,2880.57,67745,111,119,67159,66699,44406,45363,47163
45664,142,189,28169,17495,5.86995e+18,110.789,2024.98,45664,84,89,45475,45390,38737,41907,41520
57517,264,285,35812,21705,5.87939e+18,233.993,2977.03,57517,172,163,57232,57166,56321,56811,56893
84668,245,291,52949,31719,5.88891e+18,238.625,3848.29,84668,206,207,84338,84081,71107,73891,75385
3939,2,109,2449,1490,5.86817e+18,51.9726,512.64,3939,50,51,368,0,8,0,11
90401,90,273,56042,34359,5.87418e+18,232.539,3377.1,90401,168,165,87800,85151,28975,35482,34298
30102,150,217,18523,11579,5.87014e+18,127.146,1661.88,30102,85,89,29880,29750,22278,21939,25405
65490,18,259,40353,25137,5.87042e+18,133.037,2612.6,65490,97,106,47644,31179,7201,11451,5768
39673,16,179,24461,15212,5.86972e+18,101.441,1986.71,39673,82,83,26255,16483,4892,4223,4613
31997,18,307,19695,12302,5.87026e+18,92.4446,1980.09,31997,83,89,22287,13780,4657,4573,5995
85192,296,315,52588,32604,5.87123e+18,207.019,3322.61,85192,128,136,84877,84838,84582,84759,84468
91209,213,230,56215,34994,5.87011e+18,142.519,3058.33,91209,97,105,90979,90975,89820,89959,90159
31221,133,176,19262,11959,5.87018e+18,110.967,1727.59,31221,79,80,31045,30980,28589,29518,28613
16803,272,282,10448,6355,5.87876e+18,121.28,1660.56,16803,104,95,16521,16521,16506,16517,16342
95290,180,247,58844,36446,5.87013e+18,163.774,3321.24,95290,101,102,95035,94881,87912,91409,91781
37707,109,266,23215,14492,5.87133e+18,169.363,2055.67,37707,104,112,37115,36602,20696,21285,23444
14191,58,209,8712,5479,5.87062e+18,99.4024,1129.31,14191,76,81,13709,13403,4410,5680,6879
27219,1858,5013,17118,10101,5.71665e+18,505.855,8293.95,27219,279,239,22206,21596,11482,13777,7882
6705,20,144,4136,2569,5.86704e+18,65.5332,807.911,6705,65,65,4684,3291,1162,1613,1363
69119,225,271,43395,25724,5.89179e+18,223.37,3445.6,69119,195,194,68792,68537,59387,62911,63128
77218,28,306,48637,28581,5.89654e+18,239.141,3777.96,77218,208,202,49707,28591,8742,13009,7950
27402,36,279,17271,10131,5.89928e+18,191.751,2282.42,27402,162,164,18993,11858,4261,5513,3354
19469,157,253,12182,7287,5.88631e+18,204.453,1749.56,19469,136,132,18973,18542,12935,13283,13447
86981,260,285,53595,33386,5.87011e+18,146.684,3085.5,86981,105,108,86696,86689,84470,84939,86281
38469,188,272,24324,14145,5.90146e+18,205.048,2571.87,38469,182,176,38066,37581,27642,28247,33054
84268,139,218,51916,32352,5.87032e+18,130.494,2901.32,84268,95,103,84026,83844,64537,64526,72079
41746,171,397,25904,15842,5.87444e+18,181.233,2884.04,41746,141,140,41144,40701,25935,26019,24347
95367,162,270,59029,36338,5.87024e+18,219.912,3647.7,95367,138,144,94549,93565,68917,59452,73859
6440,18,109,3958,2482,5.87067e+18,55.7873,680.92,6440,55,56,4833,3205,1063,1538,1194
90098,12,307,56100,33998,5.88463e+18,243.666,3971.31,90098,198,202,47510,26076,7329,10138,3431
5622,33,118,3465,2157,5.86956e+18,70.667,632.121,5622,53,55,5164,4596,1533,2098,2164
86958,266,286,53918,33040,5.87892e+18,236.087,3618.55,86958,190,188,86672,86570,81115,84245,85003
53074,199,224,32611,20463,5.87045e+18,155.198,2213.31,53074,101,108,52832,52747,46449,49999,50103
11837,201,248,7302,4535,5.87266e+18,93.348,1207.22,11837,78,76,11589,11560,11216,11311,11197
77583,290,397,48074,29509,5.8736e+18,227.813,3487.95,77583,151,165,77186,77076,59502,66343,49639
74035,65,279,45728,28307,5.87021e+18,136.465,3041.6,74035,106,110,72639,71219,27882,32071,32914
64763,84,238,40046,24717,5.8701e+18,141.969,2726.05,64763,94,93,64226,64000,34446,31637,38678
20382,27,149,12588,7794,5.87026e+18,89.4647,1314.46,20382,70,73,17254,13210,3618,5721,3941
62952,177,328,39070,23882,5.8767e+18,158.13,3282.82,62952,142,147,62509,62146,55505,54575,53197
92714,31,318,57291,35423,5.87096e+18,208.658,3378.92,92714,125,133,81430,67538,11974,23366,10717
92101,222,282,56657,35444,5.87368e+18,201.867,3356.96,92101,153,163,91763,91517,75561,83993,72430
70702,1923,4895,44595,26107,5.83583e+18,317.097,9628.32,70702,312,239,65807,65363,26251,40560,7562
32267,201,257,19863,12404,5.87065e+18,138.062,1876.24,32267,97,103,31980,31868,28094,29913,28859
95434,28,216,58870,36564,5.86991e+18,135.169,3140.55,95434,94,99,80625,61493,14935,22170,16042
30203,252,267,18677,11526,5.8762e+18,168.033,2047.54,30203,128,129,29936,29925,28492,29311,29426
36523,21,321,22584,13939,5.87013e+18,159.883,2319.82,36523,101,101,26037,18193,5194,7017,4835
35659,23,310,22036,13623,5.87409e+18,125.447,2352.77,35659,116,110,27162,19527,5617,8264,5455
85869,299,411,53130,32739,5.87796e+18,234.723,4170.58,85869,180,186,85458,85347,72017,74660,56166
34996,268,287,21567,13429,5.87084e+18,118.896,2076.03,34996,100,101,34709,34695,33267,33912,33990
80041,84,273,49248,30793,5.87083e+18,173.531,2883.93,80041,121,132,78737,77551,24895,33119,36326
69941,39,276,43130,26811,5.8731e+18,206.675,2977.38,69941,149,154,63672,57457,11823,19941,11526
66629,36,286,41311,25318,5.87887e+18,203.517,3199.02,66629,175,177,56797,48168,10236,17761,9410
42048,142,302,25941,16107,5.87479e+18,166.089,2488.59,42048,131,130,41392,40968,22978,21226,19375
14193,13,166,8773,5420,5.86985e+18,86.704,1063.15,14193,70,72,9296,5660,1588,2217,1469
25670,236,258,15926,9744,5.87994e+18,206.22,1917.55,25670,138,130,25412,25346,23979,24713,25085
59755,227,279,36927,22828,5.87036e+18,130.366,2735.3,59755,104,109,59476,59353,53773,57098,56061
39956,66,222,24690,15266,5.87024e+18,118.752,2171.02,39956,89,88,39295,38447,20735,20618,21332
93062,107,315,57412,35650,5.87219e+18,202.114,3558.92,93062,146,143,91768,90398,41483,41956,45606
93916,136,302,57858,36058,5.87067e+18,156.657,3305.47,93916,121,131,93347,92915,57498,58551,59879
14459,60,153,8897,5562,5.86908e+18,96.7764,1086.28,14459,69,72,14142,13926,6842,7217,7842
22409,45,131,13825,8584,5.87023e+18,67.746,1376.76,22409,72,73,21393,19995,9176,9572,8107
35062,22,258,22069,12993,5.89525e+18,189.15,2447.5,35062,178,164,21478,12640,2982,5706,3220
61309,241,264,37949,23360,5.87106e+18,193.765,2555.02,61309,124,127,61042,60972,54912,58432,59179
62476,219,272,38482,23994,5.87174e+18,204.544,2642.18,62476,131,130,62173,61998,51908,57681,54002
55906,198,199,34497,21409,5.86986e+18,108.767,2369.97,55906,85,90,55707,55707,55706,55707,55706
48097,33,226,29771,18326,5.87025e+18,127.077,2075.91,48097,92,101,43528,36588,8621,13772,12963
97038,279,352,59827,37211,5.87033e+18,163.854,3529.2,97038,119,120,96686,96563,83683,91260,88798
25756,28,216,15937,9819,5.86995e+18,122.073,1544.08,25756,83,89,22246,18124,4256,6308,5889
94972,226,318,58531,36441,5.87059e+18,221.078,3375.23,94972,129,133,94617,94496,74182,83896,65681
96779,197,282,59844,36935,5.87084e+18,149.734,3274.22,96779,119,131,96442,96236,73253,79324,78352
10725,65,150,6629,4096,5.87047e+18,79.8387,923.96,10725,64,66,10488,10365,4929,4686,5921
78145,176,214,48287,29858,5.87011e+18,131.932,2849.84,78145,92,94,77931,77861,68309,73236,68967
87943,211,259,54355,33588,5.86995e+18,157.435,3249.78,87943,105,107,87663,87540,84198,86094,86376
15844,6,136,9807,6037,5.86955e+18,69.3411,1144.21,15844,68,69,5370,0,419,724,810
14866,107,211,9132,5734,5.87078e+18,94.9919,1170.45,14866,74,81,14638,14481,8399,7513,8035
58641,79,260,36142,22499,5.87012e+18,131.437,2503.9,58641,95,96,57985,57535,25306,28029,31145
53216,77,290,32877,20339,5.87118e+18,151.24,2529.64,53216,111,118,52178,51374,22334,28000,25611
20361,110,126,12618,7743,5.86966e+18,67.5262,1292.29,20361,73,75,20235,20235,18622,19392,18803
15909,196,213,9840,6069,5.87052e+18,96.3637,1197.24,15909,74,78,15696,15694,14612,15278,15409
42046,242,247,26017,16029,5.87011e+18,146.694,2334.4,42046,97,97,41799,41762,41778,41786,41793
63471,27,269,39091,24380,5.87119e+18,203.662,2661.38,63471,129,130,54072,43688,8367,14871,6358
9226,173,222,5748,3478,5.88497e+18,138.583,1136,9226,99,94,8991,8866,7586,8120,7611
99143,272,275,61109,38034,5.87653e+18,242.547,3642.95,99143,178,183,98865,98835,97810,98530,98865
21991,184,219,13612,8379,5.87051e+18,155.259,1454.71,21991,82,88,21768,21705,19162,20684,20834
81137,195,245,50136,31001,5.86985e+18,157.915,3075.82,81137,99,98,80892,80807,77887,79595,80176
67069,22,214,41428,25641,5.87016e+18,126.198,2646.59,67069,92,93,52111,38488,9453,12632,9916
34426,118,180,21311,13115,5.86962e+18,111.343,1684.39,34426,81,86,34222,34051,25009,24667,27256
15331,120,171,9486,5845,5.8699e+18,97.085,1131.98,15331,68,75,15160,15099,12599,13891,13473
33925,56,257,20906,13019,5.87234e+18,152.172,1979.14,33925,112,117,32322,31189,7095,11363,9457
32486,126,186,20111,12375,5.87025e+18,80.8699,1857.31,32486,80,80,32300,32272,29267,29806,28842
9486,92,125,5860,3626,5.86941e+18,61.9112,856.303,9486,63,65,9361,9355,8267,8317,7814
77430,131,275,47726,29704,5.87736e+18,229.031,3222.53,77430,175,172,75963,74277,38829,34873,41672
48181,19,296,29676,18505,5.87102e+18,135.826,2411.37,48181,95,100,35208,23186,6102,7160,5977
93623,126,230,57753,35870,5.8703e+18,151.52,3181.9,93623,93,99,93296,93027,55392,48495,51195
51730,106,259,31992,19738,5.87009e+18,160.928,2569.86,51730,101,99,51157,50815,31650,31014,31232
40704,203,226,25042,15662,5.86984e+18,124.096,1927.93,40704,90,94,40478,40463,37109,38535,38656
49032,102,266,30135,18897,5.87217e+18,163.815,2291.49,49032,113,117,48338,47703,24775,25853,28386
76063,206,274,46961,29102,5.87395e+18,209.718,3132.19,76063,168,154,75634,75195,61209,67666,60724
74982,230,272,46430,28552,5.87153e+18,197.044,2868.92,74982,136,135,74695,74580,63101,69856,66525
4171,14,76,2578,1593,5.86857e+18,68.8252,496.212,4171,55,60,2466,1409,545,718,704
44095,130,253,27148,16947,5.87016e+18,129.856,2080.95,44095,92,93,43809,43632,23155,21244,16789
79517,241,300,49156,30361,5.87072e+18,195.944,3064.02,79517,117,123,79217,79088,77532,78247,78322
9666,99,235,6028,3638,5.88331e+18,147.019,1211.39,9666,103,102,9034,8440,4782,4785,4177
66149,168,317,41465,24684,5.8903e+18,201.124,3591.9,66149,187,198,65253,64006,42075,39648,34870
90280,128,315,55685,34595,5.87236e+18,186.579,3496.54,90280,144,139,89362,88410,53047,50429,53980
92844,99,327,57565,35279,5.87609e+18,212.685,3921.71,92844,169,172,90435,87857,36282,39273,39052
76685,171,217,47282,29403,5.86985e+18,137.615,2799.53,76685,92,98,76468,76377,68714,73034,74320
75464,43,285,47034,28430,5.87972e+18,240.97,3440.08,75464,182,188,66183,57327,13595,20010,12412
74638,63,294,46091,28547,5.8702e+18,165.804,2847.63,74638,107,111,73245,72122,17786,26941,28602
30678,122,178,18858,11820,5.87011e+18,115.884,1607.4,30678,80,89,30488,30332,23335,24084,25337
45355,185,268,28109,17246,5.8731e+18,211.078,2338.79,45355,130,132,44951,44620,32945,37171,33776
70997,195,272,43863,27134,5.87553e+18,227.873,3094.08,70997,164,170,70479,69947,53445,58943,55708
75604,50,269,46557,29047,5.87127e+18,196.942,2901.06,75604,136,141,72072,69388,14479,23618,15615
33068,66,171,20440,12628,5.8696e+18,97.1078,1793.8,33068,82,82,32694,32174,18084,20083,17818
48069,160,226,29585,18484,5.86979e+18,127.814,2096.12,48069,93,96,47843,47748,35454,39133,38769
63457,213,297,39095,24362,5.87073e+18,150.852,2769.65,63457,114,119,63142,62978,50978,55397,48866
52445,182,235,32309,20136,5.87002e+18,119.179,2244.21,52445,93,96,52210,52181,43813,48281,44883
47022,34,196,28984,18038,5.87002e+18,97.2202,2197.01,47022,84,89,42200,34604,10603,14201,12674
64946,271,304,40112,24834,5.87412e+18,191.228,3049.76,64946,146,147,64642,64608,57122,61402,58268
17060,107,236,10486,6574,5.87118e+18,111.809,1301.66,17060,86,86,16742,16453,9661,9475,9160
45598,79,227,28176,17422,5.86978e+18,132.068,2291.43,45598,90,91,45177,44986,22487,21779,23739
7107,101,250,4430,2677,5.88679e+18,103.92,1090.5,7107,91,84,6664,6323,4563,4540,4072
12037,3,208,7407,4630,5.8703e+18,100.798,1045.72,12037,73,74,2150,0,12,151,107
55222,62,426,34272,20950,5.87514e+18,161.931,3448.26,55222,141,130,52260,49154,18453,19589,14418
3940,61,129,2430,1510,5.86723e+18,58.4467,543.336,3940,50,54,3790,3722,2240,2281,2395
52163,103,259,32155,20008,5.87017e+18,131.366,2374.36,52163,92,97,51758,51428,30151,31544,33763
22234,185,254,13699,8535,5.87045e+18,129.594,1579.83,22234,91,90,21980,21894,20773,21133,20737
98672,117,238,61011,37661,5.87014e+18,155.681,3307.63,98672,96,101,98275,97956,64903,59849,70326
77871,97,216,48020,29851,5.87006e+18,138.565,2838.84,77871,93,96,77439,77121,43523,39460,52406
98507,145,226,60899,37608,5.87031e+18,151.756,3279.39,98507,94,99,98239,97985,78523,79524,88780
42455,43,183,26161,16294,5.87031e+18,100.268,2063.9,42455,80,84,40214,36765,11164,14111,13229
5250,64,179,3255,1995,5.86911e+18,70.0419,699.141,5250,59,59,5011,4888,3101,3147,3393
31369,27,248,19383,11986,5.87018e+18,123.257,1954.65,31369,90,93,25298,18109,5539,6068,4384
82943,165,220,51195,31748,5.87016e+18,152.238,3039.5,82943,95,96,82714,82580,72918,77528,76253
8204,25,74,5108,3096,5.87025e+18,64.7184,674.7,8204,61,65,6593,4753,2455,2794,3353
93396,202,314,57619,35777,5.87212e+18,233.734,3545.04,93396,147,141,92987,92738,73788,82055,71044
6049,11,129,3744,2305,5.87076e+18,66.4771,714.477,6049,61,61,3392,2213,664,905,510
87126,101,303,53770,33356,5.87078e+18,161.088,3213.85,87126,117,124,86257,85489,41684,42469,41665
29069,199,216,17992,11077,5.86991e+18,126.283,1637.07,29069,83,89,28853,28829,27379,27727,28459
64683,134,225,39830,24853,5.87002e+18,131.097,2531.68,64683,93,97,64430,64229,47923,49895,53778
80529,150,303,49685,30844,5.87112e+18,165.075,3111.11,80529,116,122,80041,79731,57545,58139,62416
97763,202,328,60628,37135,5.87538e+18,206.885,3963.33,97763,170,171,97324,96936,76768,81687,83402
88695,60,279,54810,33885,5.87023e+18,147.596,3270.64,88695,109,114,86769,84551,25102,33000,31708
65732,216,288,40559,25173,5.86994e+18,147.286,2699.76,65732,100,104,65444,65409,54214,60202,57540
9760,65,125,5993,3767,5.8704e+18,73.6178,850.129,9760,62,63,9574,9503,5450,5188,5996
85753,87,285,53722,32031,5.88879e+18,222.97,3840.03,85753,204,199,79074,71096,25294,30219,30865
84653,253,285,52450,32203,5.87311e+18,206.32,3238.91,84653,146,149,84368,84316,73042,79569,79780
33167,65,155,20400,12767,5.8698e+18,91.7777,1725.41,33167,78,83,32783,32446,14916,15231,15769
7535,112,116,4631,2904,5.87061e+18,58.1141,741.893,7535,57,60,7419,7419,7413,7418,7419
90620,277,294,56564,34056,5.88722e+18,237.839,3970.17,90620,205,207,90326,90304,85477,87868,87098
17274,90,219,10633,6641,5.87012e+18,102.084,1253.86,17274,78,82,16965,16698,9035,9323,10896
45803,139,177,28239,17564,5.86987e+18,103.179,2072.47,45803,83,91,45626,45557,38646,41935,39740
40221,184,196,24835,15386,5.87015e+18,106.559,2063.5,40221,84,84,40025,40020,39358,39819,39865
88503,147,259,54608,33895,5.87011e+18,144.218,3039.43,88503,102,108,88192,87996,64336,65175,71684
97536,75,230,60224,37312,5.8703e+18,125.565,3211.27,97536,95,100,96850,96293,45898,46840,50785
40604,65,178,25090,15514,5.87004e+18,98.3625,1947.83,40604,81,87,40100,39677,17641,18372,20673
32539,171,330,20142,12397,5.87032e+18,164.705,2187.06,32539,98,96,32169,32018,28889,30052,29270
34097,134,195,21009,13088,5.87052e+18,106.746,1826.04,34097,83,85,33902,33804,30585,30234,32078
45405,192,273,28240,17165,5.87647e+18,220.072,2508.01,45405,149,144,45003,44708,35535,38908,35173
67730,230,234,41749,25981,5.87002e+18,132.755,2549.98,67730,99,107,67496,67496,67162,67368,67373
89326,269,303,55197,34129,5.87091e+18,160.181,3227.91,89326,117,128,89023,88963,77486,84258,83683
44901,135,198,27670,17231,5.87007e+18,116.973,2123.54,44901,88,87,44695,44594,39057,38747,41046
79312,163,218,48843,30469,5.87027e+18,127.785,2816.51,79312,94,103,79094,78993,69959,73492,74124
92933,228,289,57270,35663,5.87006e+18,143.938,3171.6,92933,104,108,92644,92615,78968,85874,83359
92002,129,305,57418,34584,5.887e+18,233.829,4037.99,92002,199,208,89056,84985,43266,44766,38200
51849,15,284,32341,19508,5.88188e+18,203.748,2891.86,51849,166,169,32184,18637,4822,8784,3417
56247,98,274,34727,21520,5.8744e+18,219.113,2723.73,56247,140,151,54723,53337,25348,27432,27451
22646,78,150,13963,8683,5.86911e+18,92.0317,1391.26,22646,72,75,22405,22313,13360,12767,14934
51787,136,305,32373,19414,5.88864e+18,192.393,3111.09,51787,175,182,50347,48483,28409,29303,25710
82361,258,316,51078,31283,5.87897e+18,216.983,3736.22,82361,177,189,82036,81915,70432,75744,68974
83968,84,315,51825,32143,5.87238e+18,207.383,3419.17,83968,144,142,82130,80485,28718,34099,36745
66012,221,273,40972,25040,5.87374e+18,202.666,2891.45,66012,153,144,65661,65422,54422,60088,57184
9258,61,151,5741,3517,5.86888e+18,74.5787,852.933,9258,62,62,9047,8956,5047,4960,5055
70750,97,286,43892,26858,5.87958e+18,248.5,3316.86,70750,179,184,67758,64409,26262,28365,26468
88073,294,300,54406,33667,5.8707e+18,195.994,3203.69,88073,124,126,87773,87752,87329,87665,87405
8043,94,138,4968,3075,5.87065e+18,84.6612,773.908,8043,59,62,7894,7804,6071,6326,6881
85429,57,289,52643,32786,5.87041e+18,145.807,3072.45,85429,102,110,83651,81424,22160,30860,31042
24041,126,256,14996,9045,5.88231e+18,190.569,1894.06,24041,134,133,23205,22234,12268,11422,12138
79177,239,307,49252,29925,5.88367e+18,242.493,3701.37,79177,196,192,78811,78576,65614,71500,70691
76728,136,232,47305,29423,5.87023e+18,132.456,2872.21,76728,92,97,76463,76267,54492,51049,51950
31810,167,308,19685,12125,5.87437e+18,120.066,2225.32,31810,115,108,31420,31264,26063,25702,24850
80605,246,285,50124,30481,5.87783e+18,206.929,3449.61,80605,174,176,80293,80182,69304,74585,72702
56993,89,259,35175,21818,5.86999e+18,138.958,2465.33,56993,97,96,56468,56051,29723,29432,35945
94220,95,297,58139,36081,5.87024e+18,162.544,3196.14,94220,113,117,93443,92703,37259,42067,45832
88624,29,285,55298,33326,5.88253e+18,249.952,3788.96,88624,197,199,69228,53910,10867,20191,10485
95349,190,318,59088,36261,5.87831e+18,229.85,3940.56,95349,191,191,94622,93823,62614,56568,56941
16813,135,240,10418,6395,5.87504e+18,158.034,1413.02,16813,98,97,16443,16145,11312,11397,10491
37108,129,258,23085,14023,5.87775e+18,200.242,2247.36,37108,146,136,36171,35035,19679,17973,20510
88979,223,279,55523,33456,5.88662e+18,218.569,3849.43,88979,201,197,88608,88222,75310,80718,80040
22359,46,236,13826,8533,5.87045e+18,107.998,1458.48,22359,85,89,21342,20583,4867,7266,8113
29522,106,327,18250,11272,5.87016e+18,144.19,2133.8,29522,100,96,28952,28621,18061,16634,17211
61615,240,271,37923,23692,5.87047e+18,164.132,2564.57,61615,117,121,61344,61331,52596,57798,55298
77703,253,262,47891,29812,5.87008e+18,138.532,2853,77703,101,107,77441,77434,76355,77041,77145
8102,69,134,4981,3121,5.86914e+18,69.568,810.991,8102,62,65,7940,7874,5313,5220,5083
82677,45,257,51144,31533,5.87045e+18,147.113,3135.47,82677,107,106,78011,72094,19855,26624,21019
80896,119,232,49905,30991,5.87019e+18,132.01,2940.74,80896,93,98,80573,80300,49716,44326,48495
74490,260,276,46087,28403,5.87698e+18,235.442,3247.61,74490,179,175,74209,74146,71179,72691,73435
39584,168,196,24444,15140,5.87034e+18,110.142,1960.53,39584,83,86,39388,39332,35459,37732,36235
69930,1165,1770,44128,25802,5.88243e+18,219.085,5094.36,69930,229,203,68160,68144,42555,48463,8639
31527,241,260,19413,12114,5.87142e+18,129.966,1862.83,31527,100,103,31267,31242,28430,30066,29213
59866,193,199,36937,22929,5.87035e+18,119.815,2461.27,59866,85,91,59667,59659,59533,59566,59644
78893,172,273,48814,30079,5.87099e+18,156.818,2862.46,78893,116,128,78517,78287,54824,49585,60587
61780,126,268,37975,23805,5.87115e+18,165.495,2552.45,61780,115,122,61194,60640,34703,32741,40465
74817,151,273,45967,28850,5.87181e+18,155.64,2777.77,74817,118,123,74376,74065,48324,42005,50393
63604,91,202,39230,24374,5.86983e+18,120.111,2525.91,63604,86,93,63206,62948,34800,32492,37408
23517,122,253,14450,9067,5.87249e+18,166.216,1639.26,23517,94,96,23126,22833,14604,12913,13406
82691,185,307,51463,31228,5.88416e+18,242.99,3791.39,82691,198,195,81955,81077,54869,54655,58627
83318,228,307,51878,31440,5.88455e+18,248.324,3822.73,83318,199,197,82904,82571,66305,71448,70950
56656,131,286,35679,20977,5.89582e+18,231.249,3207.81,56656,196,191,54363,51015,28992,26408,30515
58401,133,256,36066,22335,5.87023e+18,151.252,2520.91,58401,92,94,58073,57942,30338,26585,19417
44417,204,290,27462,16955,5.87164e+18,156.724,2353.5,44417,107,112,44115,43970,34305,37829,33384
46006,156,194,28388,17618,5.86982e+18,118.075,2185.19,46006,84,87,45812,45761,41819,44019,43527
28553,149,175,17526,11027,5.86987e+18,116.614,1536.77,28553,80,86,28378,28326,25204,26955,26026
57648,182,228,35637,22011,5.87009e+18,133.678,2293.22,57648,94,102,57419,57332,49044,53757,54506
18820,2,213,11627,7193,5.87092e+18,99.0393,1295.63,18820,77,83,1756,0,148,0,264
88671,48,271,54833,33838,5.87009e+18,192.846,3418.42,88671,117,121,83721,77563,19492,27278,23909
73044,120,216,45035,28009,5.86984e+18,129.079,2701.1,73044,92,100,72750,72471,48626,46791,51739
82943,235,293,51105,31838,5.87073e+18,149.949,3089.96,82943,120,129,82650,82598,69893,77234,66041
80683,132,285,49711,30972,5.87017e+18,149.928,2973.35,80683,106,110,80326,80033,43244,37839,45719
62570,142,274,38638,23932,5.87411e+18,221.291,2845.11,62570,160,149,61636,60919,34763,31923,34796
84833,14,286,52612,32221,5.87906e+18,235.258,3607.86,84833,187,191,51959,29632,8425,12731,4005
56288,122,274,34753,21535,5.87427e+18,215.472,2691.89,56288,150,142,55187,54000,26473,26506,28270
54774,48,273,34104,20670,5.87876e+18,192.837,2826.72,54774,169,156,49083,43907,9939,14873,11485
40526,157,173,25018,15508,5.87019e+18,104.945,1920.16,40526,82,87,40353,40344,38886,39653,39477
16343,7,242,10115,6228,5.87378e+18,144.467,1370.08,16343,92,92,6861,0,1011,1501,475
93363,150,277,57794,35569,5.87119e+18,186.11,3172.22,93363,135,145,92723,92199,55781,48770,57668
84824,145,298,52425,32399,5.87081e+18,200.55,3138.72,84824,122,127,84332,83998,55970,49528,61612
44120,254,259,27220,16900,5.87001e+18,121.995,2191.57,44120,90,90,43861,43858,43829,43826,43861
99123,76,316,61123,38000,5.87279e+18,187.213,3688.32,99123,153,152,96594,94551,31523,39686,37624
51191,253,266,31520,19671,5.87088e+18,190.819,2355.8,51191,115,120,50925,50909,49752,50307,50256
79402,197,397,49208,30194,5.87342e+18,206.824,3715.76,79402,153,162,78814,78378,51872,49807,50275
80728,188,274,49798,30930,5.87311e+18,220.05,3147.03,80728,148,157,80184,79701,57655,61766,63209
73985,168,279,45889,28096,5.87939e+18,236.191,3335.86,73985,184,178,73095,71956,49294,46154,48670
88546,31,328,54833,33713,5.8771e+18,186.444,3846.36,88546,168,176,73522,58658,13255,22616,13246
31880,13,307,20092,11788,5.89971e+18,203.987,2454.25,31880,170,172,14194,5667,1418,2919,269
75953,16,381,47000,28953,5.87086e+18,173.223,3323.27,75953,130,135,52168,35071,8469,13826,4272
94862,29,317,58611,36251,5.87274e+18,192.453,3651.14,94862,149,155,80514,65131,14651,23985,14605
80180,7158,7822,50507,29673,5.78422e+18,459.03,13974.2,80180,490,287,72358,72358,62990,67762,26627
31949,230,264,19700,12249,5.87323e+18,197.901,1960.43,31949,114,114,31681,31612,28099,30142,30225
90248,214,411,55843,34405,5.87759e+18,201.264,4275.58,90248,181,181,89708,89356,64297,60680,52814
74024,166,328,45934,28090,5.8771e+18,175.333,3575.48,74024,158,164,73378,72791,59290,58924,57508
62564,155,259,38536,24028,5.87007e+18,115.863,2592.18,62564,95,105,62297,62207,45210,40322,42006
14101,20,157,8673,5428,5.86955e+18,100.947,1079.45,14101,69,70,11011,8304,2166,2535,2263
71638,118,285,44670,26968,5.88143e+18,235.116,3363.28,71638,187,183,69375,66514,32457,30447,34601
68416,95,426,42936,25480,5.89052e+18,225.984,4038.79,68416,196,204,63412,57580,18337,24262,14409
23612,32,217,14614,8998,5.8702e+18,105.662,1474.25,23612,81,84,21207,18063,4467,7049,5534
98065,45,242,60521,37544,5.8703e+18,154.413,3303.98,98065,97,97,93200,86708,23053,32532,28050
13938,214,253,8646,5292,5.87953e+18,143.996,1425.18,13938,107,107,13676,13626,11805,12729,12241
91984,169,270,56958,35026,5.87023e+18,241.027,3716.8,91984,155,161,91025,89796,62719,53809,68544
16678,389,426,10411,6267,5.88576e+18,149.38,2132.8,16678,131,120,16252,16230,16110,16139,14976
54307,111,290,34049,20258,5.89217e+18,231.288,3153.09,54307,192,190,51206,47218,22074,22993,21874
96581,264,307,60235,36346,5.88634e+18,244.33,4130.93,96581,211,201,96262,96123,88023,90178,93447
48860,6,247,30043,18817,5.87045e+18,118.033,2188.59,48860,90,97,16998,0,1850,2893,7
79308,159,285,49458,29850,5.88112e+18,233.332,3536.17,79308,196,182,78161,76828,49056,45803,48262
63847,58,234,39469,24378,5.87009e+18,138.418,2659.63,63847,90,90,62522,60373,20470,22816,24717
43431,32,266,26690,16741,5.87229e+18,167.125,2176.09,43431,108,114,38643,32998,5862,10726,7866
74730,104,217,46103,28627,5.87022e+18,130.965,2774.41,74730,90,94,74360,74056,46392,46207,52624
52497,132,217,32347,20150,5.8702e+18,123.318,2355.76,52497,88,93,52259,52095,36786,34845,35506
18698,24,145,11505,7193,5.86927e+18,97.9527,1226.97,18698,69,74,15297,11336,3142,4682,4744
23727,160,175,14626,9101,5.87004e+18,83.8854,1547.19,23727,78,78,23552,23549,22565,23118,22693
43076,38,195,26566,16510,5.86999e+18,119.044,2053.17,43076,86,87,40066,36685,9379,13542,13615
4336,74,130,2678,1658,5.86624e+18,63.3925,602.993,4336,62,62,4199,4153,3780,3854,3860
49765,56,251,30674,19091,5.87028e+18,115.627,2258.62,49765,94,102,48544,47230,17458,21377,22195
59711,268,304,36842,22869,5.87439e+18,203.498,2943.27,59711,146,147,59407,59372,51363,55914,52113
70679,187,257,43695,26984,5.87045e+18,146.236,2916.44,70679,103,102,70372,70193,56171,53633,62304
11783,192,206,7288,4495,5.87096e+18,89.5315,1031.89,11783,71,73,11577,11577,11189,11429,11457
99111,76,279,61002,38109,5.87442e+18,221.795,3510.94,99111,170,164,95795,93052,22353,35392,27974
51792,325,327,32138,19654,5.87708e+18,155.095,3027.75,51792,138,140,51465,51465,51462,51463,51387
61016,2446,14231,38604,22412,5.65645e+18,672.076,20025.5,61016,851,321,46785,45678,9727,16375,2850
40976,113,226,25354,15622,5.87045e+18,130.842,1937.64,40976,91,97,40651,40344,24176,22992,31212
21419,229,239,13185,8234,5.87105e+18,115.34,1460.54,21419,90,87,21180,21180,20974,21058,21153
60679,135,194,37495,23184,5.86981e+18,126.639,2475.47,60679,86,89,60463,60349,51500,53567,54360
52585,168,197,32460,20125,5.87012e+18,107.859,2247.04,52585,86,92,52388,52388,49734,50592,50063
58621,40,249,36017,22604,5.87101e+18,157.224,2379.43,58621,107,112,55307,51103,10112,15701,13704
82065,316,366,50735,31330,5.87046e+18,179.465,3394.2,82065,111,110,81699,81679,81615,81634,81554
57997,134,286,36528,21469,5.89594e+18,221.941,3237.46,57997,196,190,55825,52677,29485,27801,34060
57112,83,237,35300,21812,5.87011e+18,124.892,2329.76,57112,92,103,56487,56012,24731,25925,31692
61345,129,202,37842,23503,5.87e+18,122.569,2488.67,61345,86,93,61110,60935,46455,44760,51392
43285,132,220,26778,16507,5.87021e+18,132.912,1973.95,43285,91,98,43001,42807,31389,29177,35752
34561,34,179,21325,13236,5.87034e+18,111.029,1816.73,34561,78,81,31086,25637,6841,10731,7909
62725,122,269,38811,23914,5.87093e+18,163.457,2567.2,62725,112,124,62126,61559,33952,33104,41421
11425,118,153,7035,4390,5.87023e+18,89.9282,962.08,11425,67,69,11272,11220,10070,10076,10246
61138,227,300,38606,22532,5.90101e+18,218.857,3305.67,61138,198,191,60816,60588,50800,52103,53973
80522,11,230,49674,30848,5.87009e+18,134.868,2935.24,80522,93,99,43530,27678,7732,7935,5913
24573,33,256,15134,9439,5.87254e+18,135.333,1666.56,24573,94,99,21872,18746,3688,5989,3772
26744,123,162,16573,10171,5.87034e+18,103.749,1470.84,26744,74,79,26576,26465,21643,23749,22460
72190,55,272,44448,27742,5.87149e+18,194.365,2809.75,72190,134,134,69445,67354,15299,23635,17677
36897,136,192,22808,14089,5.86984e+18,108.968,1975.22,36897,84,86,36705,36624,29644,32196,30138
72166,83,220,44471,27695,5.87007e+18,122.88,2759.83,72166,90,97,71666,71376,34940,35076,39859
25478,142,193,15790,9688,5.86987e+18,104.06,1582.8,25478,75,77,25285,25238,24960,24899,25148
11070,13,125,6826,4244,5.86856e+18,60.6188,928.759,11070,67,66,6533,3796,1449,1043,1275
62859,200,215,38760,24099,5.87005e+18,133.415,2566.81,62859,88,94,62644,62637,62305,62404,62421
79896,258,276,49278,30618,5.87322e+18,197.505,3142.21,79896,146,153,79613,79554,70674,75596,75978
32882,177,270,20342,12540,5.87025e+18,191.342,2181.11,32882,111,116,32444,32071,25328,23754,28103
71706,247,274,44376,27330,5.87111e+18,163.189,2729.15,71706,116,127,71432,71414,63702,68023,68433
49625,278,314,30678,18947,5.87254e+18,141.032,2699.28,49625,115,112,49311,49287,48209,48680,48008
67930,263,270,42461,25469,5.88502e+18,228.376,3305.33,67930,194,188,67660,67660,67018,67462,67443
35287,100,157,21769,13518,5.87001e+18,94.4096,1781.96,35287,78,84,35081,34963,24407,23332,25959
45865,38,262,28672,17193,5.88903e+18,236.808,2767.42,45865,177,178,36092,27839,6724,10730,6658
97935,14,227,60433,37502,5.86998e+18,142.994,3213.81,97935,95,100,61118,35775,11247,13123,7487
78222,57,228,48165,30057,5.87017e+18,136.064,2794.52,78222,98,104,76662,74915,20039,28197,27387
78362,26,288,48327,30035,5.87015e+18,142.771,2955.91,78362,105,108,65281,49613,11029,18261,10184
60897,258,269,37515,23382,5.8711e+18,205.658,2614.77,60897,127,135,60628,60628,59997,60188,60515
98089,246,270,60652,37437,5.8702e+18,197.38,3504.84,98089,113,115,97819,97728,97431,97631,93604
88741,27,261,54874,33867,5.87005e+18,172.139,3295.32,88741,108,105,72350,52336,14959,21451,16645
80928,125,216,49882,31046,5.86988e+18,130.304,2823.43,80928,95,103,80647,80334,58390,58647,68190
24784,39,143,15360,9424,5.87025e+18,68.7766,1489.84,24784,76,75,22888,20463,9536,10393,10696
25373,44,162,15700,9673,5.86943e+18,108.479,1440.75,25373,78,81,24345,23128,6926,9237,10554
80225,103,279,49571,30654,5.87026e+18,154.48,3129.4,80225,107,113,79513,79008,38506,33325,37580
7002,97,122,4314,2688,5.86985e+18,56.7038,718.158,7002,60,59,6880,6876,6709,6803,6654
78992,187,217,48720,30272,5.87015e+18,131.234,2864.57,78992,91,98,78775,78753,72569,76455,75997
96820,118,285,60389,36431,5.88222e+18,242.699,3911.43,96820,203,198,93693,89656,43367,41072,43969
95976,212,426,59807,36169,5.88056e+18,203.079,4710.6,95976,187,192,95442,95138,74373,71446,63966
69350,120,215,42752,26598,5.87021e+18,132.984,2684.76,69350,91,95,69070,68841,49573,49297,53988
67934,3,307,42211,25723,5.88203e+18,236.489,3408.12,67934,184,181,10661,0,17,588,461
92332,171,285,57658,34674,5.88392e+18,247.009,3912.08,92332,201,200,91239,89752,60353,57417,66004
97960,24,298,60443,37517,5.87064e+18,170.659,3366.4,97960,124,128,80529,61181,13522,23042,13634
73175,130,203,45089,28086,5.87009e+18,126.632,2707.87,73175,92,98,72928,72788,56068,54448,63935
22497,87,246,13891,8606,5.86927e+18,100.793,1653.84,22497,87,92,22045,21769,9643,9263,9089
91289,216,317,56484,34805,5.87291e+18,190.849,3565.76,91289,150,156,90859,90553,69120,73877,66857
44280,171,180,27321,16959,5.87016e+18,116.865,2081.72,44280,83,84,44100,44090,43512,43878,43996
3429,46,123,2121,1308,5.8685e+18,47.3287,498.47,3429,48,49,3266,3164,2160,2223,2304
62634,200,220,38694,23940,5.87009e+18,137.436,2622.8,62634,90,91,62414,62404,61979,61979,62253
27916,138,173,17296,10620,5.86968e+18,95.1307,1651.59,27916,78,79,27743,27710,25773,26669,25265
21161,178,223,13126,8035,5.87021e+18,78.0284,1466.36,21161,78,80,20938,20917,20791,20795,20772
7847,112,114,4841,3006,5.87035e+18,56.1437,773.96,7847,61,62,7733,7733,7732,7733,7733
29866,63,175,18395,11471,5.86953e+18,90.6646,1685.55,29866,79,80,29447,29052,14529,14215,13204
59959,39,265,36915,23044,5.87123e+18,157.806,2505.17,59959,111,122,55923,51459,11440,17717,12062
66704,6,274,41156,25548,5.87382e+18,219.731,2911.53,66704,144,156,23606,0,2783,4073,2130
42580,144,197,26318,16262,5.87049e+18,123.768,1943.48,42580,87,91,42371,42295,33701,37687,36390
31095,24,175,19165,11930,5.87072e+18,104.024,1737.3,31095,78,79,24819,17888,4925,8418,3790
41701,9,286,25822,15879,5.87712e+18,218.266,2505.96,41701,149,139,19840,0,3417,4192,1521
92819,134,259,57357,35462,5.87015e+18,151.687,3341.34,92819,105,107,92344,91884,66304,65345,76681
60708,73,285,37815,22893,5.87985e+18,237.929,3074.62,60708,173,168,56814,53173,13510,21126,17243
2729,57,71,1675,1054,5.87057e+18,57.9919,385.322,2729,51,51,2646,2567,2291,2321,2564
58365,176,184,35913,22452,5.86993e+18,121.559,2382.07,58365,86,91,58181,58172,57547,57795,58181
72613,77,211,44871,27742,5.87011e+18,122.861,2790.4,72613,89,91,72178,72005,32461,32595,35042
35862,208,295,22171,13691,5.87101e+18,108.001,2116.52,35862,86,91,35567,35524,35201,35251,34991
18875,202,247,11708,7167,5.8703e+18,129.607,1619.48,18875,89,91,18628,18597,17692,18164,18352
38384,46,257,23636,14748,5.87079e+18,172.488,2041.31,38384,107,109,36362,34673,7554,12433,11390
13289,92,162,8209,5080,5.8701e+18,88.3791,1024.34,13289,70,70,13098,12930,8729,8434,9840
15583,50,139,9644,5939,5.86898e+18,92.8473,1109.65,15583,67,68,15158,14749,5721,6316,6465
60112,29,262,37019,23093,5.87013e+18,135.701,2540.37,60112,97,101,51878,41516,9123,14277,10986
46440,219,266,28598,17842,5.87157e+18,166.78,2237.28,46440,107,117,46166,46091,39853,43518,42086
11284,108,239,7034,4250,5.88008e+18,128.507,1261.16,11284,104,94,10775,10246,5604,5283,5512
6235,51,102,3859,2376,5.86701e+18,55.9631,643.591,6235,57,58,6053,5799,4509,4379,5043
4657,85,136,2862,1795,5.86824e+18,62.2182,588.101,4657,54,58,4521,4467,3403,3328,3711
19433,24,246,12002,7431,5.87383e+18,172.342,1543.02,19433,109,104,15623,12316,2433,4493,3319
25509,102,170,15728,9781,5.87069e+18,79.5139,1559.82,25509,76,77,25334,25238,21019,20233,19809
47783,70,183,29555,18228,5.86993e+18,96.0101,2177.16,47783,82,87,47426,46967,23847,23553,23317
71644,42,315,44222,27422,5.87108e+18,193.114,2988.7,71644,114,119,67468,62155,13135,21627,19385
30567,46,165,18807,11760,5.87034e+18,108.256,1575.7,30567,77,84,29526,28487,8559,11688,10537
65851,69,284,40665,25186,5.87028e+18,161.325,2686.17,65851,104,107,64834,63969,17667,26328,28729
80682,19,294,50686,29996,5.89387e+18,239.049,3846.69,80682,207,201,47042,23664,6155,11724,6816
48942,175,187,30258,18684,5.87025e+18,110.2,2188.14,48942,81,82,48755,48755,48229,48567,48618
94270,239,288,58126,36144,5.87014e+18,152.198,3206.72,94270,106,110,93982,93944,86127,89245,91729
41365,61,270,26029,15336,5.89427e+18,211.342,2710.94,41365,181,174,34660,28116,8634,12202,11575
55017,16,279,33991,21026,5.87067e+18,124.528,2625.75,55017,102,109,36266,22886,6116,9161,6283
10880,167,246,6736,4144,5.86984e+18,116.312,1246.99,10880,80,81,10627,10503,8917,8873,9618
90927,227,307,56743,34184,5.88675e+18,225.712,4022.94,90927,196,207,90512,90201,69830,73800,65588
68001,21,266,41780,26221,5.87145e+18,185.572,2674.05,68001,124,129,54194,42054,6921,14065,6285
28125,157,272,17358,10767,5.87343e+18,191.725,1925.2,28125,107,109,27737,27555,19804,19747,21552
66133,129,306,40961,25172,5.8739e+18,187.683,3070.98,66133,142,149,65130,64089,38659,37965,33932
84673,9,270,52428,32245,5.87033e+18,247.121,3540.4,84673,146,155,36827,0,5017,7584,3038
82363,87,220,50835,31528,5.87005e+18,152.718,3027.17,82363,95,96,81856,81631,41055,39080,44555
55287,134,274,34317,20970,5.88049e+18,194.85,2903.04,55287,167,160,54032,52518,29764,27689,29583
2677,84,126,1644,1033,5.86783e+18,46.8285,441.465,2677,45,48,2551,2546,2495,2528,2482
74492,8,288,45958,28534,5.87001e+18,138.448,2888.33,74492,104,106,32848,0,5086,5986,2881
74572,146,286,46272,28300,5.87991e+18,239.536,3394,74572,186,181,73197,71798,41205,37675,44712
17915,73,144,11061,6854,5.86855e+18,70.1262,1275.88,17915,74,74,17757,17630,14219,14382,13493
82564,105,342,50996,31568,5.87039e+18,154.43,3289.7,82564,116,108,81826,81308,49298,48624,55996
41201,71,221,25298,15903,5.87043e+18,124.721,1921.81,41201,93,96,40517,40102,15121,17240,21202
11843,26,149,7334,4509,5.86866e+18,79.2113,963.683,11843,65,69,10126,8059,2187,3240,2990
32415,3720,4913,20382,12033,5.75492e+18,426.431,8341.77,32415,281,229,27502,27497,23491,24431,9710
42259,225,274,26568,15691,5.89404e+18,203.377,2725.67,42259,181,173,41967,41845,36026,38044,37876
84628,23,262,52172,32456,5.86996e+18,144.645,2983.69,84628,103,108,68097,51107,11641,16465,11734
53793,165,288,33150,20643,5.8707e+18,156.251,2546.58,53793,114,118,53404,53166,36027,32319,31255
93205,117,285,58010,35195,5.8788e+18,235.876,3725.98,93205,197,189,90629,87406,40530,38906,41412
23868,15,272,14719,9149,5.87221e+18,166.415,1750.71,23868,98,99,15911,9442,2952,3782,2040
33071,23,197,20452,12619,5.86998e+18,116.863,1820.72,33071,79,82,26126,19190,5059,7432,6233
24949,128,219,15444,9505,5.87039e+18,117.308,1520.08,24949,80,87,24709,24557,17270,15994,16027
23794,251,258,14703,9091,5.88044e+18,187.389,1822.37,23794,125,125,23536,23532,23259,23439,23455
11917,26,151,7320,4597,5.8692e+18,79.0937,986.418,11917,64,67,10078,7788,2306,2939,2921
43354,15,262,26695,16659,5.87156e+18,164.524,2175.02,43354,107,115,29721,18241,5484,8008,3337
94209,9,328,58355,35854,5.87657e+18,194.643,3951.5,94209,169,179,44341,0,6767,9154,4856
5739,164,230,3578,2161,5.87386e+18,102.988,884.466,5739,73,72,5509,5472,4015,4275,3738
58836,128,265,36931,21905,5.89071e+18,231.227,3155.13,58836,193,191,56578,53469,29280,26494,30703
29125,153,174,17945,11180,5.86984e+18,103.964,1658.78,29125,77,78,28951,28919,28227,28630,28633
58152,229,281,36246,21906,5.8805e+18,200.751,3002.58,58152,172,171,57833,57658,48715,53162,48345
95342,158,318,59059,36283,5.87823e+18,234.029,3871.26,95342,193,190,94081,92806,47995,45428,43132
35301,121,261,22153,13148,5.89149e+18,218.221,2444.18,35301,168,165,33625,31319,16972,15575,18246
35990,104,257,22198,13792,5.87269e+18,158.436,2078.08,35990,120,120,35152,34326,16303,16314,15209
44562,131,317,28010,16552,5.895e+18,227.749,2929.64,44562,180,185,42749,40240,18089,18048,11480
25804,7,248,15891,9913,5.8704e+18,125.839,1670.4,25804,86,91,10494,0,1618,1876,1168
96553,45,285,60094,36459,5.87841e+18,236.859,3806.33,96553,191,195,86338,77120,16923,26258,18750
88056,94,226,54438,33618,5.86993e+18,140.196,3086.27,88056,91,96,87610,87350,46105,43907,50014
2741,126,139,1712,1029,5.87012e+18,66.8041,468.827,2741,51,47,2602,2548,2321,2510,2598
90107,86,286,55977,34130,5.88132e+18,238.088,3776.3,90107,196,197,85115,79549,25680,34712,32982
77478,20,300,47899,29579,5.87099e+18,187.537,2998.47,77478,116,119,59314,44124,9614,17446,8334
31530,240,256,19527,12003,5.87134e+18,147.69,1856.83,31530,102,104,31274,31224,29275,30375,30833
50879,55,226,31302,19577,5.86973e+18,125.792,2136.46,50879,92,100,49685,48488,13218,18376,19829
31323,60,159,19342,11981,5.86993e+18,79.7478,1699.19,31323,75,79,30886,30324,15044,15384,17457
39887,27,173,24647,15240,5.86991e+18,97.0246,1914.35,39887,83,86,33590,25493,6966,9888,9060
98657,192,281,60643,38014,5.87112e+18,161.803,3293.75,98657,125,129,98299,98045,73689,80020,80126
59185,225,293,36427,22758,5.87076e+18,171.058,2557.76,59185,116,121,58892,58840,47721,53438,41656
48824,72,290,30182,18642,5.87149e+18,158.036,2433.26,48824,111,118,47666,46775,16478,22402,19876
28559,17,240,17629,10930,5.87076e+18,102.63,1756.49,28559,81,81,19737,12528,3178,4930,3122
30266,154,217,18701,11565,5.87022e+18,116.45,1886.8,30266,85,85,30049,29933,27655,28607,27496
52546,154,260,32474,20072,5.87024e+18,161.26,2598.59,52546,101,105,52182,51865,37660,32957,42601
8316,112,242,5265,3051,5.90011e+18,165.18,1186.61,8316,114,109,7651,6923,3694,3455,3358
63078,262,313,39139,23939,5.87931e+18,193.704,3272.2,63078,175,176,62765,62712,53886,58567,53466
98854,49,295,61660,37194,5.88601e+18,236.36,4122.57,98854,206,207,83845,70124,15542,26138,17398
38353,140,257,23687,14666,5.86983e+18,137.126,2244,38353,99,99,37953,37632,27716,25086,30427
94614,278,285,58865,35749,5.87898e+18,232.675,3770.64,94614,191,193,94329,94319,91757,93560,93339
46540,383,426,29143,17397,5.88703e+18,192.258,3491.97,46540,171,173,46114,46074,43708,44832,40832
1981,42,85,1218,763,5.8662e+18,37.9202,330.963,1981,42,43,1889,1824,1043,1081,950
60585,271,272,37307,23278,5.87197e+18,203.858,2625.03,60585,132,131,60313,60313,60312,60313,60313
52488,160,211,32387,20101,5.87024e+18,131.587,2283.05,52488,89,94,52277,52194,49857,50855,50430
79167,190,275,49039,30128,5.87275e+18,203.897,3080.59,79167,145,144,78721,78269,56094,60738,56784
27610,180,251,16954,10656,5.87288e+18,130.069,1731.22,27610,97,103,27335,27234,20757,23026,20875
74378,216,266,45794,28584,5.87099e+18,188.245,2806.09,74378,132,130,74083,73890,63102,69104,64940
12247,14,152,7612,4635,5.86948e+18,64.7146,1052.9,12247,68,71,7526,4476,1248,2053,1364
7099,107,111,4372,2727,5.86691e+18,58.5561,660.536,7099,60,59,6988,6988,6962,6972,6988
38691,126,194,23914,14777,5.86967e+18,108.546,2012.9,38691,83,85,38488,38397,28474,29067,28960
39209,116,268,24214,14995,5.87488e+18,163.656,2273.36,39209,131,132,38352,37394,17997,18067,16479
9558,27,77,5888,3670,5.86868e+18,72.0737,744.167,9558,65,69,7767,5612,2635,3140,3538
91326,196,282,56317,35009,5.87287e+18,218.746,3341.45,91326,152,160,90834,90316,67339,75623,73484
29403,60,162,18074,11329,5.87073e+18,109.065,1550.45,29403,77,82,28882,28555,12151,12084,13985
73651,180,273,45679,27972,5.87376e+18,218.237,3030.13,73651,151,155,73084,72567,51994,51509,56378
15031,3796,4546,9429,5602,5.62237e+18,526.277,6710.81,15031,227,211,10485,10485,9683,9713,7022
71583,172,342,44194,27389,5.87024e+18,142.855,3096.92,71583,115,111,71155,70928,56109,54384,59309
61618,257,327,38218,23400,5.87564e+18,148.828,3209.76,61618,137,138,61291,61226,58710,58840,57054
18609,62,183,11511,7098,5.86941e+18,84.2238,1455.8,18609,78,80,18183,17633,9859,9374,9254
91430,7,327,56670,34760,5.87666e+18,186.619,3914.8,91430,170,181,35045,0,4731,6653,2907
8035,52,109,4933,3102,5.86877e+18,55.2159,764.049,8035,59,60,7856,7613,5767,5972,6243
9283,58,158,5751,3532,5.86962e+18,71.5135,941.09,9283,65,67,9026,8858,3908,3889,4101
61755,64,272,38108,23647,5.87368e+18,214.974,2823.55,61755,147,152,58929,56592,15128,23245,17356
73794,75,279,45596,28198,5.87043e+18,157.883,3051.71,73794,109,113,72711,72048,26130,29210,31369
90524,105,307,56415,34109,5.88547e+18,238.414,3978.43,90524,209,197,86195,81076,35547,36280,37210
48191,208,285,29991,18200,5.87924e+18,229.616,2724.58,48191,155,150,47804,47497,38115,42166,38995
18119,68,182,11204,6915,5.87002e+18,83.1348,1417.79,18119,81,79,17822,17446,11487,11755,11494
59114,272,285,36824,22290,5.88017e+18,216.846,3043.03,59114,169,171,58829,58791,56160,57553,56334
36053,137,171,22273,13780,5.86987e+18,100.175,1883.09,36053,82,84,35882,35836,31491,33630,32040
95288,134,279,58541,36747,5.87132e+18,167.871,3180.96,95288,128,133,94652,94071,53431,47788,61606
18236,21,142,11266,6970,5.87005e+18,79.4292,1226.17,18236,70,72,14152,10525,3172,4421,4147
8405,95,220,5233,3172,5.8762e+18,120.51,1019.72,8405,85,78,7983,7593,3977,3978,3525
83386,93,293,51379,32007,5.87013e+18,164.519,2986.9,83386,108,116,82633,81884,37502,37719,41257
33939,155,238,20996,12943,5.86991e+18,134.223,2049.47,33939,90,90,33682,33452,29864,30153,30285
88468,143,325,54834,33634,5.87848e+18,221.536,3895.63,88468,183,188,87010,85587,49420,50482,44488
10387,74,145,6385,4002,5.87006e+18,74.547,921.375,10387,66,68,10196,10111,7316,7144,7364
85619,25,278,52808,32811,5.87792e+18,228.913,3443.91,85619,185,181,68425,52400,8440,20157,7402
87536,219,274,53799,33737,5.8712e+18,181.649,3041.84,87536,133,136,87233,87110,74297,81086,78930
53899,45,275,33174,20725,5.8752e+18,203.201,2612.38,53899,139,137,49857,46231,9914,15882,10025
10741,114,132,6614,4127,5.86956e+18,66.1894,939.732,10741,60,61,10609,10596,10198,10411,10102
62859,199,217,38706,24153,5.87035e+18,128.555,2564.93,62859,90,96,62642,62637,61157,61768,62286
46420,55,260,28681,17739,5.86976e+18,150.97,2438.65,46420,99,103,44730,42350,11027,14954,13853
42736,127,265,26435,16301,5.87132e+18,170.677,2166.45,42736,110,114,42232,41789,25260,25562,29667
29730,122,381,18408,11322,5.87199e+18,160.606,2318.02,29730,113,111,29076,28537,16499,16206,16811
92150,12,286,57432,34718,5.88567e+18,215.777,3939.51,92150,205,197,48326,26425,6987,10630,5109
17190,63,279,10633,6557,5.86979e+18,115.953,1523.72,17190,79,87,16548,16208,4430,6156,5764
18187,99,255,11266,6921,5.87794e+18,153.4,1584.29,18187,114,109,17410,16673,8902,8865,9663
97489,404,426,60716,36773,5.88028e+18,180.314,4723.17,97489,182,189,97063,97037,96520,96843,93284
13280,142,270,8352,4928,5.89909e+18,159.273,1608.2,13280,133,125,12768,12149,7896,7321,6182
23621,77,236,14606,9015,5.87068e+18,109.253,1502.24,23621,85,90,23128,22758,8290,9602,12536
67891,50,268,42039,25852,5.87175e+18,197.143,2737.23,67891,129,138,64785,62424,13914,21677,17016
94467,89,227,58288,36179,5.86991e+18,140.849,3161.22,94467,94,102,93905,93562,47195,45106,55404
64867,220,271,40391,24476,5.88425e+18,224.056,3200.83,64867,192,184,64517,64148,54925,58261,58211
21690,6,141,13382,8308,5.87057e+18,73.0111,1372.91,21690,73,72,7176,0,675,1389,664
80767,173,273,49611,31156,5.87108e+18,158.82,2881.6,80767,123,127,80387,80136,58171,52900,61309
55523,82,411,34482,21041,5.87607e+18,157.843,3451.71,55523,151,140,53448,51471,29019,28993,28252
19830,174,275,12225,7605,5.87174e+18,80.0731,1511.41,19830,79,82,19555,19533,19327,19331,19138
50329,104,317,31579,18750,5.89297e+18,215.566,3172.03,50329,182,190,47060,43208,20827,20294,12174
67659,45,260,41691,25968,5.87075e+18,131.918,2669.21,67659,98,102,64819,61639,15427,20970,19344
90259,231,276,55980,34279,5.87338e+18,221.942,3342.53,90259,167,158,89911,89647,75196,83116,81035
63767,9,284,39372,24395,5.87014e+18,164.481,2649.67,63767,104,107,31220,0,4766,6456,2429
90976,104,262,56113,34863,5.87007e+18,142.842,3078.76,90976,104,109,90431,89871,49313,47187,61750
39535,77,322,24571,14964,5.88042e+18,133.31,2714.46,39535,145,142,37435,35303,18955,19765,14033
17129,74,139,10521,6608,5.86932e+18,94.0989,1162.76,17129,67,75,16894,16792,9333,8986,9671
17825,121,131,10969,6856,5.86906e+18,69.6331,1161.65,17825,72,73,17694,17694,17105,17393,17281
6689,27,134,4118,2571,5.87053e+18,74.5224,708.215,6689,56,59,5824,4818,1540,2135,2131
67345,52,211,41482,25863,5.87009e+18,132.306,2577.74,67345,92,97,65613,63271,17595,24749,24256
45968,21,279,28417,17551,5.87026e+18,144.813,2482.4,45968,103,98,33334,23627,7031,9129,7049
90662,89,231,55894,34768,5.87017e+18,145.445,3048.97,90662,95,101,90035,89547,41360,40057,40489
53434,89,196,32999,20435,5.87018e+18,97.8484,2366.51,53434,84,85,53157,53035,34651,32363,33883
10936,122,201,6753,4183,5.86974e+18,94.3526,994.99,10936,69,73,10721,10610,8254,8344,9635
95042,99,328,58943,36099,5.87564e+18,206.584,3924.44,95042,167,170,92829,90403,42397,43966,53206
89677,9,227,55352,34325,5.86993e+18,130.314,3089.32,89677,94,99,41990,0,6866,8368,5151
14911,137,212,9183,5728,5.8697e+18,88.0343,1176.87,14911,76,78,14699,14633,11498,11420,10795
88950,15,227,54899,34051,5.86997e+18,138.709,3075.71,88950,92,98,57470,33612,10762,10876,9228
96239,99,294,59412,36827,5.87032e+18,164.541,3204.84,96239,112,118,95490,94697,44315,44681,53707
49977,48,224,30728,19249,5.86975e+18,137.284,2125.41,49977,94,104,48242,46886,11289,16813,18062
42877,114,381,26555,16322,5.87149e+18,184.219,2656.01,42877,116,125,42077,41356,18799,19407,20287
64464,263,285,40130,24334,5.87977e+18,209.844,3146.14,64464,171,176,64179,64132,57233,61291,59741
78573,252,273,48711,29862,5.87366e+18,215.806,3118.9,78573,154,154,78285,78163,67803,74022,74040
25500,124,252,15779,9721,5.87198e+18,142.301,1674.38,25500,100,100,25076,24705,14732,14422,17146
50146,25,272,31155,18991,5.87738e+18,187.367,2633.84,50146,155,148,40016,30659,5968,11501,6375
75380,422,426,47171,28209,5.88637e+18,211.29,4318.42,75380,189,199,74954,74943,74952,74951,73931
83568,28,327,51806,31762,5.87501e+18,197.988,3666.38,83568,160,152,68510,52291,10837,20293,12288
78309,159,279,48400,29909,5.87087e+18,153.487,2942.64,78309,114,125,77912,77635,49389,40815,43366
61577,115,250,38063,23514,5.87019e+18,144.035,2782.27,61577,104,103,61077,60704,39318,37346,40712
13520,120,257,8388,5132,5.86949e+18,107.015,1357.76,13520,83,84,13208,13056,7299,6324,7540
33961,11,252,20904,13057,5.87154e+18,171.946,1899.91,33961,104,102,19932,13139,3696,4749,812
10047,18,145,6220,3827,5.87112e+18,68.2373,975.467,10047,69,70,6835,4154,1495,1349,1830
42970,102,285,26712,16258,5.87847e+18,224.203,2548.24,42970,149,139,41565,40128,18333,17755,16070
11866,185,245,7394,4472,5.878e+18,187.583,1286.86,11866,98,98,11588,11443,9828,10719,9646
31824,58,269,19683,12141,5.87603e+18,176.368,2095.85,31824,129,131,29629,27938,8266,12434,9698
74372,151,268,45684,28688,5.87139e+18,165.178,2764.45,74372,123,127,73912,73568,48914,45290,53833
48834,61,190,30099,18735,5.86946e+18,109.189,2128.22,48834,85,93,48070,47475,15734,19146,22313
44405,95,196,27411,16994,5.87043e+18,116.145,2088.09,44405,83,87,44098,43908,27187,25567,28305
85142,110,285,52959,32183,5.87804e+18,243.282,3585.07,85142,177,187,82697,79968,38360,37691,42452
51857,103,316,32053,19804,5.87398e+18,152.941,2814.27,51857,131,129,50810,49903,29864,30086,29028
65228,154,271,40962,24266,5.89278e+18,226.159,3366.41,65228,193,194,63862,61850,40770,38208,44142
66112,177,270,40937,25175,5.87019e+18,199.763,2991.46,66112,119,122,65664,65250,49654,46658,57153
93686,8,279,57932,35754,5.87015e+18,157.472,3353.21,93686,109,108,39621,0,5598,6653,3403
8065,34,143,4951,3114,5.86948e+18,63.7123,794.858,8065,62,64,7279,6194,2823,3076,3467
66617,202,208,41148,25469,5.87002e+18,112.873,2685.13,66617,88,91,66409,66409,66405,66409,66211
4074,16,74,2536,1538,5.86668e+18,57.4816,475.761,4074,55,57,2672,1676,658,943,1063
59208,49,265,36634,22574,5.87106e+18,169.549,2498.56,59208,115,123,56743,54759,13070,19506,17049
56358,193,315,34842,21516,5.87329e+18,152.234,2898.44,56358,126,127,55958,55769,48263,46949,45670
48827,81,314,30201,18626,5.87401e+18,149.9,2739.3,48827,129,126,47435,46259,20560,22940,21653
5408,6,123,3343,2065,5.87164e+18,55.1997,645.844,5408,56,59,1866,0,158,375,454
29254,63,172,18057,11197,5.8705e+18,78.0016,1671,29254,77,79,28865,28499,17516,17628,19381
67612,152,275,41691,25921,5.87818e+18,231.268,3049.69,67612,173,168,66655,65817,40764,34834,38983
41546,56,172,25652,15894,5.86982e+18,99.2907,1991.58,41546,80,82,40730,39314,14535,16785,17886
13974,31,79,8678,5296,5.86962e+18,67.3773,891.356,13974,67,69,12017,9209,5243,5370,6732
19507,201,249,12169,7338,5.88066e+18,183.666,1678.29,19507,134,119,19226,19081,16617,17547,17375
13290,114,260,8385,4905,5.89757e+18,185.331,1497.05,13290,140,133,12195,10772,6695,6273,8526
78326,131,271,48404,29922,5.87072e+18,146.773,2910.95,78326,114,115,77857,77395,40895,37364,33598
91526,239,309,56310,35216,5.87175e+18,227.102,3349.19,91526,125,135,91203,91074,77724,85067,81243
32812,31,170,20231,12581,5.8696e+18,102.72,1689.8,32812,79,82,28996,23901,6920,9914,9650
11517,21,133,7117,4400,5.86921e+18,68.4961,978.406,11517,66,68,8882,6524,1897,2793,1841
84629,143,285,52814,31815,5.8826e+18,246.193,3705.26,84629,195,194,82916,81025,46486,41305,49555
75387,88,279,46602,28785,5.8698e+18,151.559,3064.54,75387,108,106,74533,74018,40654,38150,42083
93519,247,289,57633,35886,5.87022e+18,143.414,3180.74,93519,104,108,93230,93221,85125,89981,88681
42728,51,258,26364,16364,5.87008e+18,119.248,2157.96,42728,88,88,41409,39627,12995,16130,14332
92370,61,282,56791,35579,5.87094e+18,154.198,3151.49,92370,119,130,90261,88656,22041,32737,32677
83197,205,397,51519,31678,5.87265e+18,178.849,3810.45,83197,148,146,82706,82449,68891,68402,66621
11391,1227,2738,7116,4275,5.58113e+18,759.709,4622.99,11391,190,189,8653,7677,5515,5578,5422
40621,178,252,24996,15625,5.86986e+18,127.999,2011.97,40621,90,96,40369,40316,29066,34135,25599
87785,28,316,54431,33354,5.87878e+18,227.052,3838.48,87785,185,193,69654,52687,12799,20594,10218
66047,128,285,40637,25410,5.87063e+18,150.361,2714.74,66047,102,109,65688,65378,35491,31658,37116
71083,161,315,43879,27204,5.87299e+18,161.401,3174.62,71083,136,136,70513,70160,54714,52124,54050
63516,174,281,39247,24269,5.87045e+18,155.85,2629.82,63516,101,107,63227,63109,49397,54878,47734
19891,7,126,12237,7654,5.86974e+18,66.5718,1276.9,19891,73,73,7402,0,1050,836,680
30294,234,400,18866,11428,5.88844e+18,219.363,2597.97,30294,159,162,29878,29761,18687,17384,10108
85919,169,278,52854,33065,5.87294e+18,204.774,3222.63,85919,160,149,85330,84708,57583,50476,52722
5303,71,101,3245,2058,5.87162e+18,51.1371,596.433,5303,55,53,5202,5202,4084,4085,3563
58017,60,184,35717,22300,5.87003e+18,119.103,2381.99,58017,85,89,57150,56142,20074,22550,24673
12677,215,250,7862,4815,5.87275e+18,94.7519,1260.3,12677,78,81,12427,12396,11786,12081,12010
72321,21,245,44699,27622,5.87019e+18,169.551,2899.92,72321,97,96,53262,38032,9800,12431,8330
95821,97,263,59027,36794,5.87012e+18,141.991,3166.44,95821,103,110,95196,94609,47689,48009,57242
47666,59,199,29420,18246,5.87015e+18,123.212,2175.9,47666,84,89,46822,45931,16148,18657,18776
60105,90,217,37093,23012,5.87017e+18,114.604,2510.08,60105,88,91,59715,59437,36261,34594,37980
40692,168,221,25152,15540,5.87028e+18,136.961,1919.36,40692,91,99,40456,40350,34175,36904,38588
45697,165,287,28884,16813,5.90162e+18,209.685,2822.12,45697,186,183,44937,43715,28195,28730,34761
62352,10,215,38501,23851,5.86998e+18,128.776,2553.36,62352,90,93,31903,21666,5128,5428,3792
85121,232,280,53135,31986,5.88373e+18,214.354,3699.85,85121,201,192,84787,84534,73126,79035,77582
81194,167,315,50114,31080,5.87248e+18,175.802,3358,81194,141,139,80662,80295,64038,63685,65336
35049,188,260,21606,13443,5.87179e+18,196.363,2030.38,35049,114,114,34728,34518,27595,29778,25699
70327,206,270,43543,26784,5.8702e+18,202.982,3083.11,70327,121,126,69979,69772,60074,64914,65713
73703,288,316,45765,27938,5.87986e+18,235.341,3554.59,73703,177,189,73387,73361,67116,70416,68631
55444,98,273,34454,20990,5.87753e+18,231.758,2790.96,55444,157,157,53515,51599,22403,22676,22133
95006,150,328,58881,36125,5.87643e+18,188.135,3968.9,95006,169,179,93931,92761,61385,64176,62950
69204,223,296,42615,26589,5.87061e+18,156.088,2840.98,69204,118,122,68908,68827,57458,63015,52819
1332,18,51,828,504,5.86867e+18,38.3709,227.42,1332,37,38,1009,674,374,418,575
40827,193,296,25183,15644,5.8713e+18,129.318,2283.61,40827,94,95,40522,40417,37629,37902,37721
56273,126,286,35437,20836,5.89635e+18,230.924,3194.31,56273,196,191,53732,50026,27131,25103,31036
82776,3,276,51655,31121,5.88702e+18,222.812,3712.58,82776,204,195,12417,0,6,780,806
50673,80,266,31202,19471,5.8714e+18,169.874,2335.36,50673,108,120,49641,48883,14697,22445,21047
98523,61,321,60854,37669,5.87019e+18,180.186,3550.42,98523,108,111,96512,94212,31127,36176,37863
12142,218,224,7606,4536,5.88302e+18,163.12,1315.72,12142,113,109,11918,11911,11668,11834,11870
61123,175,272,37720,23403,5.87341e+18,206.9,2800.59,61123,141,150,60588,60129,44058,41226,42460
37326,261,279,23087,14239,5.86974e+18,158.72,2265.39,37326,102,97,37047,37017,36767,36925,36498
56025,182,266,34437,21588,5.87133e+18,171.841,2444.26,56025,113,120,55674,55450,40921,43111,43558
12129,3,127,7480,4649,5.8689e+18,76.4713,999.968,12129,62,64,2085,0,77,56,305
78783,194,262,48555,30228,5.87018e+18,137.026,2866.97,78783,102,106,78521,78423,68701,72384,73206
2934,47,127,1804,1130,5.86771e+18,58.0948,506.488,2934,51,55,2707,2515,1538,1415,1735
10770,172,204,6664,4106,5.87107e+18,73.3445,1043.05,10770,73,75,10566,10537,10268,10452,10237
63226,314,326,39111,24115,5.8715e+18,187.607,2885.87,63226,113,117,62900,62886,62886,62899,62757
90760,216,301,55910,34850,5.8705e+18,158.56,3255.83,90760,121,131,90433,90323,70102,80134,66320
16555,92,190,10231,6324,5.86935e+18,85.3066,1389.43,16555,78,80,16347,16296,11384,10560,10025
67942,172,239,42001,25941,5.87062e+18,149.608,2562.16,67942,106,114,67658,67531,53705,59704,56885
43786,153,199,27004,16782,5.87015e+18,98.8494,2106.16,43786,85,90,43587,43542,37407,40140,36161
25489,59,270,15776,9713,5.86998e+18,188.912,1935.52,25489,104,107,24059,22767,6977,8040,8256
83199,217,270,51520,31679,5.87015e+18,237.463,3450.93,83199,139,144,82770,82379,70219,76415,74620
9431,33,203,5801,3630,5.8697e+18,88.5908,934.542,9431,71,72,8476,7422,1637,2827,2272
5363,71,102,3326,2037,5.86973e+18,49.7054,601.47,5363,53,53,5261,5261,3983,3865,3736
83033,183,270,51411,31622,5.87018e+18,238.358,3457.67,83033,141,145,82359,81577,59896,53552,68287
7512,182,194,4652,2860,5.87064e+18,82.1739,833.552,7512,62,67,7318,7318,7244,7283,7317
9080,67,208,5620,3460,5.87006e+18,84.8414,947.469,9080,70,71,8777,8590,4711,5369,5509
81205,49,276,50829,30376,5.88719e+18,223.741,3674.51,81205,202,196,68396,56458,13799,21058,16414
64272,119,242,39713,24559,5.87019e+18,119.938,2521.99,64272,94,104,63937,63626,37730,35080,50135
9508,117,192,5862,3646,5.86929e+18,65.7162,943.133,9508,67,69,9316,9263,8055,7953,7881
51073,218,279,32254,18819,5.90054e+18,218.37,2986.85,51073,191,185,50752,50469,41747,42966,44773
93234,183,285,57970,35264,5.87695e+18,218.703,3670.52,93234,185,180,92528,91675,63896,64129,71888
75929,102,307,47436,28493,5.88815e+18,227.322,3722.21,75929,193,202,71668,66547,29230,29352,30236
55411,60,314,34258,21153,5.87314e+18,168.468,2889.46,55411,130,127,53141,51120,15415,20609,19711
94482,147,285,58960,35522,5.88274e+18,242.444,3899.38,94482,203,199,92732,90639,51609,46001,50544
59234,126,266,36424,22810,5.87259e+18,190.592,2598.1,59234,131,128,58442,57595,30529,27474,31075
19497,129,145,12103,7394,5.86924e+18,66.5733,1294.73,19497,72,72,19352,19352,18782,19109,18595
97373,114,226,60171,37202,5.87013e+18,154.446,3262.44,97373,95,99,96992,96680,61325,58065,70539
35594,78,250,21895,13699,5.87017e+18,118.779,1929.28,35594,89,98,35060,34708,14283,16858,17899
18505,117,219,11444,7061,5.86951e+18,105.892,1316.92,18505,75,81,18271,18148,14031,15153,15079
60792,166,234,37573,23219,5.8705e+18,122.755,2422.39,60792,95,105,60558,60463,47685,52804,55073
11480,169,217,7099,4381,5.87015e+18,78.1864,1121.58,11480,74,75,11263,11222,10428,10813,10353
92233,186,283,56855,35378,5.87253e+18,205.322,3368.73,92233,157,161,91715,91203,62015,59605,55073
27497,4,248,17351,10146,5.90133e+18,193.786,2154.52,27497,170,159,4764,0,10,309,336
63606,201,300,39189,24417,5.87145e+18,150.652,2782.72,63606,105,112,63267,63130,57120,57866,56942
69451,40,274,42699,26752,5.87331e+18,207.014,2843.5,69451,141,144,64184,58338,10665,18508,12871
1580,11,76,976,604,5.86414e+18,55.3165,307.439,1580,45,45,799,516,153,238,258
39717,99,220,24581,15136,5.87027e+18,126.317,1895.64,39717,90,98,39332,39003,21239,21389,28116
78405,293,397,48596,29809,5.87327e+18,209.943,3725.02,78405,154,159,78008,77896,67057,70911,60430
82153,15,259,50775,31378,5.87007e+18,140.701,3165.76,82153,105,106,51241,29345,10303,11239,7982
27110,158,251,16701,10409,5.87299e+18,167.492,1781.19,27110,116,112,26726,26469,18800,18522,18651
85554,395,411,52931,32623,5.87792e+18,206.895,4167.9,85554,181,181,85143,85119,83621,84525,81760
31348,74,258,19410,11938,5.87363e+18,198.976,1938.82,31348,109,107,30300,29530,8210,11489,6741
47005,58,250,29044,17961,5.86957e+18,143.099,2418.78,47005,100,102,45559,43634,12191,15666,16429
36260,94,195,22389,13871,5.87007e+18,109.514,1955.09,36260,83,82,36000,35876,21646,19567,19865
60796,376,397,37683,23113,5.87356e+18,176.246,3326.67,60796,148,145,60399,60370,57950,59641,56969
95926,90,426,59392,36534,5.8734e+18,172.372,4268.28,95926,146,133,94132,92373,49301,45858,48584
16029,114,243,9877,6152,5.87264e+18,144.196,1352.08,16029,89,93,15612,15257,9058,9330,10833
49432,267,275,30513,18919,5.87824e+18,231.955,2650.2,49432,151,156,49157,49122,49025,49101,49055
15568,38,125,9597,5971,5.87077e+18,60.088,1120.33,15568,69,68,14518,13210,5674,6635,5798
72213,12,297,44494,27719,5.87068e+18,154.501,2938.9,72213,118,123,42901,26644,7846,9185,4141
87500,263,342,54024,33476,5.87037e+18,159.242,3376.72,87500,118,114,87158,87054,83321,84947,83685
32291,182,270,19997,12294,5.87008e+18,202.461,2153.01,32291,108,110,31891,31598,24078,21423,26700
16007,17,187,9894,6113,5.86888e+18,102.925,1264.03,16007,74,77,11470,7672,2035,2315,2018
95685,178,281,58920,36765,5.87097e+18,182.331,3225.41,95685,137,136,95234,94854,64594,61781,64430
40156,5,226,24705,15451,5.86983e+18,129.476,1919.46,40156,91,98,11946,0,455,1905,1022
83391,29,313,51424,31967,5.87334e+18,190.362,3410.03,83391,150,149,70758,57551,10615,20107,9463
96100,181,327,59579,36521,5.8762e+18,221.485,3996.29,96100,174,178,95443,94744,67658,70299,67189
25399,19,247,15762,9637,5.87005e+18,117.922,1842.78,25399,93,94,17230,10864,3776,4401,2662
58650,105,207,36215,22435,5.86998e+18,112.908,2520.49,58650,88,88,58383,58225,38619,36288,38227
67799,50,276,41830,25969,5.87379e+18,199.703,2930.46,67799,146,149,63727,60232,14499,22019,16839
76851,11,274,47493,29358,5.8754e+18,229.344,3209.65,76851,177,168,43405,27835,7422,9876,3442
26351,13,214,16178,10173,5.8712e+18,120.983,1567.67,26351,85,89,16533,9824,2596,3863,3117
51010,241,257,31401,19609,5.86999e+18,118.708,2331.43,51010,94,95,50753,50740,49471,49581,50584
65564,159,271,40519,25045,5.86975e+18,189.077,2913.18,65564,107,111,65150,64689,46709,40825,51697
74817,147,270,45953,28864,5.87164e+18,174.378,2786.72,74817,122,125,74301,73901,45562,40860,44536
41265,40,267,25557,15708,5.87123e+18,165.368,2122.49,41265,104,113,38539,35253,8304,12827,11275
94674,204,278,58300,36374,5.87061e+18,168.358,3158.09,94674,128,132,94344,94097,78459,85759,80596
38960,99,247,24077,14883,5.87012e+18,130.371,2212.08,38960,92,90,38517,38323,25157,23733,24384
94226,45,307,58705,35521,5.88502e+18,245.283,4062.86,94226,201,200,79645,66462,15112,24456,17777
53375,284,291,32876,20499,5.87056e+18,169.423,2516.95,53375,113,119,53084,53081,52402,52882,52748
54738,231,244,33602,21136,5.87092e+18,154.382,2291.37,54738,108,110,54494,54494,51541,53491,52851
15901,77,155,9832,6069,5.86969e+18,98.9416,1134.77,15901,69,72,15652,15509,9726,9250,11593
94315,124,327,58435,35880,5.87431e+18,199.331,3822.88,94315,163,157,93089,91593,52008,49669,60770
21522,71,147,13271,8251,5.86944e+18,86.387,1350.05,21522,70,74,21277,21207,12171,11954,13351
91422,155,264,56400,35022,5.87011e+18,142.328,3096.72,91422,103,110,91118,90959,69475,68509,78168
55565,236,266,34310,21255,5.87042e+18,154.747,2534.51,55565,93,97,55299,55240,45873,51340,44228
5778,1,138,3559,2219,5.86687e+18,53.7972,701.131,5778,58,58,0,0,0,0,0
44992,265,290,27811,17181,5.87168e+18,157.915,2357.79,44992,108,113,44702,44679,39692,42693,42292
1723,176,188,1087,636,5.885e+18,78.7812,481.258,1723,52,52,1535,1532,1523,1526,1503
93128,136,246,57397,35731,5.8699e+18,142.577,3089.32,93128,101,106,92838,92556,67006,66258,73300
92401,300,352,56930,35471,5.8704e+18,176.107,3471.46,92401,120,118,92049,91996,81831,87608,87137
64383,204,290,39792,24591,5.87107e+18,153.24,2751.57,64383,112,120,64073,63912,48104,52804,46354
67126,151,203,41362,25764,5.87021e+18,123.171,2592.02,67126,89,94,66915,66808,58254,61046,64046
84755,130,232,52177,32578,5.87011e+18,130.839,2901.73,84755,98,104,84476,84208,60388,56591,65410
57663,80,381,35662,22001,5.87114e+18,154.991,3038.09,57663,123,117,56455,55593,26795,28169,28095
31624,116,257,19570,12054,5.87373e+18,155.81,1911.97,31624,113,112,31018,30398,15814,14855,16628
95390,308,381,58992,36398,5.87069e+18,167.146,3694.67,95390,134,136,95009,94901,84843,90661,82071
3625,10,105,2224,1401,5.8648e+18,50.3807,493.874,3625,50,50,2037,1418,348,366,508
68484,199,313,42284,26200,5.87405e+18,200.224,3136.86,68484,148,148,68018,67643,50310,47358,44469
50773,79,397,31478,19295,5.87391e+18,179.136,3054.96,50773,145,142,48788,47151,13783,18686,14655
51602,257,266,31929,19673,5.87249e+18,190.886,2407.82,51602,123,128,51336,51321,49694,50868,51040
15346,56,246,9684,5662,5.9014e+18,187.111,1626.69,15346,141,134,11997,9199,2997,4046,4490
60057,7,234,36916,23141,5.8705e+18,124.051,2383.44,60057,93,108,23921,0,3576,4329,2516
40531,227,340,25181,15350,5.87851e+18,120.056,2817.03,40531,134,132,40191,40149,36593,36705,34303
44758,10,221,27677,17081,5.87022e+18,161.325,2043.18,44758,95,105,24639,17302,3922,5448,3332
39185,261,299,24169,15016,5.87136e+18,136.939,2257.91,39185,97,99,38886,38832,36875,38024,37751
61618,210,285,38069,23549,5.87017e+18,162.736,2604.21,61618,100,105,61333,61249,54853,58289,56401
86551,96,303,53356,33195,5.87095e+18,175.051,3200.79,86551,120,125,85584,84743,40672,39782,45534
4854,42,76,2989,1865,5.87212e+18,62.7482,526.566,4854,59,60,4525,4037,2711,2517,3364
53907,205,311,33308,20599,5.87404e+18,160.848,2805.12,53907,134,132,53520,53309,41567,41105,39947
85175,190,303,52515,32660,5.87079e+18,208.439,3211.34,85175,121,125,84780,84541,65838,69110,68658
84125,221,316,51922,32203,5.87321e+18,192.06,3467.38,84125,147,151,83727,83464,67327,72229,67935
30036,90,296,18645,11391,5.87547e+18,133.075,2150.89,30036,118,119,29038,28112,19671,20855,18831
72255,172,275,44541,27714,5.87698e+18,224.989,3114.19,72255,164,167,71567,70844,47508,43108,45895
47989,5,226,29697,18292,5.87037e+18,129.216,2089.25,47989,92,99,14375,0,222,2567,1440
2905,92,169,1798,1107,5.87087e+18,57.0155,561.216,2905,54,58,2736,2720,2417,2429,2269
2781,55,103,1713,1068,5.86753e+18,48.6372,424.428,2781,46,44,2666,2621,1640,1678,1870
32409,208,299,20042,12367,5.87548e+18,166.541,2252.55,32409,128,129,32074,31891,24747,26482,22748
86699,245,313,53462,33237,5.8733e+18,192.05,3469.44,86699,151,152,86359,86208,74210,79528,69700
25966,155,170,16008,9958,5.87074e+18,84.1516,1563.36,25966,75,77,25796,25791,25793,25796,25796
2821,106,122,1726,1095,5.86836e+18,48.1886,452.789,2821,47,48,2699,2698,2626,2651,2628
17868,16,240,11059,6809,5.87327e+18,151.126,1425.43,17868,96,93,12855,9373,2036,3652,1720
62758,98,304,38689,24069,5.87427e+18,206.573,2988.43,62758,150,147,61164,59630,23240,28218,22800
29749,147,264,18418,11331,5.87281e+18,197.531,1859.9,29749,97,110,29312,29115,19326,17273,21056
64086,44,225,39589,24497,5.87028e+18,130.083,2653.29,64086,90,89,60627,55596,15468,21038,17280
10887,119,134,6682,4205,5.86899e+18,67.4832,918.83,10887,63,66,10753,10737,10176,10466,10219
66013,232,341,40627,25386,5.8704e+18,175.239,2828.61,66013,107,115,65672,65549,44698,53185,42960
74913,171,272,46137,28776,5.87121e+18,197.568,2869.15,74913,135,134,74427,73983,50293,47550,51356
46649,112,209,28769,17880,5.86988e+18,132.806,2160.3,46649,87,89,46368,46134,30165,28013,31490
19557,274,426,12208,7349,5.8826e+18,158.573,2290.9,19557,133,123,19131,19107,16554,16577,13329
68898,248,285,42422,26476,5.87045e+18,145.443,2790.29,68898,101,109,68613,68601,67080,68055,67333
40885,39,252,25174,15711,5.87006e+18,122.258,2078.72,40885,95,97,38084,34939,9148,12685,10255
78392,231,277,48751,29641,5.87697e+18,231.079,3310.09,78392,179,176,78048,77767,65818,72230,70814
27509,188,258,17031,10478,5.87184e+18,185.789,1775.91,27509,100,103,27210,27098,23123,25173,25072
98467,13,294,60654,37813,5.87033e+18,173.901,3268.37,98467,118,122,61637,36728,11178,11210,7180
22833,63,219,14118,8715,5.87009e+18,111.045,1456.42,22833,80,85,22290,21962,7454,9256,10321
60867,274,305,38078,22789,5.88969e+18,218.785,3380.79,60867,181,193,60562,60502,53724,56208,54027
89074,250,275,55163,33911,5.87236e+18,200.491,3244.73,89074,145,144,88799,88737,78581,84438,86034
12590,137,237,7796,4794,5.87612e+18,183.481,1307.8,12590,103,99,12188,11887,7978,7544,7297
5981,105,142,3685,2296,5.8694e+18,65.163,734.762,5981,63,63,5839,5838,4606,4664,3911
17821,109,142,11032,6789,5.86965e+18,95.1114,1199.19,17821,71,74,17669,17591,15016,16411,15922
9673,939,2080,6088,3585,5.74764e+18,140.307,3090.3,9673,165,128,7593,7534,3649,4317,1012
30890,133,197,19121,11769,5.87018e+18,114.027,1753.37,30890,79,81,30691,30602,27290,28797,27456
35973,173,181,22144,13829,5.86984e+18,120.964,1750.03,35973,83,86,35792,35792,35396,35598,35662
83698,20,227,51682,32016,5.87016e+18,157.002,2999.77,83698,93,100,62095,45026,10712,11816,7740
47572,17,271,29628,17944,5.88425e+18,225.928,2748.54,47572,178,171,30427,18506,4329,8120,3045
35404,45,249,21820,13584,5.86997e+18,109.747,1939.06,35404,88,93,33662,31705,10948,11823,12873
26967,55,167,16648,10319,5.86955e+18,109.973,1537,26967,76,83,26377,25731,8234,10328,11559
43579,269,286,27419,16160,5.89517e+18,223.774,2828.73,43579,181,177,43293,43232,42960,43153,43145
73058,94,268,45073,27985,5.87e+18,146.126,2770.74,73058,105,108,72466,71910,35813,34167,40162
68878,182,270,42642,26236,5.87076e+18,154.249,2675.49,68878,113,124,68553,68365,47916,50991,47174
86135,133,342,53191,32944,5.8705e+18,159.565,3356.31,86135,120,116,85554,85061,55659,54632,57823
62405,178,301,38476,23929,5.8712e+18,149.276,2758.76,62405,109,109,62043,61887,54825,53658,56343
43744,39,186,26950,16794,5.86952e+18,123.983,1965.37,43744,85,91,41164,38035,8531,13013,12402
80068,160,316,49622,30446,5.87878e+18,213.255,3665.87,80068,175,184,79092,78139,49449,47304,44190
45254,7,321,28102,17152,5.87914e+18,148.541,2868.58,45254,143,145,16386,0,1913,3278,2003
33599,10,258,20782,12817,5.87606e+18,194.215,2112.89,33599,135,130,17885,12135,2981,4358,972
82208,196,294,50750,31458,5.87028e+18,161.976,2976.58,82208,109,113,81914,81745,66086,72812,74130
83232,81,227,51383,31849,5.87002e+18,134.307,2983.48,83232,94,99,82645,82322,40460,40422,43194
13160,186,214,8136,5024,5.87093e+18,92.0152,1120.85,13160,76,76,12946,12930,11818,12507,12424
78871,35,259,48659,30212,5.87012e+18,143.361,2860.53,78871,101,108,72099,62948,14176,21404,19125
24677,44,307,15227,9450,5.87072e+18,81.2692,1710.63,24677,75,82,23324,21525,7216,9090,8429
36472,35,250,22517,13955,5.87004e+18,127.205,2111.76,36472,96,98,31977,25910,6903,9668,7153
38489,44,266,23671,14818,5.8715e+18,164.178,2068.81,38489,102,112,36345,34145,9211,11798,11732
10664,30,137,6555,4109,5.87123e+18,90.5917,927.538,10664,65,66,9362,7797,2398,3286,2732
88504,124,279,54791,33713,5.8718e+18,195.199,3153.23,88504,141,142,87479,86339,42464,40408,42492
27006,157,211,16700,10306,5.87037e+18,124.588,1787.63,27006,86,81,26795,26685,24407,25495,24524
9016,106,123,5577,3439,5.87071e+18,76.2622,814.724,9016,63,61,8893,8863,7947,8527,8436
65893,142,261,40560,25333,5.87044e+18,159.245,2618.87,65893,117,113,65474,65161,37416,34142,30272
32514,63,261,19997,12517,5.87159e+18,133.442,1889.93,32514,99,102,31524,30827,9655,12577,11927
68484,2514,6002,43151,25333,5.79005e+18,454.07,11564.3,68484,357,279,62482,62141,40264,42921,14500
64851,66,229,39823,25028,5.87097e+18,147.565,2480.28,64851,103,111,63690,62885,17406,23884,25130
95576,191,279,58756,36820,5.87193e+18,181.931,3221.23,95576,139,140,95176,94856,68459,75998,67160
34579,18,296,21353,13226,5.87207e+18,126.675,2126.54,34579,96,99,24679,15964,4731,7662,3524
28575,230,255,17690,10885,5.87402e+18,164.245,1828.44,28575,111,111,28320,28288,25746,27238,27918
40740,121,258,25200,15540,5.87191e+18,175.226,2088.01,40740,111,111,40191,39681,22968,21284,26735
74607,86,288,46022,28585,5.87031e+18,134.267,2899.65,74607,104,105,73955,73452,36211,38454,38392
33522,21,221,20746,12776,5.87035e+18,116.47,1742.47,33522,85,93,26631,20594,4390,7859,5813
65546,18,286,40698,24848,5.88087e+18,237.878,3217.62,65546,184,173,44497,27850,6679,11927,3609
68044,107,293,41897,26147,5.87056e+18,161.422,2774.2,68044,116,127,67313,66544,27712,30703,25497
67942,122,285,42332,25610,5.88026e+18,230.666,3242.74,67942,184,176,66042,63571,31217,29463,33436
1267,25,71,787,480,5.88224e+18,51.8706,264.76,1267,39,43,964,663,397,397,535
11650,105,281,7225,4425,5.87503e+18,133.638,1331.91,11650,87,87,11225,10952,6647,6446,5870
41821,27,342,25910,15911,5.87583e+18,118.4,2762.45,41821,123,121,32936,23365,6354,7742,7207
44442,149,298,27417,17025,5.8716e+18,134.504,2388.52,44442,99,102,44052,43904,36489,36084,37340
27292,139,174,16897,10395,5.86979e+18,105.037,1494.1,27292,78,83,27118,27043,24031,25529,25856
61396,162,217,37836,23560,5.8699e+18,126.201,2537.53,61396,89,93,61179,61098,51267,56162,51968
66774,50,328,41455,25319,5.87813e+18,171.764,3445.52,66774,157,169,60875,55025,14939,21368,16329
84516,270,303,52087,32429,5.87064e+18,150.747,3146.79,84516,120,124,84213,84197,74153,79724,78763
7622,39,230,4785,2837,5.88844e+18,147.346,1094.5,7622,95,97,6030,4663,1913,2486,2008
95000,178,279,58695,36305,5.87021e+18,164.622,3388.37,95000,111,115,94646,94398,70450,64084,79689
98729,296,309,60758,37971,5.87123e+18,227.369,3452.45,98729,131,140,98420,98400,98124,98328,98400
99792,88,315,61559,38233,5.87213e+18,209.386,3661.82,99792,148,147,97889,95999,37042,40880,44231
48842,242,307,30459,18383,5.88672e+18,206.874,3019.71,48842,170,171,48535,48399,42959,43312,42499
33214,192,5484,20885,12329,5.71262e+18,542.065,9357.64,33214,307,265,22672,18012,3507,7252,1714
35770,192,261,22369,13401,5.88547e+18,210.725,2395.03,35770,162,163,35352,34982,27139,28588,27179
45143,55,257,27890,17253,5.87023e+18,145.889,2392.99,45143,96,97,43637,41681,10931,14955,13387
55599,71,274,34329,21270,5.87424e+18,209.848,2702.09,55599,140,148,53354,51545,16383,22385,20942
13520,22,149,8327,5193,5.86926e+18,83.9423,1020.65,13520,66,69,10969,8560,2178,3221,2409
20537,228,254,12643,7894,5.87093e+18,119.069,1529.99,20537,84,89,20283,20261,19532,19991,19787
32174,53,241,19885,12289,5.87026e+18,163.737,1788.44,32174,98,100,30949,30025,7451,10735,9623
33733,179,219,20711,13022,5.87014e+18,159.576,1774.94,33733,93,97,33479,33372,28633,31402,30510
41070,43,267,25824,15246,5.89461e+18,211.422,2682.26,41070,178,175,31571,23051,6379,9075,8231
8755,43,123,5372,3383,5.86835e+18,72.1085,796.287,8755,60,62,8430,8080,3001,3354,3836
81867,271,281,51087,30780,5.88311e+18,216.548,3618.2,81867,199,190,81586,81586,81409,81535,81584
38177,132,198,23562,14615,5.87014e+18,105.725,1946.37,38177,84,84,37978,37875,32811,32007,34352
79080,16,342,48848,30232,5.87046e+18,156.948,3245.85,79080,117,114,51900,32804,8919,12899,8316
16866,77,342,10388,6478,5.87052e+18,113.03,1574.71,16866,85,89,16261,15893,4207,6074,4748
66744,232,273,41072,25672,5.87117e+18,160.673,2650.17,66744,114,125,66471,66426,55975,62158,57285
80027,97,252,49482,30545,5.87003e+18,150.541,3147.55,80027,107,106,79355,78918,46758,41833,47723
96718,172,230,59676,37042,5.87024e+18,144.117,3197.47,96718,96,101,96488,96383,81850,89131,91095
43079,141,175,26676,16403,5.87014e+18,111.779,2029.86,43079,83,81,42904,42824,39980,40899,41743
48031,209,397,29771,18260,5.87414e+18,185.022,3013.74,48031,145,142,47556,47341,31787,30291,29599
74078,32,285,46164,27914,5.88039e+18,235.715,3414.77,74078,184,182,60412,47798,10741,18668,9853
66815,181,299,41136,25679,5.87077e+18,161.059,2815.49,66815,115,119,66429,66210,48817,45110,48812
14118,249,261,8826,5292,5.88939e+18,160.31,1545.35,14118,124,109,13857,13836,13742,13810,13448
87038,198,279,53542,33496,5.87357e+18,207.026,3254.98,87038,157,160,86561,86089,66072,72320,73545
89127,51,328,55240,33887,5.87685e+18,190.758,3874.11,89127,168,178,82095,76229,17621,28771,24235
15901,9,151,9826,6075,5.86985e+18,88.3844,1119.67,15901,70,75,8073,0,1255,1533,703
78826,278,285,49098,29728,5.87998e+18,238.545,3501.83,78826,186,186,78541,78531,77119,78078,77821
22651,237,246,13952,8699,5.87665e+18,168.756,1653.26,22651,108,108,22405,22397,22016,22160,22312
94910,278,307,59151,35759,5.88552e+18,243.765,4091.5,94910,202,207,94603,94472,87578,90255,89635
36840,31,189,22745,14095,5.87008e+18,99.4818,1877.34,36840,84,87,32246,25955,8991,11339,11561
27407,30,187,16913,10494,5.87053e+18,95.0885,1623.87,27407,81,82,23689,19015,6280,7690,7583
25968,9,256,15957,10011,5.87255e+18,131.629,1716.24,25968,99,101,13030,0,2040,2884,1559
11401,117,152,7009,4392,5.87028e+18,79.1764,978.067,11401,67,70,11249,11222,9760,10420,9470
48656,240,274,30034,18622,5.87413e+18,194.374,2500.56,48656,131,140,48371,48278,43589,46224,44878
23293,155,239,14338,8955,5.86944e+18,103.064,1488.64,23293,83,87,23054,22995,17223,17032,19936
4543,86,109,2808,1735,5.86904e+18,57.1891,567.801,4543,51,51,4434,4416,3930,4173,3998
35577,163,195,21932,13645,5.86969e+18,109.924,1859.59,35577,84,85,35382,35316,33514,34495,34496
80359,25,214,49531,30828,5.87029e+18,143.694,2864.79,80359,94,97,65605,48222,11748,19907,13175
68684,90,275,42296,26388,5.8747e+18,223.769,2954.4,68684,152,157,66763,64839,24199,27149,26942
82362,7,260,50916,31446,5.87004e+18,156.974,3208.97,82362,109,110,30063,0,3465,5173,3323
18746,109,255,11605,7141,5.87392e+18,136.831,1484.96,18746,94,95,18313,17950,9503,9181,8822
23413,228,273,14536,8877,5.87513e+18,177.858,1800.97,23413,107,104,23140,23063,22161,22371,22231
81965,57,288,50547,31418,5.87029e+18,143.681,3012.29,81965,106,108,80136,77947,20758,29115,26234
80315,108,317,49640,30675,5.873e+18,198.543,3406.12,80315,140,147,79009,77753,40303,40182,37993
38080,20,262,23785,14295,5.88219e+18,204.205,2396.73,38080,162,153,26673,19004,3567,7279,3445
3393,77,167,2110,1283,5.8824e+18,94.3884,589.553,3393,65,60,3137,3010,1560,1634,1509
41293,354,411,25649,15644,5.88082e+18,196.218,3132.41,41293,158,159,40882,40805,37068,38357,35508
90732,67,307,55932,34800,5.87303e+18,198.373,3495.06,90732,159,157,87600,84754,27341,39140,29503
28967,68,273,17983,10984,5.87649e+18,179.812,1998.76,28967,122,113,27550,26269,7996,10899,10759
85459,141,291,53819,31640,5.89692e+18,233.238,3931.26,85459,211,205,82816,78742,44177,41256,49177
78554,46,209,48503,30051,5.87007e+18,126.007,2894.66,78554,91,93,75084,70362,18524,26964,24402
32223,2,155,19927,12296,5.86991e+18,92.0287,1704.65,32223,74,81,2945,0,319,0,206
26483,203,257,16457,10026,5.87775e+18,179.453,1900.36,26483,127,127,26192,26009,21448,23615,20371
58342,64,199,35967,22375,5.87018e+18,127.549,2403.31,58342,92,94,57527,56866,22084,24202,26103
86997,44,397,53845,33152,5.87127e+18,180.55,3746.83,86997,123,117,80960,72945,19743,26720,20364
80677,17,303,49871,30806,5.8709e+18,155.469,3080.67,80677,114,126,57926,38768,8962,14307,7399
75629,208,277,47004,28625,5.87758e+18,233.622,3266.7,75629,177,176,75163,74633,59436,66351,59541
66912,81,312,41499,25413,5.87927e+18,183.074,3357.87,66912,167,172,63534,60040,26951,33934,26353
31795,79,180,19525,12270,5.8706e+18,116.707,1631.88,31795,80,88,31380,31056,17015,15491,21417
69566,131,270,43520,26046,5.88611e+18,225.803,3357.89,69566,195,189,67355,64344,35154,32272,38375
26462,81,187,16343,10119,5.87e+18,100.251,1599.81,26462,81,82,26148,25970,16233,16118,16997
4261,138,145,2623,1638,5.86865e+18,65.0434,634.286,4261,57,57,4116,4103,4103,4102,4045
26751,24,256,16571,10180,5.87123e+18,139,1734.54,26751,98,100,22074,17180,3747,6916,4616
91582,23,264,56516,35066,5.87001e+18,143.079,3112.63,91582,103,111,73474,54912,12017,16476,11903
83239,97,275,51536,31703,5.87193e+18,199.543,3066.5,83239,140,141,81752,80285,31381,34206,33823
24008,43,162,14761,9247,5.87008e+18,105.212,1409.46,24008,75,79,22986,21583,6332,8959,7123
36555,26,286,22704,13851,5.88102e+18,189.776,2453.62,36555,147,148,27934,19908,4679,8504,5338
61246,242,277,38149,23097,5.87848e+18,233.988,2999.54,61246,174,170,60946,60825,53814,57504,58251
76107,43,214,47000,29107,5.87034e+18,133.097,2806.88,76107,92,94,72359,66653,17818,24515,20729
34440,106,270,21322,13118,5.86984e+18,197.653,2214.55,34440,108,110,33699,33152,16748,14290,18634
33336,17,260,20479,12857,5.8726e+18,135.756,1909.85,33336,104,105,24268,16666,3701,5620,4118
90510,27,261,55962,34548,5.87013e+18,170.301,3324.36,90510,108,106,73810,53400,15511,22022,14238
97118,245,300,59987,37131,5.87091e+18,199.534,3352.78,97118,131,128,96818,96676,93053,94955,94648
74942,171,271,46701,28241,5.88526e+18,225.296,3472.41,74942,198,189,73980,72635,49665,47618,52882
66204,137,222,40930,25274,5.86978e+18,131.101,2698.58,66204,90,90,65960,65803,49416,50703,50895
82388,181,315,50822,31566,5.87237e+18,167.341,3380.76,82388,139,137,81917,81590,67485,64207,66486
65417,174,270,40804,24613,5.88581e+18,226.483,3245.23,65417,188,191,64580,63334,44115,44123,46686
97844,173,285,60855,36989,5.87844e+18,235.635,3826.66,97844,189,196,96905,95774,66645,60773,64109
33680,128,173,20759,12921,5.86949e+18,100.946,1732.95,33680,78,84,33503,33441,27350,29895,27858
20681,71,282,12793,7888,5.87285e+18,116.624,1677.74,20681,94,93,19976,19316,9299,11699,10196
77928,95,267,48229,29699,5.871e+18,184.384,2852.87,77928,128,132,76811,75631,30551,33064,34010
57320,80,266,35211,22109,5.87146e+18,186.775,2466.59,57320,119,128,56104,55090,18484,23433,24171
12547,65,210,7715,4832,5.87059e+18,93.7427,1079.2,12547,74,75,12153,11888,3979,5148,6036
32282,226,259,20037,12245,5.87477e+18,167.435,2026.04,32282,127,117,32017,31963,28135,30451,29879
74237,36,215,45820,28417,5.87012e+18,119.883,2782.74,74237,91,95,67754,60192,16221,23325,19939
17363,124,229,10904,6459,5.88909e+18,172.693,1636.85,17363,136,128,16582,15547,10062,8925,10325
17731,114,148,10956,6775,5.86974e+18,72.2221,1301.2,17731,77,77,17583,17583,15348,16323,13942
59328,100,270,36751,22577,5.8699e+18,190.189,2836.97,59328,116,118,58437,57800,30736,26878,31679
92319,112,280,57053,35266,5.87007e+18,192.858,3431.56,92319,110,113,91601,91048,43149,36930,50812
85379,52,301,52550,32829,5.8709e+18,197.046,3160,85379,118,126,82473,79392,18673,28452,28859
46894,8,326,29110,17784,5.87885e+18,145.534,2936.67,46894,147,143,18988,0,2518,3709,2172
9831,32,127,6039,3792,5.86895e+18,66.5161,847.965,9831,61,60,8827,7433,2708,3634,3828
75096,98,277,46265,28831,5.8706e+18,157.578,2856.16,75096,119,123,74232,73400,29593,32533,30439
68804,98,342,42542,26262,5.87044e+18,155.752,3063.04,68804,115,106,68026,67511,38016,34813,38249
98247,17,228,60545,37702,5.86994e+18,142.429,3172.83,98247,98,103,68564,43650,11973,15045,11263
46746,39,266,28730,18016,5.87146e+18,172.419,2242.9,46746,109,115,43528,39932,8305,12643,9838
67984,112,266,42611,25373,5.89205e+18,224.341,3406.71,67984,192,190,64354,59627,29719,28891,34161
51029,119,268,31641,19388,5.87438e+18,211.074,2538.72,51029,137,137,50014,48855,24564,22922,23767
76827,120,273,47648,29179,5.87388e+18,232.484,3123.02,76827,160,161,75434,73863,36282,34402,36275
37754,78,173,23328,14426,5.87005e+18,100.384,1870.4,37754,80,86,37407,37219,18882,17879,21337
14162,84,125,8727,5435,5.86889e+18,65.8495,1043.19,14162,68,71,14037,14036,10068,9308,8387
32963,26,260,20304,12659,5.87205e+18,135.213,1899.17,32963,100,105,27813,21958,5023,8364,5140
74844,46,313,46192,28652,5.87343e+18,190.397,3284.6,74844,148,148,69805,64925,17857,23942,17388
85381,228,316,52658,32723,5.87291e+18,207.332,3433.98,85381,143,141,85035,84838,77328,79350,76839
72909,150,202,44946,27963,5.87021e+18,123.477,2686.24,72909,89,98,72700,72591,63933,67363,68078
45159,259,264,28106,17053,5.87773e+18,197.425,2500.38,45159,153,150,44895,44895,44009,44636,44650
34354,75,217,21132,13222,5.8696e+18,129.776,1761.07,34354,87,96,33782,33409,13640,15282,15775
42242,272,298,26081,16161,5.87148e+18,127.901,2303.61,42242,102,103,41944,41913,38398,40441,40219
48403,273,295,29939,18464,5.87066e+18,132.479,2404.52,48403,90,98,48108,48093,48040,48086,47965
52563,188,235,32502,20061,5.8699e+18,124.066,2239.36,52563,93,100,52328,52296,44250,49035,47633
34521,104,173,21379,13142,5.87022e+18,98.615,1839.37,34521,81,80,34323,34280,24848,23248,22088
18015,10,277,11191,6824,5.87582e+18,88.9231,1602.53,18015,100,91,8489,5463,1258,1861,1776
73551,53,278,45363,28188,5.87317e+18,210.164,3013.18,73551,151,145,69620,66766,14234,22199,13632
88138,43,282,54343,33795,5.87285e+18,218.439,3294.25,88138,149,160,81915,75446,15358,24912,19726
23769,135,253,14841,8928,5.88283e+18,191.096,1878.18,23769,142,132,23050,22300,13995,12510,13876
27824,130,251,17092,10732,5.87318e+18,131.068,1734.66,27824,98,102,27430,27135,16069,14213,18109
22795,76,174,14008,8787,5.87e+18,108.881,1382.42,22795,76,77,22437,22191,12148,11523,14938
87313,62,282,53993,33320,5.87082e+18,156.78,3045.7,87313,118,128,85349,83949,21547,30643,27041
92284,245,282,56905,35379,5.87287e+18,221.068,3355.69,92284,151,160,91974,91824,79576,86767,86152
23126,122,261,14481,8645,5.88799e+18,184.088,1950.09,23126,143,138,22136,20882,12117,12045,13464
71948,62,270,44521,27427,5.87005e+18,183.841,3104.46,71948,121,118,69865,67663,24560,26745,28200
49298,296,385,30580,18718,5.87507e+18,226.828,2862.37,49298,144,149,48913,48830,38825,43384,32214
47077,164,272,29134,17943,5.87722e+18,188.769,2552.37,47077,153,144,46494,45924,31565,29708,30229
63176,79,288,38999,24177,5.86998e+18,144.188,2671.51,63176,102,104,62428,61921,21745,26937,26482
90041,269,307,56134,33907,5.88574e+18,245.541,3997.56,90041,201,205,89733,89587,82008,84436,85073
76263,306,426,47604,28659,5.88405e+18,214.278,4331.26,76263,186,195,75837,75747,64994,65382,53479
3557,98,153,2211,1346,5.8716e+18,53.8965,553.934,3557,55,52,3404,3362,2856,2792,2765
56483,72,226,34747,21736,5.86973e+18,137.775,2249.22,56483,96,104,55603,55007,19383,23309,27912
58327,132,263,36421,21906,5.88689e+18,225.404,3078.82,58327,184,185,56425,54054,29417,27767,31839
39402,195,196,24377,15025,5.86993e+18,107.533,2007.92,39402,84,83,39206,39206,39205,39206,39187
34897,24,204,21602,13295,5.86994e+18,99.3343,1980.76,34897,85,84,26784,18424,6179,8871,7118
96134,203,329,59572,36562,5.8779e+18,222.203,4052.51,96134,185,190,95552,94976,69649,66643,62842
32332,63,283,20360,11972,5.89791e+18,198.449,2470.59,32332,167,172,26835,21348,7691,10572,5940
89005,93,286,55228,33777,5.87989e+18,242.784,3689.16,89005,198,189,84869,80162,31487,35058,30953
38087,181,196,23543,14544,5.87009e+18,108.199,1985.37,38087,83,83,37891,37886,37033,37585,37674
8457,35,76,5199,3258,5.87172e+18,66.9126,689.711,8457,63,65,7587,6341,3607,3632,4563
53523,191,270,33134,20389,5.87015e+18,237.883,2850.18,53523,136,146,52941,52330,40122,37371,43226
26323,25,182,16253,10070,5.86949e+18,83.2211,1691.59,26323,80,79,20604,14301,5046,6929,5890
42084,68,266,25981,16103,5.8703e+18,155.273,2220.89,42084,90,96,41304,40750,9556,14270,11433
84628,131,294,52912,31716,5.88898e+18,244.561,3860.3,84628,203,207,81803,77785,36653,36911,42542
26617,179,245,16397,10220,5.8696e+18,92.3895,1685.53,26617,84,88,26372,26321,22486,24095,20468
9654,40,261,5982,3672,5.87214e+18,85.55,1162.47,9654,80,82,8486,7279,3604,3811,4425
52937,104,321,32884,20053,5.88117e+18,177.187,3107,52937,164,165,50985,48972,27820,31366,25467
41579,108,257,25581,15998,5.87018e+18,126.091,2114.35,41579,93,94,41227,40977,26336,27854,27990
69995,252,316,43165,26830,5.87312e+18,169.28,3146.65,69995,128,131,69679,69581,66595,67570,65447
26614,163,251,16349,10265,5.87331e+18,136.265,1699.91,26614,100,101,26304,26166,18985,18438,19947
86693,197,259,53563,33130,5.87028e+18,167.452,3252.72,86693,105,104,86408,86298,83461,84321,85736
61719,34,268,38121,23598,5.87045e+18,145.394,2552.09,61719,97,100,55836,46865,11049,17817,14868
9535,140,200,5899,3636,5.87047e+18,91.204,934.162,9535,66,69,9335,9263,7983,8518,8815
72244,78,225,44614,27630,5.87011e+18,127.967,2826.6,72244,90,91,71785,71570,35390,35763,37515
27751,136,250,17512,10239,5.89668e+18,194.883,2147.13,27751,169,159,26667,25266,16471,15694,17559
96455,52,285,60174,36281,5.88165e+18,243.792,3905.56,96455,208,194,85665,78585,17430,26915,20262
69669,168,271,43151,26518,5.87086e+18,154.55,2685.87,69669,120,123,69312,69063,47304,41999,44139
15167,175,182,9325,5842,5.87074e+18,88.1875,1221.61,15167,74,77,14985,14980,14566,14869,14820
67685,238,266,41590,26095,5.87146e+18,182.975,2667.98,67685,122,124,67418,67356,59345,63955,63957
60133,112,269,37077,23056,5.87288e+18,199.601,2685.91,60133,141,138,59032,57806,27956,27715,25086
38900,3,261,24347,14553,5.88618e+18,226.121,2499.98,38900,170,165,5980,0,26,481,335
75493,91,318,46856,28637,5.87993e+18,230.077,3604.24,75493,178,186,72036,68037,24003,32783,23810
5622,152,196,3557,2065,5.90697e+18,151.005,907.988,5622,106,92,5385,5156,4494,4570,4863
26397,117,175,16329,10068,5.87021e+18,84.3391,1618.5,26397,76,79,26222,26161,18452,18064,17935
16914,224,242,10428,6486,5.87307e+18,149.544,1390.26,16914,95,97,16672,16653,15519,16237,16585
17091,93,249,10599,6492,5.88591e+18,157.633,1610.18,17091,130,119,15987,14711,6915,6752,6576
83032,268,300,51311,31721,5.87082e+18,194.087,3118.61,83032,120,123,82732,82647,80740,81908,81610
8074,112,142,4964,3110,5.86972e+18,80.4323,785.128,8074,62,62,7932,7885,6921,7423,6959
54571,6,259,33668,20903,5.87021e+18,135.149,2428.81,54571,93,100,18795,0,1891,3071,1986
75205,14,302,46374,28831,5.87068e+18,159.8,3002.82,75205,112,120,48689,29163,8247,10834,6476
28632,68,321,17797,10835,5.88283e+18,132.132,2278.03,28632,128,126,26681,24672,11685,11615,7256
89424,74,288,55155,34269,5.87014e+18,154.227,3140.01,89424,106,110,88395,87692,26772,35331,36967
58806,265,272,36364,22442,5.87629e+18,232.385,2857.25,58806,160,165,58534,58496,58153,58390,58353
39890,192,274,24638,15252,5.87477e+18,166.709,2308.67,39890,128,130,39538,39296,29141,32230,27445
93695,156,277,57999,35696,5.87126e+18,184.308,3174.56,93695,134,145,93099,92634,57594,51570,62350
73321,131,257,45357,27964,5.87019e+18,146.033,3008.26,73321,106,105,72847,72430,47834,43309,51364
35187,156,217,21774,13413,5.87077e+18,144.757,1795.4,35187,90,96,34936,34816,28813,31384,31761
11778,37,135,7240,4538,5.86976e+18,69.4337,981.771,11778,64,64,10887,9873,3106,4103,3531
18449,27,144,11411,7038,5.86926e+18,91.9004,1234.07,18449,68,72,15647,12045,3590,5437,3963
7722,129,165,4755,2967,5.86848e+18,82.735,786.616,7722,62,65,7557,7548,6968,7276,7174
60030,22,279,37080,22950,5.87023e+18,151.463,2739.33,60030,104,111,45954,33689,7792,13311,8134
76120,123,282,46854,29266,5.87425e+18,212.759,3104.68,76120,153,162,74901,73549,38703,37029,39737
21792,241,244,13420,8372,5.87064e+18,96.9659,1538.8,21792,86,85,21548,21544,21487,21495,21538
35898,164,194,22153,13745,5.87026e+18,102.252,1890.98,35898,83,87,35704,35673,31514,33944,32443
9924,119,199,6142,3782,5.87086e+18,84.7884,945.03,9924,66,70,9725,9625,6848,6530,6670
29778,32,257,18429,11349,5.87413e+18,159.877,1865.76,29778,113,110,26116,22516,4218,7578,4340
26456,20,253,16395,10061,5.87148e+18,130.754,1693.37,26456,96,100,20806,15968,3228,6283,3118
48189,69,279,29972,18217,5.88219e+18,209.627,2783.21,48189,169,173,44213,40250,12904,19267,12757
43043,134,178,26591,16452,5.87001e+18,96.6835,2005.39,43043,82,88,42863,42819,35329,39019,36099
33645,128,158,20700,12945,5.87035e+18,92.656,1752.65,33645,79,83,33487,33456,29468,31662,31121
2231,32,189,1389,842,5.8871e+18,76.3828,533.941,2231,55,54,1676,1246,374,609,586
89643,94,260,55218,34425,5.87039e+18,144.116,3052.1,89643,105,111,88982,88347,44403,43747,54243
94318,186,309,58076,36242,5.87137e+18,235.783,3410.78,94318,132,139,93854,93512,65823,67782,59754
24341,30,163,14955,9386,5.87051e+18,98.1229,1411.77,24341,77,81,21398,17743,5019,7000,5943
30655,3,275,18853,11802,5.87331e+18,207.219,1940.9,30655,103,114,5208,0,135,407,455
26317,141,279,16238,10079,5.87217e+18,103.845,1825.54,26317,98,98,25986,25859,20759,20758,20608
11659,110,131,7163,4496,5.86935e+18,76.1909,946.094,11659,63,66,11528,11509,10356,10996,10695
7130,38,134,4435,2695,5.86982e+18,59.885,706.314,7130,58,61,6614,6054,1736,2403,1064
86561,64,280,53232,33329,5.87219e+18,196.899,3129.39,86561,143,143,83779,81601,17794,29982,18955
16271,43,150,10051,6220,5.8696e+18,82.6372,1199.62,16271,68,70,15552,14475,3833,5709,4360
96380,90,273,59821,36559,5.87478e+18,239.396,3549.23,96380,176,180,93380,90246,32277,38426,35544
82715,352,411,51195,31520,5.87902e+18,236.043,4105.33,82715,179,190,82304,82210,71014,75635,67999
91464,94,234,56325,35139,5.8703e+18,129.374,3030.83,91464,99,107,90916,90407,45872,42592,55974
54789,364,381,33914,20875,5.87134e+18,173.186,2964.65,54789,122,127,54408,54400,52784,53861,52714
35580,122,199,21980,13600,5.87e+18,92.9182,1989.38,35580,81,83,35378,35321,30809,31166,29979
2967,216,225,1857,1110,5.87315e+18,77.8193,668.725,2967,63,59,2742,2734,2630,2710,2596
36503,114,426,22918,13585,5.89095e+18,196.622,3117.66,36503,166,169,34532,32132,15220,14923,10688
35013,10,249,21569,13444,5.86984e+18,117.811,1916.95,35013,89,95,18597,12763,3509,4054,2470
25407,184,252,15653,9754,5.87182e+18,146.511,1676.59,25407,92,95,25138,25021,22950,23364,22912
48561,269,342,29898,18663,5.87054e+18,141.747,2498.48,48561,106,110,48219,48119,40747,44670,41897
47647,167,315,29479,18168,5.87164e+18,135.525,2590.03,47647,108,105,47306,47213,44947,45099,44205
53629,3,275,33079,20550,5.87813e+18,229.359,2739,53629,160,160,8864,0,4,837,532
30188,206,274,18643,11545,5.87456e+18,212.17,1975.68,30188,114,116,29873,29709,24859,26940,26289
41751,207,217,25847,15904,5.87017e+18,123.998,2175.96,41751,88,85,41534,41534,41528,41531,41522
59863,104,213,36926,22937,5.86995e+18,130.967,2448.44,59863,90,97,59507,59192,37873,34194,43994
80292,39,274,49687,30605,5.87098e+18,178.007,2888.55,80292,125,132,75023,69076,12947,20215,13471
86693,92,274,53555,33138,5.87469e+18,218.689,3380.57,86693,179,168,83992,81033,31419,35579,35350
37085,5510,6016,23294,13791,5.69318e+18,672.483,10391,37085,323,282,31069,31069,28552,29104,18742
26706,49,257,16436,10270,5.87219e+18,131.698,1733.89,26706,95,101,25368,24252,5930,8563,6946
65022,122,257,40084,24938,5.87035e+18,138.562,2609.44,65022,97,101,64678,64390,45621,47998,53297
66675,70,224,41240,25435,5.87017e+18,155.686,2725.39,66675,90,93,66022,65201,23480,25760,25621
52173,150,203,32262,19911,5.87029e+18,120.677,2284.02,52173,85,83,51970,51869,48162,49127,50807
86649,70,277,53879,32770,5.8784e+18,229.05,3529.51,86649,186,184,81496,76458,19014,30404,26671
77609,267,274,48087,29522,5.87315e+18,205.616,3054.57,77609,152,146,77335,77335,75913,76943,77117
66394,136,274,40960,25434,5.87349e+18,207.517,2884.01,66394,154,147,65435,64680,35736,34601,40743
50622,10,196,31252,19370,5.87005e+18,101.002,2311.57,50622,83,87,25217,16890,4377,4606,3318
57621,159,226,35553,22068,5.86995e+18,132.394,2393.82,57621,91,95,57395,57310,50563,53600,54464
94512,194,274,58370,36142,5.87463e+18,239.865,3521.77,94512,176,174,93897,93224,67710,75276,68950
32787,195,262,20434,12353,5.88518e+18,202.708,2284.24,32787,160,150,32422,32122,25940,27567,27168
93626,1219,6074,58923,34703,5.81622e+18,407.715,12424.1,93626,365,282,87428,84160,22026,45382,8359
37943,204,220,23472,14471,5.87028e+18,125.766,1851.87,37943,88,96,37723,37700,35724,36619,37655
22631,223,257,14087,8544,5.87902e+18,187.886,1781.47,22631,129,121,22363,22257,20168,21270,21206
11021,6,218,6777,4244,5.87051e+18,102.837,1035.68,11021,76,75,4132,0,467,869,465
83890,90,285,52288,31602,5.88061e+18,237.521,3602.49,83890,196,190,79692,74781,27041,31472,30960
57907,220,285,36065,21842,5.87921e+18,235.384,2983.59,57907,170,165,57544,57216,47801,52121,50623
12172,274,282,7577,4595,5.88006e+18,133.108,1482.06,12172,108,104,11890,11884,11825,11841,11744
75895,206,315,46866,29029,5.87206e+18,192.749,3206.99,75895,127,126,75550,75393,67338,69268,70345
50163,8,226,31025,19138,5.87034e+18,137.771,2131.01,50163,96,103,23133,0,3397,4844,2277
26388,45,297,16461,9927,5.88468e+18,129.288,2188.2,26388,133,130,22432,18437,9078,9403,9964
15009,27,137,9217,5792,5.87043e+18,77.7547,1071.79,15009,68,70,12728,9699,3811,4715,4550
45466,168,203,28091,17375,5.87018e+18,121.845,2033.9,45466,87,92,45263,45245,39388,42749,41142
46420,223,411,28792,17628,5.8759e+18,168.632,3183.53,46420,140,131,46004,45905,41528,40803,38302
38201,249,426,23874,14327,5.88462e+18,187.298,3164.78,38201,162,157,37775,37713,29709,28790,22257
2855,7,70,1774,1081,5.87268e+18,53.9965,385.581,2855,49,55,1065,0,102,209,284
43862,61,226,27144,16718,5.87001e+18,126.053,1990.46,43862,89,94,42993,42406,11720,16545,18975
83455,214,274,51510,31945,5.87387e+18,237.263,3264.87,83455,165,163,83026,82570,67990,75256,71339
43592,178,183,26938,16654,5.86987e+18,117.941,1951.71,43592,86,93,43409,43409,43349,43394,43401
78736,232,259,48504,30232,5.8703e+18,146.611,2875.32,78736,102,109,78477,78438,73754,76353,78090
31705,91,195,19549,12156,5.87001e+18,95.5982,1761.53,31705,82,83,31456,31337,21369,21375,20615
59833,33,342,36853,22980,5.8705e+18,139.65,2775.58,59833,107,112,53225,43220,9547,12971,10674
80281,143,259,49458,30823,5.87021e+18,136.897,2892.14,80281,100,107,79976,79798,60445,56731,69295
45411,169,200,28082,17329,5.87025e+18,107.787,2218.01,45411,84,84,45211,45171,44349,44684,44249
34849,73,220,21564,13285,5.86984e+18,122.851,1780.54,34849,88,92,34264,33916,14101,16210,19968
14706,33,243,9059,5647,5.87152e+18,137.87,1304.51,14706,86,91,12930,11145,2665,4352,3816
40759,150,257,25237,15522,5.86992e+18,152.383,2315.78,40759,99,99,40373,40045,32907,31883,35000
49319,245,273,30601,18718,5.87554e+18,220.934,2559.72,49319,148,142,49037,48932,46087,47675,47426
5687,34,80,3533,2154,5.86827e+18,65.2893,584.073,5687,59,64,4930,3727,2310,2297,3236
73196,151,285,45683,27513,5.88331e+18,235.107,3450.83,73196,191,185,71928,70300,44075,39457,44761
35763,170,178,22032,13731,5.87009e+18,80.2503,1903.64,35763,78,82,35585,35585,34971,35370,34833
89713,42,231,55316,34397,5.87011e+18,146.504,3034.63,89713,95,102,85084,78380,17647,27543,24253
50136,54,262,31066,19070,5.87123e+18,165.674,2317.23,50136,112,118,48341,46784,13219,19435,17072
24975,275,286,15455,9520,5.87269e+18,127.037,1816.73,24975,102,101,24689,24684,23984,24486,24534
88311,265,274,54474,33837,5.87329e+18,227.262,3303.06,88311,158,163,88034,87969,85273,87133,86599
60721,8,271,37745,22976,5.88249e+18,220.918,3062.7,60721,183,178,25646,0,3797,5595,2120
84889,159,285,52960,31929,5.88133e+18,241.43,3653.95,84889,199,190,83619,82145,52052,48393,51587
37090,45,275,22864,14226,5.8764e+18,177.743,2237.25,37090,131,129,34002,31167,7179,11385,7990
94419,85,215,58240,36179,5.87014e+18,136.321,3111.16,94419,94,100,93804,93427,45839,44367,53118
14596,10,125,8993,5603,5.86946e+18,61.1558,1086.71,14596,69,68,7322,4887,1183,1391,967
91634,191,315,56538,35096,5.87164e+18,205.604,3462.78,91634,139,138,91207,90968,73536,79764,79194
18017,48,172,11095,6922,5.869e+18,118.815,1236.91,18017,75,76,17353,16872,4760,6761,6612
67609,200,235,41789,25820,5.87017e+18,147.42,2547.87,67609,104,111,67358,67278,58499,63648,61837
54529,72,256,33603,20926,5.87017e+18,128.811,2394.12,54529,93,100,53820,53337,19907,23509,25585
1797,220,232,1126,671,5.88034e+18,70.7846,564.231,1797,57,55,1565,1565,1560,1563,1555
44331,60,261,27757,16574,5.88679e+18,227.068,2678.92,44331,177,170,38782,34004,8587,13643,11468
89713,267,286,55565,34148,5.87774e+18,231.315,3632.09,89713,194,182,89424,89332,82577,86332,85710
51425,144,215,31810,19615,5.86986e+18,116.99,2385.3,51425,87,85,51208,51083,45600,46811,47011
83117,257,279,51400,31717,5.86989e+18,148.084,3187.86,83117,108,108,82838,82801,81183,82321,81022
58190,96,217,35906,22284,5.87009e+18,125.298,2482.99,58190,87,92,57830,57605,34057,32982,37148
91514,277,317,56618,34896,5.87283e+18,190.533,3571.6,91514,150,156,91197,91125,79649,86211,81096
76284,116,307,47466,28818,5.88381e+18,239.038,3640.54,76284,196,186,73487,69979,32712,32394,33487
28560,250,257,17793,10767,5.87987e+18,198.606,2005.44,28560,141,133,28303,28302,27985,28182,28222
55360,172,286,34370,20990,5.8801e+18,215.947,2951.15,55360,164,170,54715,54006,37269,37662,39758
71256,151,271,44369,26887,5.88401e+18,220.109,3361.45,71256,196,185,69936,68158,43024,39772,45120
31371,106,292,19340,12031,5.87179e+18,112.279,2010.21,31371,96,93,30954,30720,22718,24075,22249
63017,167,289,38753,24264,5.87041e+18,141.745,2660.72,63017,98,106,62727,62584,42913,41130,38923
57304,146,426,35665,21639,5.8794e+18,163.419,3710.55,57304,160,157,56435,55354,40586,40496,37641
89553,162,230,55159,34394,5.87029e+18,140.144,3020.44,89553,98,104,89319,89198,78114,82206,83128
30396,36,255,18787,11609,5.87036e+18,106.618,1809.54,30396,88,86,27654,24489,6072,8935,7603
92145,85,302,56932,35213,5.87094e+18,145.078,3303.34,92145,116,128,91016,90038,31722,41645,41418
72602,30,313,44931,27671,5.87346e+18,197.781,3250.3,72602,143,152,61602,50345,10662,18610,11365
27727,686,4819,17445,10282,5.73534e+18,437.673,7957.65,27727,274,224,22151,19526,4764,8290,3179
84467,94,294,52146,32321,5.87032e+18,165.635,3002.91,84467,112,115,83713,82991,37014,38730,49695
22815,97,142,14064,8751,5.87081e+18,76.8771,1409.33,22815,73,74,22666,22635,17286,16010,17215
76320,87,238,47160,29160,5.87029e+18,162.759,2962.79,76320,96,95,75752,75475,37668,35617,39152
11302,41,155,6945,4357,5.86938e+18,83.3189,971.43,11302,67,69,10734,10028,2894,4002,3845
58917,311,317,37016,21901,5.89366e+18,224.654,3313.97,58917,190,194,58600,58598,58040,58396,58523
47288,99,220,29253,18035,5.87029e+18,142.957,2059.44,47288,98,101,46829,46399,24671,23597,29382
83619,162,294,51624,31995,5.87032e+18,166.204,2992.61,83619,112,113,83272,83029,59633,63300,72521
67650,15,300,41660,25990,5.87105e+18,156.609,2840.34,67650,109,115,45305,27334,7660,10268,7148
8256,133,259,5164,3092,5.88509e+18,116.893,1206.04,8256,95,97,7890,7634,5931,5726,5220
31933,232,257,19630,12303,5.8721e+18,182.788,1892.67,31933,104,107,31676,31600,30390,31045,31039
59286,47,233,36429,22857,5.87046e+18,132.822,2355.37,59286,97,104,57196,55348,13322,19991,20848
72964,125,286,45968,26996,5.89743e+18,232.888,3638.07,72964,203,203,69582,64534,32718,30635,38104
29501,62,165,18146,11355,5.86969e+18,109.266,1551.76,29501,77,82,29010,28747,12774,13349,12959
42991,75,196,26592,16399,5.87013e+18,104.911,2109.93,42991,83,84,42661,42470,18669,19106,19532
11661,15,134,7226,4435,5.86954e+18,71.7408,949.077,11661,64,66,7695,4554,1473,1888,1883
85312,234,317,53410,31902,5.88796e+18,209.278,4007.01,85312,198,206,84951,84677,66939,70629,64723
31548,144,215,19398,12150,5.87055e+18,129.151,1698.74,31548,83,91,31311,31169,24046,23869,27427
39833,206,252,24517,15316,5.86991e+18,126.846,2044.99,39833,95,97,39581,39548,34098,37173,34708
53712,126,227,32996,20716,5.87058e+18,131.945,2196.76,53712,97,102,53401,53109,35039,33456,41616
90962,195,307,56737,34225,5.88612e+18,246.211,4025.65,90962,202,203,90283,89466,61368,65442,65082
8107,108,134,5022,3085,5.87144e+18,72.3979,800.351,8107,67,69,7973,7960,7902,7921,7843
75892,192,397,47057,28835,5.87335e+18,210.404,3689.38,75892,150,159,75294,74839,52435,51728,51820
56061,110,265,35201,20860,5.89061e+18,232.074,3088.66,56061,194,188,52994,49235,24183,22621,26299
24162,142,149,14928,9234,5.87006e+18,80.1283,1464.58,24162,72,77,24013,24013,23537,23846,23770
57533,324,381,35574,21959,5.87073e+18,170.33,3035.91,57533,117,113,57152,57078,55477,56362,55247
65632,97,381,40602,25030,5.87101e+18,151.119,3182.56,65632,124,120,64645,63899,30931,32842,33121
55102,135,266,33929,21173,5.87107e+18,166.417,2421.38,55102,110,120,54598,54177,31703,30427,33970
64763,110,208,39991,24772,5.87005e+18,124.739,2640.69,64763,89,89,64487,64313,43374,41401,46410
27180,118,364,17137,10043,5.89577e+18,193.48,2248.73,27180,175,163,25204,22419,9219,10105,5612
44254,82,172,27209,17045,5.87035e+18,110.202,1991.46,44254,81,90,43853,43582,23760,22335,28368
47866,84,287,30060,17806,5.89301e+18,221.656,2934.91,47866,188,182,43069,37506,13337,16065,16294
85988,249,328,53322,32666,5.87514e+18,196.203,3698.89,85988,155,156,85660,85520,81586,82141,80121
97334,220,232,60097,37237,5.87005e+18,134.153,3204.47,97334,94,99,97102,97101,96393,96839,96896
44603,123,291,27489,17114,5.87106e+18,157.313,2356.62,44603,107,113,44062,43630,26637,27056,25276
9794,68,224,6117,3677,5.8868e+18,167.46,1193.94,9794,106,100,8689,7721,2946,3574,3284
36339,15,260,22523,13816,5.8725e+18,210.809,2079.09,36339,116,119,24915,15753,3928,6611,2301
35255,239,258,21782,13473,5.8704e+18,115.04,1980.73,35255,85,87,34997,34997,34977,34980,34985
93120,45,307,58095,35025,5.8866e+18,235.153,4062.43,93120,196,207,77829,63873,15338,24938,16497
29161,194,257,18106,11055,5.87723e+18,185.454,1976.79,29161,128,130,28821,28583,23044,25018,22516
12156,36,251,7676,4480,5.90124e+18,179.009,1428.08,12156,140,123,7840,4389,1567,1843,2325
26708,224,279,16515,10193,5.86983e+18,137.345,1951.64,26708,99,95,26429,26317,24941,25796,25374
5150,85,149,3165,1985,5.86835e+18,68.2388,696.669,5150,56,58,4996,4936,3405,3199,3016
14177,42,221,8779,5398,5.87243e+18,73.5438,1214.98,14177,81,77,13105,11782,5976,6456,7036
88678,182,273,54572,34106,5.87089e+18,176.871,3033.19,88678,129,134,88274,87979,63178,64807,67785
54383,211,321,33777,20606,5.88065e+18,175.488,3142.56,54383,164,165,53981,53745,42169,42217,38928
84009,31,273,51604,32405,5.87128e+18,170.975,2946.51,84009,127,130,74652,63533,10554,21537,12408
24207,20,219,14986,9221,5.87008e+18,103.729,1487.71,24207,79,84,18829,14244,3186,5872,3420
84320,225,315,52034,32286,5.87251e+18,176.574,3407.43,84320,142,139,83964,83788,74002,76603,73326
71687,248,313,44319,27368,5.87037e+18,168.405,2812.04,71687,103,112,71374,71326,71311,71309,71297
4135,54,144,2566,1569,5.86728e+18,61.8718,637.874,4135,59,63,3906,3606,1793,1754,1730
54000,250,257,33362,20638,5.8703e+18,149.815,2600.85,54000,102,101,53743,53721,53734,53740,52827
3969,68,102,2460,1509,5.86944e+18,45.2935,514.077,3969,49,52,3867,3867,2926,2875,2540
78180,219,274,48120,30060,5.87043e+18,174.033,2853.05,78180,123,129,77884,77774,67178,73365,70287
99690,93,328,61836,37854,5.87568e+18,207.77,4009.79,99690,170,176,97071,94110,41093,42386,49373
42413,26,255,26788,15625,5.90087e+18,214.692,2695.68,42413,185,178,25649,12654,4340,6601,4791
14061,14,132,8666,5395,5.86967e+18,69.9246,1050.58,14061,75,73,8348,4720,2012,2230,2385
69966,169,279,43232,26734,5.87039e+18,149.561,2909.26,69966,102,110,69630,69416,48801,42043,57223
45988,84,267,28546,17442,5.87447e+18,207.737,2421.81,45988,138,132,44418,42951,13866,17686,13492
98569,284,288,60820,37749,5.87006e+18,152.769,3271.5,98569,107,113,98281,98281,98279,98281,98277
79751,164,232,49196,30555,5.87023e+18,132.982,2916.23,79751,91,97,79517,79426,62183,68261,63904
25689,176,272,15911,9778,5.87753e+18,165.62,1935.06,25689,118,122,25299,25024,18811,18290,17643
42859,90,265,26527,16332,5.87724e+18,195.067,2412.56,42859,151,141,41075,39092,15905,17760,16035
36024,127,269,22252,13772,5.87533e+18,177.144,2183.88,36024,128,132,35249,34443,18471,18224,19450
12829,271,281,7986,4843,5.87643e+18,91.4787,1438.59,12829,91,85,12548,12548,12535,12546,12434
49474,5,202,30563,18911,5.87042e+18,119.465,2271.36,49474,84,85,13723,0,179,2004,1267
98971,139,230,60959,38012,5.87018e+18,142.136,3163.85,98971,99,109,98702,98444,73995,73427,86172
41988,162,173,25884,16104,5.86944e+18,107.946,1946.93,41988,81,88,41815,41815,41298,41576,41501
66066,55,281,40968,25098,5.87886e+18,194.161,3152.92,66066,175,176,60302,55966,13438,21255,16874
84438,157,279,52142,32296,5.87032e+18,153.577,3240.65,84438,109,114,84025,83643,62118,58069,68263
65075,259,300,40192,24883,5.8707e+18,151.451,2801.15,65075,106,110,64775,64706,62031,63577,62915
23141,153,249,14271,8870,5.87009e+18,120.909,1602.47,23141,86,88,22892,22806,16281,15010,14825
80523,181,314,49676,30847,5.87175e+18,200.257,3309.48,80523,131,133,80085,79776,63444,68509,69253
39191,134,199,24174,15017,5.8701e+18,101.862,2005.43,39191,84,90,38989,38916,28456,29004,26741
33882,102,173,20938,12944,5.87028e+18,98.3416,1817.67,33882,80,82,33682,33639,25433,23192,21723
42451,130,226,26269,16182,5.87035e+18,129.38,1977.24,42451,88,99,42193,41985,26887,23768,24081
18784,18,139,11582,7202,5.87061e+18,71.8399,1267.65,18784,72,70,13277,8297,2414,3482,2705
35010,184,199,21600,13410,5.87025e+18,104.395,1849.51,35010,79,86,34811,34808,33333,34252,33760
36483,12,194,22539,13944,5.86931e+18,110.171,1929.62,36483,79,82,20647,12596,3874,2913,2838
39547,82,196,24424,15123,5.87079e+18,110.21,1958.6,39547,83,86,39182,38999,20683,19903,18588
65740,132,273,40770,24970,5.87374e+18,210.906,2892.88,65740,147,154,64725,63795,36889,35761,38664
27129,71,272,16788,10341,5.87629e+18,166.022,1980.43,27129,118,124,25673,24539,10071,12205,11614
38811,186,261,24205,14606,5.88191e+18,210.512,2398.64,38811,160,153,38369,37885,28982,31656,30797
7220,80,122,4464,2756,5.86865e+18,68.2119,725.265,7220,60,58,7085,7040,5355,5128,5398
27002,67,273,16762,10240,5.87495e+18,174.15,1911.05,27002,109,113,25804,24784,8562,10896,12270
85392,44,273,52848,32544,5.87114e+18,181.966,3004.57,85392,130,134,81047,76425,14819,24390,18794
56483,146,274,34895,21588,5.87466e+18,217.18,2727.4,56483,156,146,55651,55024,33157,30376,33789
28503,43,257,17544,10959,5.87113e+18,182.446,1798.2,28503,100,102,26651,24721,5489,9086,8368
86403,6,303,53400,33003,5.87086e+18,157.252,3194.17,86403,117,128,30331,0,2953,4455,1505
41235,175,194,25438,15797,5.87027e+18,98.5333,2013.27,41235,84,87,41041,41030,39267,40300,39842
87264,176,321,54990,32274,5.8973e+18,236.953,4035.19,87264,212,206,86228,84500,53034,53597,56821
11441,276,277,7115,4326,5.8789e+18,98.4765,1372.66,11441,99,89,11164,11162,11164,11164,11147
59751,49,326,36970,22781,5.87288e+18,150.515,2913.94,59751,117,112,56887,53753,13058,19768,19969
54109,117,260,33425,20684,5.86975e+18,154.903,2625.75,54109,101,106,53622,53243,29493,26963,31855
31582,127,159,19503,12079,5.87041e+18,79.4991,1709.95,31582,75,79,31423,31394,27889,29768,28611
78144,124,302,48177,29967,5.87068e+18,157.757,3052.44,78144,112,123,77522,76983,48866,51509,53535
70064,156,316,43496,26568,5.88006e+18,235.903,3470.86,70064,175,186,68991,67916,37817,36251,32582
42414,89,173,26238,16176,5.87004e+18,112.553,2015.05,42414,84,83,42165,42095,25655,24548,28729
87969,227,263,54195,33774,5.87013e+18,145.105,3039.81,87969,102,110,87706,87654,79173,84061,87081
48719,15,304,30059,18660,5.87536e+18,211.411,2704.48,48719,142,143,31913,19224,4564,8346,2757
40597,2855,5081,25564,15033,5.77327e+18,416.562,9016.17,40597,298,243,35516,35473,23645,24557,9340
45987,44,199,28364,17623,5.86975e+18,96.3635,2141.03,45987,84,90,43935,40993,15162,17922,18209
67148,134,305,42026,25122,5.89052e+18,221.961,3523.64,67148,192,199,64979,62044,31847,32573,24838
41145,170,195,25368,15777,5.87033e+18,102.68,2084.16,41145,83,82,40950,40944,39608,40452,39776
34679,1348,11046,21782,12897,5.58435e+18,798.77,15236.6,34679,739,291,23553,20432,4140,5662,910
24860,111,163,15296,9564,5.86963e+18,104.724,1422.94,24860,74,81,24670,24539,18535,17985,19901
76401,71,231,47223,29178,5.8701e+18,131.988,2864.85,76401,94,96,75666,75044,32701,35330,36190
44037,32,262,27399,16638,5.87954e+18,202.909,2492.57,44037,157,150,36446,29908,5740,10843,6242
76339,112,269,47087,29252,5.87008e+18,153.828,2840.99,76339,107,109,75872,75369,45263,41330,50899
19469,116,253,12180,7289,5.88505e+18,201.018,1746.69,19469,132,129,18541,17539,9802,9073,10059
71766,68,324,44484,27282,5.87842e+18,192.837,3501.79,71766,167,174,67370,62997,20669,27613,15566
85482,233,300,52789,32693,5.87085e+18,192.029,3165.46,85482,120,122,85171,85005,81075,82874,82719
49924,150,273,30942,18982,5.87425e+18,173.937,2529.54,49924,136,136,49336,48889,33737,32017,33278
16188,90,247,10037,6151,5.87094e+18,138.212,1512.61,16188,90,86,15698,15421,9539,8753,9403
12942,188,204,8019,4923,5.8704e+18,91.0277,1112.59,12942,69,70,12738,12715,12094,12488,12680
43498,86,223,26713,16785,5.87121e+18,129.805,1991.05,43498,93,97,42981,42525,21116,21366,27330
3571,163,173,2209,1362,5.8683e+18,69.5715,634.542,3571,57,59,3398,3397,3342,3377,3304
49255,171,273,30611,18644,5.87712e+18,228.341,2646.27,49255,156,152,48690,48161,31897,30761,29772
78844,276,316,48647,30197,5.8728e+18,178.498,3342.32,78844,139,137,78528,78456,71519,75347,73398
71272,251,293,43934,27338,5.87005e+18,164.248,2786.72,71272,103,113,70979,70965,69510,70320,70690
40635,193,272,25093,15542,5.87459e+18,171.712,2318.92,40635,129,134,40262,40033,30809,32978,30530
55407,67,285,34545,20862,5.88054e+18,202.001,2964.24,55407,167,172,51213,47152,15038,20216,16029
59217,14,219,36596,22621,5.87061e+18,125.905,2546.39,59217,89,90,35416,20318,6058,8103,6332
86604,255,307,53940,32664,5.88497e+18,244.796,3909.36,86604,199,199,86276,86104,76089,79591,82080
83790,126,282,51637,32153,5.87083e+18,147.706,3068.9,83790,118,127,83228,82618,41382,40340,40436
22486,213,258,13936,8550,5.87833e+18,191.258,1782.47,22486,118,126,22210,22065,18807,20657,18616
79981,82,397,49557,30424,5.8721e+18,173.345,3697.87,79981,134,131,78297,77041,35442,35794,38907
69062,68,259,42663,26399,5.87002e+18,153.418,2939.16,69062,105,106,67897,66802,22596,25608,27697
18116,123,145,11146,6970,5.8711e+18,70.7529,1167.62,18116,74,73,17971,17947,17604,17815,17562
54242,62,211,33470,20772,5.86998e+18,124.492,2321.46,54242,88,91,53412,52771,21094,23433,25790
49882,6,273,31017,18865,5.87616e+18,236.1,2628.77,49882,151,147,17523,0,1700,3287,1569
11185,264,282,6982,4203,5.88786e+18,150.794,1461.79,11185,112,109,10903,10889,10693,10794,10427
22208,45,262,13860,8348,5.87861e+18,157.652,1800.54,22208,117,121,19746,17491,6661,8172,7025
25131,77,275,15495,9636,5.87509e+18,169.023,1838.18,25131,105,108,24234,23459,10610,11151,13475
27004,91,171,16668,10336,5.86941e+18,104.839,1621.13,27004,78,82,26794,26735,15820,14497,14093
69246,42,277,43068,26178,5.87842e+18,236.015,3160.98,69246,174,177,61290,53807,11447,18747,11639
73087,137,259,45188,27899,5.86983e+18,146.926,2995.38,73087,103,102,72636,72226,55448,55292,59123
71692,89,238,44320,27372,5.87032e+18,168.927,2872.11,71692,94,97,71126,70846,32919,30309,31077
74371,89,260,45823,28548,5.87048e+18,149.027,2800.84,74371,102,106,73696,73063,33232,32427,36623
25686,233,285,15980,9706,5.87983e+18,157.381,2059.52,25686,128,119,25401,25344,23763,23688,23260
13202,11,186,8159,5043,5.86959e+18,88.9358,1224.25,13202,75,78,6645,4146,1166,1572,886
42353,210,255,26747,15606,5.90095e+18,213.336,2692.09,42353,185,179,42042,41788,35980,37284,39075
64292,185,199,39595,24697,5.87009e+18,130.772,2548.51,64292,87,89,64093,64089,63858,64015,64016
60212,113,261,37732,22480,5.88864e+18,226.149,3143.43,60212,194,188,57308,53604,26143,24523,29707
38884,205,411,24191,14693,5.88444e+18,207.278,3039.46,38884,164,165,38379,38108,24934,23282,18704
57783,282,342,35672,22111,5.87052e+18,150.286,2844.5,57783,114,108,57441,57354,54035,55968,55582
32587,215,257,20093,12494,5.87234e+18,154.341,1939.15,32587,113,111,32317,32212,27899,30463,29275
78299,11,286,48617,29682,5.88078e+18,241.006,3496.78,78299,195,181,41554,25302,6742,9317,2935
46114,8,261,28543,17571,5.87175e+18,181.79,2233.45,46114,120,115,21727,0,3281,4771,1304
28492,214,328,17782,10710,5.88245e+18,120.532,2344.83,28492,134,129,28164,28125,24437,24439,22280
1664,10,139,1039,625,5.87396e+18,64.1166,384.382,1664,41,46,929,680,137,209,216
52792,11,270,32952,19840,5.88251e+18,219.599,2852.3,52792,176,170,27956,17253,3933,6420,2556
24495,7,177,15185,9310,5.86925e+18,81.1117,1559.82,24495,74,77,9425,0,1175,1465,756
18237,199,247,11390,6847,5.88773e+18,162.198,1677.67,18237,132,120,17972,17877,15645,16842,16331
85858,256,293,53056,32802,5.8708e+18,147.527,3138.7,85858,116,126,85565,85531,73115,80513,73569
75914,152,397,47030,28884,5.87258e+18,171.943,3649.06,75914,150,147,75124,74417,49573,48739,46575
19921,40,146,12329,7592,5.87021e+18,69.6255,1369.14,19921,76,76,18382,16295,7061,8075,8322
54152,19,212,33353,20799,5.87021e+18,123.667,2324,54152,91,95,40124,26683,7021,8868,8252
81135,112,275,49964,31171,5.87493e+18,232.813,3202.62,81135,160,161,79484,77718,38090,36223,39034
22952,9,189,14137,8815,5.86972e+18,103.181,1506.41,22952,80,82,11025,0,1608,2221,1341
59267,182,229,36679,22588,5.87022e+18,127.993,2572.29,59267,90,92,59038,58993,57203,58064,57359
77226,28,309,47871,29355,5.87364e+18,214.425,3252.88,77226,151,159,64947,52279,10205,18673,9140
36956,141,199,22803,14153,5.86976e+18,103.536,1934.44,36956,82,87,36757,36698,27010,28657,24683
64449,122,269,39661,24788,5.87086e+18,159.038,2606.3,64449,114,124,63886,63264,32994,32949,32143
88659,94,277,54885,33774,5.87152e+18,188.06,3098.42,88659,134,144,87283,85881,32659,37673,37025
66376,124,269,41497,24879,5.88588e+18,223.536,3270.75,66376,193,184,64102,60813,32134,29684,34391
46777,53,226,28948,17829,5.87012e+18,129.863,2052.58,46777,92,100,45530,44354,12110,17311,17829
51078,134,215,31499,19579,5.86997e+18,123.867,2332.59,51078,88,92,50851,50708,36271,35985,33810
74519,138,411,46238,28281,5.87549e+18,170.247,3904.4,74519,156,151,73539,72483,53385,52724,52447
1364,49,65,840,524,5.87673e+18,48.5997,264.97,1364,43,41,1279,1202,1028,1053,1199
40910,203,250,25247,15663,5.87047e+18,109.324,2058.09,40910,89,94,40660,40632,36726,38782,36818
39416,115,183,24264,15152,5.86941e+18,120.754,1830.87,39416,83,91,39189,38951,28240,27191,32175
81345,83,274,50344,31001,5.87095e+18,159.606,2888.68,81345,118,127,80099,79004,24742,33235,35450
48929,87,183,30219,18710,5.87008e+18,115.801,2183.63,48929,81,86,48609,48448,28695,26308,29395
88849,106,279,54926,33923,5.86985e+18,175.734,3310.77,88849,110,107,88131,87652,47125,42259,49958
81430,73,235,50312,31118,5.87017e+18,146.842,3037.13,81430,96,93,80774,80134,39525,39900,42243
11787,139,188,7296,4491,5.8713e+18,82.7208,1176.14,11787,74,75,11599,11571,10863,10789,10677
41935,133,274,25904,16031,5.87446e+18,171.869,2350.03,41935,126,133,41204,40564,26112,25994,26767
55924,110,208,34550,21374,5.87033e+18,120.112,2433.71,55924,86,90,55659,55510,33248,30168,30898
52487,392,397,32557,19930,5.87536e+18,230.46,2988.62,52487,145,157,52090,52088,52085,52087,50857
70270,275,282,43270,27000,5.87448e+18,218.533,3001.43,70270,152,160,69988,69988,69749,69836,69747
14847,19,253,9200,5647,5.87181e+18,94.477,1321.86,14847,77,79,11115,7613,2125,3467,2254
50391,14,273,31275,19116,5.87401e+18,172.392,2538.69,50391,135,134,32862,20099,5105,8393,3147
21971,85,147,13534,8437,5.86978e+18,72.7122,1386.11,21971,73,76,21816,21801,14372,13649,14011
82345,16,222,50876,31469,5.87031e+18,151.263,3017.3,82345,94,93,53606,32979,10476,11407,8309
16934,42,244,10405,6529,5.87057e+18,100.276,1373.5,16934,83,82,15892,14769,4276,5668,5649
79277,132,262,48847,30430,5.87051e+18,132.67,2895.92,79277,100,106,78944,78711,52968,52745,61380
70528,102,215,43532,26996,5.87004e+18,131.436,2748.6,70528,89,91,70185,69953,41635,37339,46661
87075,111,307,54316,32759,5.88646e+18,235.595,3942.06,87075,199,203,83217,78328,35191,36339,37496
72832,152,286,45882,26950,5.89711e+18,232.533,3634.49,72832,203,198,71158,68315,42452,39652,46426
34464,55,259,21362,13102,5.87032e+18,150.751,2142.9,34464,98,100,32976,31020,9174,11198,11842
1172,75,168,745,427,5.88167e+18,63.1997,393.213,1172,50,48,968,861,590,606,548
2898,103,104,1791,1107,5.86338e+18,44.7343,436.034,2898,44,49,2794,2794,2785,2789,2793
19540,72,262,12186,7354,5.88422e+18,195.961,1766.17,19540,132,126,17675,15990,5503,7067,6612
26197,183,272,16205,9992,5.87573e+18,165.753,1951.08,26197,115,125,25837,25634,20924,20725,20035
64466,69,203,39740,24726,5.86998e+18,118.707,2549.79,64466,89,94,63806,63140,26101,27255,29841
68889,248,256,42448,26441,5.87029e+18,131.951,2680.61,68889,97,106,68633,68621,67423,67883,68632
42191,103,192,26079,16112,5.86993e+18,122.892,1920.85,42191,90,93,41883,41578,24430,22097,27608
63265,199,226,39021,24244,5.86986e+18,131.038,2494.17,63265,92,97,63039,63034,61781,62427,62887
93633,91,275,57872,35761,5.87006e+18,200.407,3443.96,93633,111,114,92675,92092,36855,34948,40309
73840,177,271,45664,28176,5.87011e+18,212.258,3118.01,73840,113,111,73450,73107,52777,51917,48708
18301,144,245,11383,6918,5.87836e+18,171.602,1577.87,18301,116,113,17868,17578,11761,11309,11558
59133,18,327,36605,22528,5.87021e+18,160.782,2860.18,59133,106,104,39930,24475,7646,10912,7142
55763,40,281,34746,21017,5.8809e+18,208.69,2954.57,55763,172,171,47753,40237,8563,14059,7517
77678,17,342,47950,29728,5.87035e+18,142.406,3200.67,77678,118,111,52975,33442,9405,12504,7948
58723,61,234,36299,22424,5.87046e+18,124.186,2362.56,58723,94,104,57707,57005,15604,22073,25493
95134,174,282,58646,36488,5.87274e+18,200.564,3396.61,95134,154,161,94496,93861,65249,58384,64819
49250,51,226,30458,18792,5.8702e+18,129.617,2115.06,49250,90,98,47827,46355,12211,17022,19492
6357,162,213,3933,2424,5.87121e+18,100.947,812.361,6357,63,68,6144,6118,5867,6014,5864
41475,154,226,25523,15952,5.86978e+18,131.954,1959.66,41475,90,93,41246,41155,28026,28831,27814
92799,237,282,57560,35239,5.87336e+18,232.101,3404.62,92799,167,162,92464,92236,78268,86121,84269
52674,225,264,32960,19714,5.88636e+18,218.559,2899.16,52674,183,176,52359,52118,45370,48462,48818
22690,270,282,14280,8410,5.89579e+18,203.173,2085.32,22690,155,156,22408,22396,22022,22222,21471
77001,321,327,47724,29277,5.87776e+18,191.282,3649.06,77001,171,179,76674,76666,75552,76357,75636
7866,58,127,4865,3001,5.87085e+18,68.4833,782.401,7866,58,60,7700,7579,4142,4030,3753
35489,20,257,22012,13477,5.87261e+18,154.655,2036.41,35489,119,113,27543,20993,3910,8175,2263
37909,72,270,23473,14436,5.87e+18,213.094,2353.94,37909,115,119,36463,35489,11970,11492,10920
18843,62,142,11670,7173,5.86958e+18,67.026,1213.41,18843,72,74,18568,18262,14595,15283,15938
20460,140,274,12609,7851,5.87266e+18,164.072,1559.85,20460,87,92,20123,20038,14300,14867,14157
7667,27,234,4725,2942,5.87498e+18,102.659,959.381,7667,77,70,6374,5144,1264,2043,1644
18058,29,216,11172,6886,5.87047e+18,104.185,1303.49,18058,76,77,15766,13188,3285,5326,4634
34405,143,167,21188,13217,5.86987e+18,115.65,1702.14,34405,81,85,34238,34165,30319,32567,33015
20289,99,158,12463,7826,5.86981e+18,103.812,1286.76,20289,72,76,20086,19936,15188,14791,17044
90968,304,381,56239,34729,5.87062e+18,185.977,3660.95,90968,125,119,90587,90488,87628,89101,86689
35526,114,172,21832,13694,5.8699e+18,98.878,1772.59,35526,79,85,35331,35202,26765,26811,26205
55646,17,226,34338,21308,5.86975e+18,131.932,2358.31,55646,91,94,39344,25628,7085,8172,7076
12450,85,259,7771,4679,5.88547e+18,173.341,1429.44,12450,116,102,11521,10642,5062,4980,5668
77533,115,315,47872,29661,5.8723e+18,208.172,3301.13,77533,136,137,76500,75394,36975,35195,37345
79198,10,271,48758,30440,5.87088e+18,193.903,2945.45,79198,132,136,43023,29734,8108,8630,3374
81122,93,305,50691,30431,5.88843e+18,226.912,3833.27,81122,193,205,75659,68900,26174,31227,27208
79921,174,313,49294,30627,5.87345e+18,195.854,3338.5,79921,150,149,79295,78772,52254,47639,47073
71115,135,269,43991,27124,5.8712e+18,179.803,2730.8,71115,122,125,70521,70011,38958,35538,39320
18928,222,257,11705,7223,5.86944e+18,135.559,1637.34,18928,89,87,18671,18604,17421,18155,18268
92409,266,342,57216,35193,5.87635e+18,199.127,3996.7,92409,170,164,92067,91934,87956,88225,86286
63500,4,315,39237,24263,5.87327e+18,170.393,3058.95,63500,131,133,14667,0,8,1946,607
15303,197,253,9553,5750,5.88143e+18,178.681,1511.91,15303,108,113,15032,14904,12594,13680,12488
99149,94,381,61295,37854,5.8706e+18,178.927,3774.49,99149,133,135,97801,96670,36989,41890,41660
11759,41,137,7283,4476,5.87081e+18,66.8076,1005.76,11759,70,70,10885,9700,5174,5340,6083
19981,130,158,12287,7694,5.86943e+18,99.0476,1271.04,19981,69,78,19823,19750,18067,19111,19216
57618,225,272,35574,22044,5.87487e+18,223.797,2753.14,57618,152,157,57291,57070,48580,53041,53239
48918,208,296,30131,18787,5.8717e+18,140.334,2455.23,48918,103,102,48622,48515,46466,47063,46204
53319,81,307,33129,20190,5.88256e+18,223.884,3048.87,53319,173,164,49852,46122,14145,19528,18273
87942,14614,15343,55699,32243,5.70819e+18,567.386,22129.5,87942,901,331,72599,72597,70489,70685,30972
7841,175,186,4842,2999,5.86931e+18,79.1366,958.492,7841,69,71,7655,7655,7608,7639,7483
73204,47,285,45683,27521,5.88294e+18,234.286,3453.57,73204,191,185,63652,54825,12644,18823,14228
4987,87,134,3076,1911,5.86691e+18,62.5607,651.822,4987,60,65,4853,4834,3314,3043,2143
19737,57,257,12277,7460,5.88046e+18,179.181,1678.69,19737,116,117,17971,16680,5365,7230,6148
55427,77,184,34122,21305,5.87001e+18,118.208,2325.84,55427,83,89,55014,54836,26866,26058,30718
51792,111,270,32088,19704,5.87017e+18,232.097,2889.85,51792,142,150,50167,48415,24304,19942,22154
24033,50,257,14867,9166,5.87198e+18,136.403,1656.73,24033,97,99,22780,21921,5106,7796,6667
34493,18,235,21319,13174,5.86993e+18,128.461,2052.01,34493,89,86,22907,13675,4651,5280,4365
62633,162,217,38652,23981,5.86995e+18,131.055,2559.59,62633,88,92,62416,62311,53848,58290,56647
97157,220,285,60510,36647,5.88047e+18,238.249,3843.29,97157,198,197,96716,96193,79207,86206,82085
96526,230,298,59612,36914,5.87082e+18,201.027,3379.75,96526,126,131,96207,96045,89139,92267,91613
21584,116,146,13262,8322,5.86938e+18,99.1202,1325.68,21584,72,74,21433,21343,18982,20231,20199
40794,77,260,25263,15531,5.87108e+18,138.829,2077.27,40794,104,106,39906,39218,14189,17856,20975
15482,85,242,9543,5939,5.87007e+18,84.2901,1327.26,15482,80,80,15191,15011,9905,10294,10076
32016,48,158,19811,12205,5.86987e+18,85.6972,1719.21,32016,75,81,30910,29429,8836,11822,12078
3935,110,116,2428,1507,5.86498e+18,65.8374,543.568,3935,58,61,3819,3819,3817,3819,3812
36358,177,217,22482,13876,5.87103e+18,157.849,1834.31,36358,92,102,36104,35980,30711,33819,32937
80700,53,342,50353,30347,5.88521e+18,193.459,4050.15,80700,184,194,70712,62346,19051,24968,19737
14894,39,186,9208,5686,5.87013e+18,100.397,1210.69,14894,73,77,13926,12849,3331,4535,3938
69538,196,317,43567,25971,5.88965e+18,194.299,3662.25,69538,187,198,69019,68477,49278,49262,44706
54047,197,264,33211,20836,5.87173e+18,169.381,2407.6,54047,115,122,53734,53544,43192,47345,43954
11079,32,139,6816,4263,5.87082e+18,90.4053,964.038,11079,64,65,9891,8219,2347,3417,2438
12316,29,118,7586,4730,5.87048e+18,66.4664,891.956,12316,65,68,10419,7930,2426,3571,1779
2116,4,153,1316,800,5.86839e+18,47.3299,448.685,2116,47,49,488,0,6,39,138
10694,74,154,6588,4106,5.86735e+18,62.6781,967.422,10694,66,66,10540,10489,6123,6253,4875
38861,213,274,23995,14866,5.87449e+18,211.641,2274.67,38861,130,129,38547,38341,32667,35559,35256
88690,21,232,54752,33938,5.87018e+18,126.386,3066.96,88690,93,98,67264,49237,12551,14750,13946
85192,16,285,52519,32673,5.87006e+18,151.499,3070.89,85192,103,106,58136,38126,10254,12764,8187
33107,104,251,20362,12745,5.87017e+18,132.821,1818.06,33107,89,91,32750,32442,14704,15578,13255
50444,254,260,31068,19376,5.87128e+18,195.411,2379.6,50444,123,127,50184,50165,49340,49921,50184
17051,149,219,10477,6574,5.87037e+18,103.856,1274.72,17051,74,79,16832,16753,15972,16016,16396
17271,143,213,10629,6642,5.86974e+18,98.7476,1243.73,17271,77,82,17058,16979,13124,14030,15419
16089,27,136,9897,6192,5.86952e+18,82.0623,1116.72,16089,66,72,13609,10447,3185,4033,3991
43425,220,272,26825,16600,5.87585e+18,218.432,2422.76,43425,142,142,43114,42911,36845,39999,39954
7682,41,120,4754,2928,5.86963e+18,57.5059,751.634,7682,57,60,7333,6848,2662,3117,3396
72817,169,294,44935,27882,5.87028e+18,166.636,2822.34,72817,108,108,72498,72307,51060,54940,51367
80475,119,272,49647,30828,5.87354e+18,227.363,3184.88,80475,159,161,79005,77365,38480,39387,42386
40327,65,284,25201,15126,5.88393e+18,195.442,2605.46,40327,161,159,36535,32920,10834,15163,10275
55293,286,317,34620,20673,5.88748e+18,165.789,3267.67,55293,175,176,54976,54952,52721,54045,53003
31744,74,221,19505,12239,5.87058e+18,119.659,1706.6,31744,85,94,31203,30864,13352,15087,17132
56627,161,182,34977,21650,5.86988e+18,119.864,2345.98,56627,84,89,56445,56401,52891,54970,55740
5300,43,104,3297,2003,5.86854e+18,51.2434,578.052,5300,54,56,5076,4745,2348,2204,1395
25329,222,248,15619,9710,5.87352e+18,173.111,1730.52,25329,115,112,25074,25007,22426,23846,24547
28633,70,236,17682,10951,5.87005e+18,98.5974,1759.19,28633,79,84,28259,27942,13884,13312,14342
36004,165,261,22175,13829,5.87549e+18,159.378,2128.03,36004,126,120,35613,35292,24812,23363,23887
32828,130,261,20627,12201,5.89246e+18,209.387,2351.78,32828,171,159,31557,29791,17784,16249,19127
15449,218,249,9573,5876,5.86947e+18,135.765,1465.17,15449,87,84,15200,15185,15141,15144,15143
94319,120,279,57955,36364,5.87092e+18,151.448,3189.26,94319,123,131,93652,92895,50063,49035,55667
10844,48,126,6661,4183,5.87076e+18,60.7912,916.509,10844,64,65,10471,9976,4453,4553,3970
7805,178,230,4816,2989,5.87079e+18,99.271,977.503,7805,79,78,7575,7533,6379,6998,5573
72946,50,234,44980,27966,5.86976e+18,141.825,2700.39,72946,102,112,70636,68126,15269,23634,24066
37212,98,299,23038,14174,5.87495e+18,150.445,2379.18,37212,129,129,36121,35122,21920,22623,19743
1710,54,170,1066,644,5.88045e+18,68.462,445.441,1710,49,49,1447,1298,530,644,530
58741,241,266,36151,22590,5.8712e+18,182.223,2493.01,58741,116,125,58475,58429,52634,56027,56169
90209,41,227,55714,34495,5.87007e+18,152.937,3116.99,90209,96,102,84817,76802,17116,27487,20932
34717,33,179,21339,13378,5.86947e+18,112.69,1702.24,34717,81,88,31319,26123,6186,8761,9102
14003,16,76,8606,5397,5.87097e+18,67.4063,885.06,14003,67,68,9177,5708,2151,2589,3211
25693,80,156,15929,9764,5.86965e+18,91.0357,1516.28,25693,74,74,25500,25473,17611,16871,14719
43090,275,342,26509,16581,5.87074e+18,136.756,2340.16,43090,100,108,42748,42660,35731,39789,36691
75648,33,270,47245,28403,5.88487e+18,224.353,3471.04,75648,195,190,60025,46365,9657,17442,10522
3577,23,71,2201,1376,5.86797e+18,57.5594,443.073,3577,53,55,2732,1933,1005,1135,1486
2683,88,131,1644,1039,5.87124e+18,56.7984,446.964,2683,46,44,2552,2516,2124,2200,2331
68947,98,273,42440,26507,5.87076e+18,160.072,2680.44,68947,114,127,68090,67287,30750,33993,34838
83336,34,257,51529,31807,5.87045e+18,167.326,3169.1,83336,109,106,73326,58007,16074,23095,16454
71229,141,227,43993,27236,5.86985e+18,139.353,2759.83,71229,92,96,70975,70796,49595,48413,45385
32072,50,256,19742,12330,5.8701e+18,107.559,1861.67,32072,88,86,30866,29409,10552,12103,9255
72512,69,271,45511,27001,5.89101e+18,221.787,3536.49,72512,202,195,63795,54442,15982,23203,21291
14331,197,249,8952,5379,5.88077e+18,159.775,1436.54,14331,110,102,14060,13954,12417,12750,12537
22268,50,174,13764,8504,5.86933e+18,82.6922,1503.63,22268,77,77,21557,20577,6904,8612,9106
93237,326,409,57639,35598,5.8707e+18,179.374,3786.84,93237,122,118,92828,92819,92469,92447,92065
13624,160,200,8428,5196,5.86906e+18,99.1691,1276.44,13624,78,78,13424,13363,12755,13034,12783
36759,119,249,22580,14179,5.87072e+18,133.837,1939.17,36759,88,95,36452,36189,18739,17629,19483
21144,164,174,13063,8081,5.87016e+18,109.402,1333.49,21144,75,78,20970,20970,20280,20771,20961
61595,40,342,37928,23667,5.8704e+18,138.078,2807.89,61595,106,112,57535,52392,10614,15931,13139
98677,155,411,61137,37540,5.87623e+18,184.373,4430.58,98677,170,171,97684,96592,71282,71133,70319
53248,205,211,32912,20336,5.87056e+18,118.408,2366.78,53248,85,86,53037,53037,53033,53034,53037
25893,199,246,15961,9932,5.86973e+18,92.537,1672.51,25893,83,90,25647,25621,22759,24474,22930
29149,99,270,18039,11110,5.87056e+18,197.51,2121.5,29149,123,130,27850,26621,14625,12467,14703
7678,175,198,4754,2924,5.86955e+18,121.623,971.168,7678,69,74,7480,7416,7295,7382,7230
31000,97,166,19054,11946,5.87019e+18,101.448,1631.13,31000,79,84,30763,30591,20522,18735,18859
11231,60,233,6944,4287,5.87536e+18,119.361,1207.63,11231,93,89,10371,9732,2722,4199,2756
96221,296,304,60017,36204,5.88637e+18,229.474,4096.36,96221,204,206,95917,95912,95089,95684,95417
11909,156,234,7342,4567,5.87386e+18,128.345,1187.36,11909,91,84,11661,11547,9595,9871,10143
51610,29,266,31782,19828,5.87135e+18,167.742,2337.15,51610,110,119,44910,37502,8013,13103,8107
67857,175,342,42103,25754,5.87842e+18,152.361,3567.84,67857,159,156,67411,67095,59063,57405,55357
75998,374,381,47019,28979,5.87098e+18,175.024,3372.95,75998,131,130,75617,75612,75611,75612,74821
58407,100,257,36029,22378,5.87041e+18,139.708,2486.64,58407,95,97,57969,57591,35400,32640,40595
71044,262,294,43800,27244,5.87017e+18,163.976,2788.61,71044,104,108,70750,70743,68928,69972,70115
10938,45,183,6751,4187,5.86918e+18,85.874,1097.48,10938,71,73,10160,9191,3339,3894,3254
97568,217,280,60309,37259,5.8701e+18,203.517,3542.07,97568,114,116,97256,97048,79382,89356,81359
8517,108,140,5243,3274,5.86915e+18,65.2319,878.165,8517,67,68,8377,8377,7890,8076,7354
94838,291,304,59170,35668,5.88654e+18,226.351,4072.16,94838,202,206,94534,94527,92574,93593,93103
86837,43,285,53530,33307,5.87014e+18,141.143,3089.3,86837,107,111,82568,76628,19371,26956,23871
34378,80,177,21265,13113,5.86967e+18,123.348,1695.98,34378,85,91,33934,33563,16896,16267,21301
28093,39,217,17294,10799,5.87032e+18,163.247,1628.86,28093,89,91,26283,24380,5604,8614,8362
83579,219,285,52071,31508,5.87949e+18,244.543,3579.01,83579,188,189,83139,82706,66516,73301,63233
69731,235,262,42951,26780,5.87007e+18,137.679,2712.89,69731,100,104,69469,69438,63350,66546,67658
23589,15,217,14500,9089,5.87038e+18,128.311,1488.79,23589,80,92,16278,10073,2364,3416,2189
92655,295,315,57153,35502,5.87299e+18,193.469,3620.85,92655,152,153,92340,92289,85979,89548,88185
20536,122,151,12654,7882,5.87113e+18,82.6446,1347.71,20536,71,74,20385,20354,17424,18720,17879
98765,184,234,61008,37757,5.8701e+18,152.325,3309.17,98765,98,99,98531,98461,94241,96234,97494
55403,47,273,34400,21003,5.87424e+18,214.574,2674.69,55403,151,143,51279,47930,10658,16144,13180
13086,43,151,8116,4970,5.86906e+18,66.8929,1105.92,13086,72,73,12293,11132,4838,5161,5289
43237,49,258,26645,16592,5.8702e+18,121.16,2161.86,43237,89,92,41704,39929,10575,14698,13578
27576,150,162,17063,10513,5.86922e+18,104.815,1502.86,27576,78,81,27414,27405,26093,26816,26835
22414,242,246,13887,8527,5.87588e+18,166.926,1638.94,22414,107,109,22168,22168,21951,22090,22168
8685,57,199,5369,3316,5.86958e+18,86.7599,899.906,8685,65,69,8314,8099,3455,3957,4471
84149,272,285,52493,31656,5.88231e+18,246.139,3689.1,84149,195,194,83864,83823,83229,83639,83723
90493,172,230,55851,34642,5.8702e+18,128.926,3105.57,90493,94,100,90263,90212,75539,82563,78893
44917,177,267,28227,16690,5.89444e+18,216.746,2780.51,44917,183,178,44315,43413,32237,33168,36166
60596,160,279,37461,23135,5.87037e+18,150.501,2775.59,60596,106,109,60212,59883,45595,43076,48985
55093,120,397,34167,20926,5.87394e+18,217.63,3197.88,55093,145,152,53878,52672,24204,25162,23165
45446,143,397,28196,17250,5.87434e+18,185.672,3015.42,45446,143,142,44632,43964,28180,27320,27039
54986,163,266,33851,21135,5.87155e+18,187.502,2424.08,54986,115,123,54557,54238,38940,38009,41920
98250,128,294,60606,37644,5.87013e+18,164.25,3252.13,98250,112,112,97802,97366,53423,47671,43735
25283,75,204,15609,9674,5.86989e+18,107.37,1711.05,25283,83,84,24987,24856,13253,12912,12759
55364,287,301,34153,21211,5.87115e+18,139.864,2613.62,55364,106,109,55063,55048,53742,54653,54107
68115,30,202,42008,26107,5.87013e+18,124.85,2598.51,68115,88,96,59238,47759,11660,18294,13865
8708,107,184,5361,3347,5.87074e+18,60.9072,888.387,8708,60,65,8524,8522,8115,8310,8102
40405,2,197,24862,15543,5.86968e+18,119.225,1991.72,40405,87,89,3631,0,412,0,245
13108,79,163,8035,5073,5.86905e+18,90.2579,1019.32,13108,70,73,12868,12672,7244,6921,9467
72138,58,260,44451,27687,5.87018e+18,148.097,2689.15,72138,110,114,70486,69025,15631,24027,22705
27966,156,216,17294,10672,5.87063e+18,163.245,1624.83,27966,89,94,27698,27547,21774,23937,24685
11673,162,245,7208,4465,5.87354e+18,94.6175,1202.67,11673,81,81,11427,11367,9650,9791,9704
92865,184,294,57347,35518,5.87018e+18,198.672,3191.64,92865,123,122,92501,92251,67588,74035,69917
87817,82,271,54369,33448,5.87137e+18,189.053,3086.08,87817,138,144,86034,84450,23521,34153,34124
1245,57,90,767,478,5.86426e+18,40.8835,275.007,1245,37,35,1139,1092,847,939,822
80196,110,342,49763,30433,5.87912e+18,205.218,3891.7,80196,171,163,78202,75692,35918,34198,36409
2952,49,137,1832,1120,5.87423e+18,74.2005,494.609,2952,52,48,2683,2479,1159,1263,1002
6857,52,143,4220,2637,5.86762e+18,73.573,747.86,6857,62,66,6586,6341,3357,3742,3901
67163,69,315,41484,25679,5.87313e+18,167.366,3124.88,67163,135,134,65104,63267,24610,28310,28106
16842,139,248,10470,6372,5.88142e+18,188.028,1566.31,16842,122,116,16325,15945,10508,10036,11247
59792,147,274,36893,22899,5.87298e+18,184.125,2723.63,59792,135,143,59109,58586,36027,35913,41471
8619,14,193,5336,3283,5.86957e+18,88.2898,878.177,8619,67,66,5989,3868,959,1582,409
55081,192,265,34070,21011,5.87127e+18,165.415,2407.82,55081,115,121,54760,54549,43603,47960,46927
12862,104,121,7916,4946,5.86901e+18,59.7535,1013.35,12862,67,66,12741,12741,11861,12323,11856
11561,34,77,7116,4445,5.87029e+18,69.0459,810.535,11561,68,67,10273,8225,4633,4682,6026
53072,113,277,33010,20062,5.87704e+18,236.388,2759.67,53072,153,156,51593,49963,24061,22786,23809
30299,106,179,18732,11567,5.87009e+18,117.016,1597.08,30299,83,85,30059,29860,20232,19710,21379
83648,81,215,51536,32112,5.87002e+18,139.192,2911.65,83648,95,101,82985,82563,38644,37738,47650
58608,75,241,36257,22351,5.87084e+18,155.178,2339.85,58608,105,112,57628,56894,17038,22823,21821
47661,76,179,29317,18344,5.87017e+18,106.341,2099.78,47661,84,93,47216,46966,23507,22772,27886
99757,236,325,61805,37952,5.87804e+18,223.062,4094.51,99757,186,195,99355,99066,80023,85094,71299
94529,58,270,58435,36094,5.87021e+18,202.127,3448.48,94529,112,115,91887,88254,22792,30760,29399
91722,218,282,56703,35019,5.87076e+18,154.92,3122.36,91722,119,130,91423,91274,76849,85136,78885
12133,97,153,7504,4629,5.869e+18,81.0525,1002.99,12133,68,70,11964,11870,8505,7723,7345
89180,70,273,55408,33772,5.87537e+18,245.625,3458.9,89180,175,179,84993,81429,19151,32171,24985
60179,159,217,37225,22954,5.87017e+18,125.238,2559.43,60179,88,87,59962,59838,56848,57814,57779
75881,106,272,46821,29060,5.87341e+18,234.738,3109.92,75881,159,159,74189,72445,31942,33861,30299
65759,178,203,40517,25242,5.87018e+18,128.979,2549.13,65759,92,98,65556,65486,61784,63668,64912
64692,304,411,40058,24634,5.88015e+18,214.22,3619.65,64692,176,178,64281,64179,52312,55363,38677
76474,157,302,47176,29298,5.8708e+18,168.666,3044.12,76474,113,121,76008,75721,56482,57605,63058
13319,74,235,8422,4897,5.89711e+18,183.858,1492.05,13319,136,124,11353,9085,4443,4234,4788
56340,34,264,34881,21459,5.871e+18,183.761,2444.67,56340,118,122,50971,44061,8623,15549,12267
69678,291,295,43674,26004,5.89206e+18,234.642,3545.31,69678,193,201,69383,69380,68888,69232,69100
58794,112,251,36376,22418,5.87076e+18,158.384,2382.45,58794,110,112,58287,57690,28829,27726,28885
50084,41,266,30776,19308,5.87218e+18,160.054,2315.03,50084,110,115,47106,43530,9479,14078,12374
87996,65,277,54184,33812,5.8709e+18,160.506,3034.77,87996,120,129,86096,84666,21247,31027,27797
73213,148,271,45304,27909,5.86986e+18,191.153,3111.46,73213,113,117,72682,72097,48831,41800,55740
88541,202,288,54572,33969,5.87018e+18,151.391,3124.92,88541,106,110,88253,88159,71861,78904,72958
23726,215,253,14698,9028,5.87094e+18,143.087,1632.55,23726,95,93,23473,23418,22462,23044,22772
37717,180,267,23227,14490,5.87503e+18,209.812,2180.01,37717,121,126,37332,37032,27808,29947,27527
67246,192,285,41873,25373,5.8802e+18,229.617,3222.05,67246,179,174,66700,66107,48400,52388,50326
99161,216,426,61749,37412,5.88001e+18,186.18,4749.66,99161,187,189,98664,98474,79393,75657,67852
96509,250,281,59510,36999,5.87267e+18,227.726,3454.83,96509,167,164,96211,96058,84496,91344,93412
49973,178,301,30831,19142,5.87104e+18,133.614,2507.41,49973,105,104,49619,49477,42708,41450,43234
91995,118,298,56837,35158,5.87067e+18,204.014,3272.83,91995,128,130,91231,90439,49205,44513,55491
81782,71,288,50426,31356,5.87019e+18,141.814,3014.39,81782,107,108,80724,79913,25965,36491,34097
83197,256,317,51422,31775,5.87277e+18,194.491,3456.75,83197,144,147,82871,82764,74297,78169,72450
7440,43,143,4573,2867,5.8691e+18,61.9772,772.659,7440,61,64,7059,6563,3269,3293,2462
93212,53,342,57530,35682,5.87045e+18,157.867,3461.91,93212,118,116,90042,85302,25392,31846,28226
5417,188,245,3391,2026,5.89227e+18,108.483,974.478,5417,90,82,5172,5157,4448,4344,4118
42455,156,261,26643,15812,5.89237e+18,216.761,2669.8,42455,178,176,41518,40281,26869,26215,29876
68882,188,285,42899,25983,5.88041e+18,228.981,3259.28,68882,181,174,68299,67631,48811,52177,51098
68458,81,211,42276,26182,5.87018e+18,120.505,2712.66,68458,86,88,68052,67887,33158,33125,38330
53586,173,322,33293,20293,5.88079e+18,169.343,3134.89,53586,159,168,52979,52376,38621,37372,32923
20103,109,173,12371,7732,5.87007e+18,109.08,1290.28,20103,75,80,19907,19761,14900,15317,17028
61953,238,304,38167,23786,5.87454e+18,214.015,2893.69,61953,146,145,61621,61475,49907,55580,47310
50915,207,214,31359,19556,5.87028e+18,127.487,2264.16,50915,86,88,50701,50699,50698,50475,50609
40595,130,251,24997,15598,5.87053e+18,122.455,2068.02,40595,93,102,40317,40133,26200,23190,26193
23226,20,147,14274,8952,5.86959e+18,101.835,1383.09,23226,72,77,17936,13207,3282,3492,4039
41412,52,173,25581,15831,5.87016e+18,109.881,1913.19,41412,84,90,40430,39158,11868,15651,17310
5072,32,136,3133,1939,5.86861e+18,69.2666,622.055,5072,54,56,4537,3944,1377,1813,1663
59677,78,232,36721,22956,5.86979e+18,153.014,2347.34,59677,101,110,58777,58069,21474,24339,25212
39077,27,268,24129,14948,5.87431e+18,172.049,2254.98,39077,130,136,32367,25744,5246,9468,4735
13930,8,81,8637,5293,5.86907e+18,68.9383,892.907,13930,68,70,5881,0,690,1292,1315
12874,139,236,8025,4849,5.87721e+18,180.619,1318.45,12874,103,99,12486,12198,8223,8088,7902
6901,35,144,4268,2633,5.86925e+18,65.705,819.813,6901,66,71,5993,4754,2199,2307,2359
65087,121,411,40361,24726,5.87984e+18,202.056,3780.37,65087,175,177,63215,60884,30849,31575,25637
74235,278,307,46213,28022,5.88468e+18,232.214,3598.67,74235,195,184,73928,73833,72346,72705,72904
68360,184,397,42344,26016,5.87301e+18,168.771,3528.38,68360,146,144,67799,67399,52494,52472,51748
64073,93,302,39535,24538,5.87073e+18,157.572,2815.25,64073,104,117,63267,62585,30762,33131,38435
80073,78,219,49465,30608,5.87021e+18,142.085,2986.37,80073,96,95,79545,79294,40788,39691,41621
28794,157,219,17685,11109,5.87061e+18,126.143,1633.44,28794,85,91,28573,28465,23172,24710,24444
80067,107,271,49517,30550,5.87024e+18,226.032,3281.45,80067,121,120,79153,78434,37044,31782,38847
9344,310,397,5821,3523,5.88165e+18,145.351,1559.02,9344,106,100,8947,8902,7790,7921,6867
3511,34,115,2171,1340,5.86839e+18,63.5973,504.582,3511,48,51,3210,2855,906,1149,616
88704,322,342,54691,34013,5.87043e+18,146.638,3386.84,88704,118,116,88362,88349,88217,87449,87810
72985,134,307,45362,27623,5.88253e+18,245.824,3531.36,72985,191,187,71172,69025,35293,34074,36693
92586,81,301,57055,35531,5.8709e+18,197.658,3311.2,92586,120,130,91237,90220,32056,38299,45971
36507,92,275,22499,14008,5.8756e+18,189.955,2200.53,36507,126,122,35388,34216,15236,15719,15941
56095,184,307,35000,21095,5.88686e+18,224.748,3221.84,56095,182,178,55540,54967,36975,39384,38771
43921,58,217,27018,16903,5.87012e+18,160.638,2014.85,43921,97,99,42778,41894,10582,17189,18418
52753,39,212,32439,20314,5.87032e+18,125.262,2277.87,52753,89,94,49427,45265,11196,16844,14697
63514,112,298,39245,24269,5.87087e+18,149.802,2776.58,63514,108,112,62937,62395,39732,38198,44792
6001,154,214,3694,2307,5.87205e+18,119.257,811.508,6001,67,70,5787,5740,5276,5527,5374
15444,7,262,9631,5813,5.88629e+18,178.627,1611.75,15444,126,116,5473,0,709,1047,771
57283,24,259,35256,22027,5.87012e+18,119.667,2480.08,57283,94,105,46674,34790,7060,13738,10217
47925,104,190,29532,18393,5.86995e+18,117.605,2078.12,47925,88,94,47622,47309,29308,26814,33420
28401,22,255,17498,10903,5.87027e+18,100.746,1774.2,28401,86,84,21932,16374,4332,6266,3583
18846,24,275,11624,7222,5.87568e+18,125.628,1635.98,18846,98,96,14805,10802,2692,3877,3203
32476,61,262,20176,12300,5.88022e+18,203.834,2184.02,32476,147,146,29376,26784,7002,11411,8786
69774,142,257,43109,26665,5.87003e+18,128.509,2941.36,69774,104,104,69358,68985,53624,49724,56486
97243,109,307,60591,36652,5.88516e+18,235.683,4114.94,97243,202,203,93011,87729,38090,39727,39485
46775,20,262,28934,17841,5.87167e+18,176.732,2256.2,46775,110,116,36545,27852,5513,9870,5386
40143,16,197,24743,15400,5.87026e+18,115.277,2000.51,40143,83,84,27196,17589,4804,6447,4628
78541,203,215,48400,30141,5.86998e+18,130.294,2814.66,78541,94,99,78326,78325,76240,78125,78125
37370,216,229,22983,14387,5.87047e+18,156.32,1884.52,37370,98,102,37141,37141,34958,36054,36393
42752,43,173,26405,16347,5.86995e+18,103.62,1984.25,42752,82,87,40812,37919,10236,14729,13876
93771,149,285,58371,35400,5.8787e+18,234.047,3727.48,93771,196,194,92303,90673,53194,47923,54822
62069,271,315,38350,23719,5.87231e+18,148.29,2951.89,62069,124,122,61754,61697,59734,60622,59302
3241,87,189,2008,1233,5.86917e+18,65.1589,614.654,3241,58,59,3052,3025,2615,2628,2556
42915,16,290,26543,16372,5.87111e+18,162.99,2314.97,42915,109,113,29868,20520,5017,8307,4762
55199,165,286,34750,20449,5.89568e+18,222.773,3160.32,55199,194,190,54274,52906,34818,35395,39222
17885,207,261,11216,6669,5.8912e+18,154.498,1790.47,17885,133,129,17616,17534,15009,15363,14852
46126,52,285,28775,17351,5.88218e+18,191.141,2751.96,46126,161,162,40960,37397,10757,14313,11691
13234,124,247,8194,5040,5.86954e+18,117.799,1356.66,13234,86,86,12900,12672,9145,8780,9420
30908,69,230,19102,11806,5.87042e+18,163.063,1730.61,30908,97,95,30150,29525,9706,12250,12285
54490,235,272,33688,20802,5.87581e+18,225.152,2749.76,54490,160,157,54181,54015,45734,50180,49769
78886,88,215,48695,30191,5.87001e+18,130.231,2868.07,78886,91,95,78404,78117,39786,39400,42731
12847,80,260,8034,4813,5.88937e+18,156.898,1485.68,12847,119,113,11695,10529,4857,5281,5860
56851,178,272,35393,21458,5.87992e+18,188.894,2893.95,56851,168,160,56299,55578,39737,40675,40689
87791,153,270,54344,33447,5.87018e+18,227.62,3512.97,87791,135,143,86918,85850,59189,50896,65389
49011,93,226,30318,18693,5.87029e+18,135.906,2102.9,49011,94,102,48506,48003,25826,24487,32127
32837,54,211,20303,12534,5.86973e+18,118.425,1959.42,32837,85,87,31662,29501,11708,12658,12637
89501,83,279,56021,33480,5.88761e+18,219.746,3893.67,89501,205,199,82410,74430,25476,31377,31449
53585,206,266,32987,20598,5.87019e+18,166.54,2383.36,53585,111,116,53287,53105,45588,49454,47005
10292,2,152,6322,3970,5.86975e+18,87.0326,927.018,10292,64,65,916,0,86,0,44
16937,110,262,10566,6371,5.88738e+18,189.581,1681.77,16937,133,122,16043,15104,7687,7559,8661
98919,86,230,61020,37899,5.87026e+18,146.962,3268,98919,96,102,98317,97969,46652,44493,50228
12139,8,153,7470,4669,5.87024e+18,91.5364,999.178,12139,67,70,5474,0,1013,1179,593
60423,253,274,37346,23077,5.87528e+18,226.9,2853.38,60423,163,154,60146,60027,56545,58607,59428
24647,115,284,15412,9235,5.88432e+18,151.242,2096.47,24647,135,135,23687,22665,15663,15971,14355
53404,65,265,32830,20574,5.8722e+18,186.706,2442.1,53404,123,122,51669,50330,12295,19848,17661
11134,136,146,6925,4209,5.86953e+18,64.0291,935.992,11134,64,67,10988,10988,10535,10803,10559
96514,12,262,59449,37065,5.87042e+18,139.442,3186.69,96514,104,110,56388,34750,9795,10182,7515
49774,64,232,30768,19006,5.86992e+18,122.377,2161.65,49774,91,98,48939,48407,14054,20714,23642
78821,56,397,48839,29982,5.8718e+18,164.659,3652.71,78821,133,124,75533,71586,23866,27099,26638
69675,227,276,43163,26512,5.87783e+18,236.433,3190.44,69675,179,172,69325,69044,59216,64329,61707
36399,30,197,22432,13967,5.86974e+18,115.73,1898.52,36399,86,87,31530,25358,6638,9930,7363
61523,218,232,37857,23666,5.86989e+18,151.419,2378.79,61523,102,112,61291,61291,59550,60419,60354
2801,6,80,1740,1061,5.86792e+18,64.1985,413.241,2801,51,57,885,0,49,187,234
66915,22,200,41297,25618,5.87025e+18,122.27,2629.8,66915,87,89,51390,37564,9564,13055,9710
43910,204,255,27164,16746,5.87017e+18,145.516,2393.91,43910,100,98,43632,43560,42801,43152,43244
47097,159,275,29090,18007,5.8785e+18,225.889,2590.93,47097,151,149,46475,45949,30523,27253,28117
69108,141,266,42472,26636,5.87189e+18,181.736,2695.76,69108,122,125,68563,68158,39987,35231,38701
73509,124,272,45429,28080,5.87574e+18,230.834,3159.32,73509,171,170,71901,69909,34650,34751,40209
2291,134,170,1444,847,5.90942e+18,128.346,561.78,2291,77,70,2089,1955,1698,1704,1830
62930,249,314,38855,24075,5.87295e+18,163.921,3023.02,62930,135,133,62604,62512,55583,58681,53223
95110,74,281,58454,36656,5.87132e+18,165.803,3183.2,95110,125,130,93395,92172,24051,36472,38557
77577,3,285,48412,29165,5.88286e+18,232.587,3532.88,77577,196,188,12355,0,6,843,656
38599,154,179,23786,14813,5.87006e+18,114.706,1922.98,38599,80,84,38420,38380,37637,38048,38246
15221,102,144,9390,5831,5.86964e+18,83.0445,1129.75,15221,69,71,15064,15015,11832,11604,12325
15762,64,240,9696,6066,5.8746e+18,138.72,1341.47,15762,91,91,14985,14376,4758,6268,5782
69464,155,259,42816,26648,5.87056e+18,126.416,2715.01,69464,99,103,69190,69059,52281,47761,57229
94060,282,286,58349,35711,5.87951e+18,236.523,3770.25,94060,200,189,93774,93750,92858,93513,92967
50659,221,269,31667,18992,5.88508e+18,226.394,2836.47,50659,176,180,50329,50028,42504,45242,46296
28935,2,165,17814,11121,5.87004e+18,105.382,1547.71,28935,78,81,2665,0,314,0,171
2185,104,184,1374,811,5.90074e+18,127.538,565.079,2185,70,68,1877,1598,1187,1091,1261
62914,219,335,39378,23536,5.88778e+18,200.861,3560.31,62914,180,189,62509,62285,46653,47346,40301
94279,17,215,58149,36130,5.87004e+18,139.01,3103.26,94279,95,101,65575,41556,11293,11860,9020
40477,166,178,24991,15486,5.8699e+18,97.9917,1943.5,40477,81,87,40299,40299,39627,40053,39756
34204,199,258,21179,13025,5.87209e+18,182.206,1944,34204,106,112,33910,33759,28904,31312,30508
92374,79,282,56951,35423,5.87284e+18,201.612,3351.8,92374,154,160,89863,87690,25480,37724,32709
74663,99,294,46173,28490,5.87076e+18,154.359,2932.75,74663,117,125,73820,73050,34250,37515,35002
61845,254,275,38306,23539,5.87251e+18,210.925,2700.03,61845,134,138,61570,61539,57133,59580,60761
6041,3,76,3712,2329,5.86972e+18,68.6443,588.061,6041,60,59,1008,0,93,68,253
80749,123,274,49830,30919,5.87354e+18,233.256,3187.74,80749,157,159,79360,77846,38010,37988,39522
15030,76,172,9286,5744,5.87025e+18,103.614,1133.87,15030,68,74,14758,14606,7894,7346,8343
72951,91,273,45291,27660,5.87658e+18,229.638,3144.81,72951,167,170,70303,67488,25164,28621,25655
25013,91,162,15369,9644,5.87085e+18,94.1842,1424.67,25013,74,79,24781,24617,16298,14923,15554
62592,61,364,38723,23869,5.87019e+18,150.087,2931.3,62592,101,105,61041,59196,25989,27109,30075
9617,77,202,5938,3679,5.86981e+18,90.8641,939.617,9617,69,71,9331,9152,5190,5167,6431
22773,207,246,14024,8749,5.87511e+18,173.2,1642.41,22773,106,105,22509,22383,19490,21129,20410
26540,25,307,16600,9940,5.88825e+18,212.703,2255.86,26540,152,153,18358,11758,3150,5230,1920
30579,206,209,18887,11692,5.87009e+18,121.147,1893.85,30579,86,84,30370,30370,30368,30370,30370
80023,126,271,49494,30529,5.87006e+18,206.157,3254.17,80023,116,120,79294,78605,42494,39067,49011
58304,76,381,36078,22226,5.87107e+18,177.551,2925.15,58304,123,129,56796,55740,15906,22634,20182
19237,65,262,12007,7230,5.87927e+18,175.949,1699.39,19237,117,121,17677,16315,5158,7625,5431
25982,215,258,16028,9954,5.87954e+18,181.211,1880.79,25982,132,125,25699,25562,22152,23489,23097
32977,218,270,20397,12580,5.87031e+18,216.318,2219.29,32977,119,126,32615,32366,28188,29880,30102
84363,54,274,52103,32260,5.87462e+18,235.992,3325.95,84363,172,164,79120,75336,16294,27017,16639
7120,16,146,4386,2734,5.86826e+18,60,811.063,7120,61,63,4696,2953,987,1263,818
82205,107,276,50526,31679,5.87078e+18,159.783,2918.18,82205,119,128,81401,80573,39700,39708,41915
50031,160,279,31591,18440,5.90032e+18,219.32,2957.79,50031,191,185,49040,47496,30113,30267,36246
98455,121,227,60789,37666,5.87011e+18,146.421,3251.77,98455,97,103,98116,97820,59994,55002,55888
93628,154,381,57881,35747,5.87053e+18,175.965,3716.74,93628,122,117,93062,92615,72387,75057,76495
47040,192,224,28932,18108,5.86987e+18,135.878,2060.21,47040,93,104,46816,46761,41021,44458,45752
36482,213,217,22580,13902,5.87087e+18,154.052,1844.9,36482,92,98,36264,36206,35001,35884,36198
25740,228,242,16250,9490,5.89989e+18,194.9,2070.09,25740,163,158,25498,25490,25009,25264,25402
98122,74,285,61083,37039,5.87815e+18,236.759,3830.39,98122,188,196,92730,87757,24686,37164,34841
99064,193,285,61610,37454,5.87857e+18,248.612,3849.93,99064,191,195,98363,97568,68459,71263,75187
34673,181,261,21475,13198,5.87169e+18,135.251,1943.93,34673,100,105,34365,34227,26166,28313,27768
7090,17,146,4368,2722,5.86878e+18,60.5233,810.531,7090,61,63,4815,2976,990,1467,1121
58650,175,314,36235,22415,5.8731e+18,160.714,2954.07,58650,132,133,58179,57848,49054,47751,46711
31294,111,156,19314,11980,5.8699e+18,89.118,1689.57,31294,75,79,31128,31041,24856,25859,27467
62385,212,215,38534,23851,5.87018e+18,128.513,2538.57,62385,88,93,62170,62164,62167,61908,62170
97419,126,320,59981,37438,5.87257e+18,232.738,3618.11,97419,148,146,96443,95339,48577,45767,48926
89024,186,276,54885,34139,5.87266e+18,211.746,3298.46,89024,158,158,88458,87965,62932,63685,69923
56459,166,260,34809,21650,5.87013e+18,134.389,2466.4,56459,94,96,56193,56057,49264,47788,53505
90494,161,274,55925,34569,5.87547e+18,245.867,3500.12,90494,185,175,89462,88440,57664,51661,55976
82590,98,272,50759,31831,5.87163e+18,189.794,2995.8,82590,134,137,81361,80154,33107,34371,32103
34860,114,196,21471,13389,5.87019e+18,104.287,1881.74,34860,82,88,34631,34475,24222,21807,23540
63401,7060,13476,40052,23349,5.68791e+18,619.156,19270.4,63401,836,308,49925,49653,30633,31616,5745
39215,159,260,24274,14941,5.86962e+18,150.498,2275.84,39215,102,102,38856,38542,31323,29668,34088
78107,227,267,48350,29757,5.87076e+18,172.63,2837.53,78107,122,131,77826,77749,67172,73472,69505
5784,97,147,3541,2243,5.87206e+18,75.8005,668.651,5784,55,61,5637,5579,4576,4851,4845
12066,132,207,7398,4668,5.86933e+18,92.9562,1039.4,12066,74,75,11854,11762,8888,8805,10616
86593,41,271,53539,33054,5.87009e+18,195.671,3383.62,86593,117,121,79446,70286,17573,24824,20143
90603,159,285,56403,34200,5.87895e+18,226.748,3679.67,90603,192,183,89450,88151,55835,49865,51920
90636,39,314,55922,34714,5.87214e+18,201.945,3520.29,90636,144,143,83303,75221,15342,24404,20253
12476,63,230,7691,4785,5.87872e+18,142.124,1222.62,12476,94,86,11674,11036,3640,4603,3554
46651,51,192,28801,17850,5.86992e+18,99.8941,2206.14,46651,85,84,45270,42875,17425,19657,21409
50922,99,260,31470,19452,5.87001e+18,189.218,2569.26,50922,101,105,50301,49922,23871,20135,23728
77177,37,294,47739,29438,5.87104e+18,151.907,2970.39,77177,117,125,71048,64392,14871,20962,16556
49349,218,330,30880,18469,5.88744e+18,165.729,3193.72,49349,165,174,48996,48886,38783,39081,34442
89176,222,294,55072,34104,5.87029e+18,175.87,3104.87,89176,117,119,88882,88796,84481,86552,85145
30086,201,218,18507,11579,5.87027e+18,135.526,1657.32,30086,85,90,29868,29832,27716,28973,28959
8425,18,144,5198,3227,5.87061e+18,67.3519,902.039,8425,68,67,5587,3297,1232,1768,1430
16043,150,152,9918,6125,5.86899e+18,84.8177,1202.69,16043,69,73,15891,15891,15869,15888,15881
73082,186,259,45041,28041,5.87055e+18,124.115,2791.02,73082,99,103,72823,72732,59113,64716,62646
28325,101,156,17503,10822,5.86937e+18,72.477,1628.56,28325,78,78,28169,28147,23156,22242,19346
27183,57,300,17047,10136,5.89064e+18,147.766,2342.17,27183,154,150,23045,19171,9209,9949,8755
24800,102,256,15236,9564,5.87314e+18,137.962,1679.58,24800,96,97,24306,23939,14987,15179,14881
31167,73,256,19306,11861,5.87148e+18,177.856,1864.17,31167,104,106,30245,29632,10714,12822,13584
41133,66,264,25469,15664,5.87133e+18,165.879,2127.82,41133,106,113,39944,39049,12213,16525,17186
93406,161,319,57727,35679,5.87098e+18,221.012,3381.94,93406,124,134,92899,92520,52344,45199,50451
36706,125,342,22640,14066,5.87045e+18,143.177,2343.01,36706,107,101,36176,35825,22099,20983,22467
30258,128,215,18621,11637,5.8698e+18,127.2,1665.26,30258,84,90,30001,29817,21369,19337,23946
38473,112,177,23732,14741,5.87011e+18,109.31,1935.03,38473,80,81,38268,38153,29015,29490,30050
2900,20,75,1781,1119,5.86666e+18,60.4931,411.123,2900,51,54,2050,1449,575,774,983
73622,220,250,45531,28091,5.87001e+18,134.843,3010.17,73622,106,104,73365,73283,68869,71626,72571
55936,35,266,34437,21499,5.87136e+18,168.122,2433.61,55936,111,120,50833,44522,9097,13565,10112
70550,117,271,43655,26895,5.87002e+18,194.811,3062.86,70550,112,117,69824,69186,36694,33003,40908
95425,8,228,58820,36605,5.87005e+18,144.415,3115.52,95425,99,104,41641,0,6681,6816,4661
63203,282,315,39041,24162,5.87313e+18,160.451,3041.43,63203,134,136,62888,62838,58402,60900,59444
88594,102,276,54806,33788,5.87096e+18,169.392,3035.53,88594,124,129,87626,86663,37520,37874,38944
50504,153,264,31046,19458,5.87286e+18,200.458,2392.17,50504,127,128,49974,49600,32903,28954,35054
47461,169,306,29466,17995,5.87492e+18,219.11,2600.86,47461,138,140,46896,46459,27607,24630,23042
78901,92,215,48700,30201,5.87022e+18,129.697,2898.6,78901,90,91,78486,78260,40320,36617,45026
22396,392,412,14129,8267,5.89889e+18,194.081,2338.54,22396,154,159,21984,21983,21832,21936,21412
34646,53,255,21831,12815,5.89668e+18,190.384,2424.29,34646,176,165,27671,22483,6307,9075,9343
28119,203,311,17447,10672,5.87323e+18,104.407,2030.1,28119,94,90,27808,27766,26932,26939,26296
82564,116,229,50954,31610,5.87027e+18,141.338,2990.14,82564,92,93,82233,82007,54081,50897,58930
96610,198,316,59584,37026,5.87252e+18,205.341,3646.88,96610,146,147,96156,95805,81344,78867,82443
14796,299,397,9181,5615,5.8765e+18,133.222,1846.82,14796,109,99,14399,14359,13687,13614,12832
89479,30,381,55325,34154,5.87076e+18,168.28,3490.04,89479,126,135,77597,63960,11028,21940,10386
31422,6,159,19318,12104,5.87025e+18,85.0837,1698.25,31422,76,80,10471,0,1060,1488,594
68649,301,314,42369,26280,5.87276e+18,165.036,3132.13,68649,135,134,68335,68308,66880,67672,66709
25912,181,258,16030,9882,5.87736e+18,186.817,1885.42,25912,124,125,25552,25259,18514,20103,18044
98443,245,285,61238,37205,5.87866e+18,236.694,3838.74,98443,190,197,98101,97900,82617,90205,85906
75238,50,257,46555,28683,5.87022e+18,160.849,3017.08,75238,106,105,72083,67469,17570,23569,15427
75113,245,298,46370,28743,5.87095e+18,164.461,3022.16,75113,117,122,74812,74709,69392,72364,68304
79351,49,285,49363,29988,5.87894e+18,227.401,3437.58,79351,185,185,71513,64834,14442,23121,15771
16273,74,117,10020,6253,5.86873e+18,68.5289,1045.97,16273,70,74,16152,16074,10370,9598,9117
68498,152,327,42514,25984,5.87804e+18,171.323,3483.02,68498,157,172,67633,66723,50443,51197,47818
59441,130,266,36519,22922,5.87153e+18,181.779,2506.38,59441,118,126,58827,58300,34012,31198,38184
99239,96,246,61105,38134,5.87015e+18,140.736,3181.08,99239,101,107,98647,98100,49315,46398,54794
26629,124,165,16369,10260,5.8702e+18,109.695,1481.64,26629,77,82,26461,26349,23213,24410,24835
84215,247,300,52059,32156,5.87081e+18,196.518,3126.41,84215,123,123,83915,83800,82534,83181,83158
33772,163,197,20872,12900,5.87019e+18,102.006,1951.05,33772,84,81,33575,33527,32322,32927,31893
12198,185,207,7516,4682,5.87034e+18,84.5221,1075.63,12198,72,75,11991,11980,11480,11797,11754
45441,28,272,28058,17383,5.8742e+18,198.971,2451.98,45441,131,142,37757,29944,7127,11424,5870
55665,249,381,34436,21229,5.87078e+18,158.248,2996.63,55665,123,117,55284,55182,49150,49402,48586
74029,201,316,45685,28344,5.87316e+18,164.263,3241.98,74029,137,137,73638,73407,64408,64239,62113
64386,258,269,39651,24735,5.87112e+18,202.107,2686.85,64386,129,139,64117,64117,63633,63734,64013
33257,238,264,20464,12793,5.87244e+18,199.237,1975.52,33257,108,115,32993,32947,31351,32220,32430
30402,167,258,18799,11603,5.87594e+18,184.848,2005.64,30402,124,129,29948,29588,21254,20156,22087
70785,53,211,43720,27065,5.8703e+18,121.38,2759.46,70785,88,89,68928,65319,18894,24708,24577
36193,112,217,22252,13941,5.86998e+18,131.163,1808.85,36193,87,94,35884,35617,22939,23512,29626
89620,208,426,56020,33600,5.88544e+18,215.426,4664.8,89620,195,207,89035,88585,58951,56698,47396
72845,52,392,45099,27746,5.88121e+18,248.447,3582.13,72845,186,183,65184,60048,11895,20657,2669
68071,241,270,42146,25925,5.8701e+18,185.732,3006.01,68071,119,120,67785,67669,66429,67034,66530
18261,225,253,11422,6839,5.88449e+18,200.106,1687.28,18261,130,125,18008,17944,17156,17629,17645
87049,110,282,53674,33375,5.87305e+18,200.156,3266.41,87049,154,157,85582,83995,41604,41547,35747
58638,214,327,36383,22255,5.87605e+18,150.476,3176.43,58638,140,140,58305,58217,53639,53638,51151
51440,154,261,32260,19180,5.88933e+18,232.795,2920.21,51440,184,184,50319,48911,31484,29976,33929
8527,16,76,5242,3285,5.87171e+18,66.8699,692.569,8527,63,65,5500,3360,1229,1534,2092
66512,90,268,40858,25654,5.87147e+18,157.834,2627.16,66512,117,123,65553,64616,25988,30525,32674
34547,154,250,21329,13218,5.87036e+18,108.451,2045.29,34547,95,95,34245,34021,27018,25219,28971
56618,94,268,34855,21763,5.87383e+18,205.626,2623.21,56618,138,136,55154,53658,22109,23018,21566
65674,59,213,40474,25200,5.87013e+18,128.069,2554.19,65674,94,98,64531,63338,21368,25470,25983
56804,282,328,35266,21538,5.87721e+18,150.487,3135.94,56804,140,137,56476,56443,54299,54321,53770
7796,91,231,4911,2885,5.89631e+18,175.893,1130.07,7796,111,99,6973,6045,3386,3156,3829
15443,115,214,9526,5917,5.86947e+18,104.252,1176.66,15443,76,81,15200,15023,10686,10379,12773
67160,169,269,41261,25899,5.87248e+18,198.149,2721.17,67160,132,135,66664,66253,45847,41577,45719
7258,34,77,4471,2787,5.86829e+18,69.2436,645.478,7258,62,65,6404,5136,2889,2946,3863
86886,207,279,53745,33141,5.86999e+18,151.778,3241.9,86886,109,107,86586,86441,81414,83256,83455
48364,274,426,29954,18410,5.87309e+18,140.411,3098.81,48364,124,115,47938,47933,46590,46609,44787
64575,132,328,40072,24503,5.87674e+18,155.229,3325.53,64575,143,150,63677,62686,44538,47734,45190
61033,9,224,37746,23287,5.86995e+18,151.788,2383.15,61033,102,108,30668,0,4767,6556,3050
23852,13,170,14733,9119,5.86988e+18,92.7616,1454.7,23852,77,78,14165,8302,2996,3418,2278
93775,199,328,58158,35617,5.87667e+18,222.444,3951.06,93775,175,175,93276,92829,70151,73560,73706
16555,2,131,10182,6373,5.87039e+18,69.7711,1094.13,16555,71,72,1455,0,142,0,19
76215,117,225,47062,29153,5.87014e+18,144.413,2915.78,76215,94,91,75902,75707,51586,47147,49615
1811,196,203,1136,675,5.89291e+18,109.862,534.029,1811,63,56,1608,1608,1601,1607,1586
78697,168,274,48616,30081,5.87499e+18,215.96,3226.08,78697,173,164,77945,77189,51330,46325,48011
62040,192,275,38280,23760,5.878e+18,233.084,2932.32,62040,162,166,61536,61025,44602,48804,44205
33300,122,284,20791,12509,5.8827e+18,160.118,2358.44,33300,144,145,32294,31020,19788,20894,19616
95579,5,352,58888,36691,5.87045e+18,176.042,3514.27,95579,120,121,27224,0,521,4263,2406
86153,167,222,53187,32966,5.87012e+18,143.606,3059.11,86153,93,97,85931,85833,77261,81585,83038
11771,29,292,7390,4381,5.89142e+18,130.77,1541.05,11771,112,111,8068,5007,2185,2531,1715
19270,14,145,11856,7414,5.86934e+18,91.3565,1238.92,19270,68,75,12348,7263,2543,2130,2139
25623,54,154,15774,9849,5.86956e+18,86.4965,1504.99,25623,72,77,25139,24298,10300,10988,10855
83053,1576,5725,52344,30709,5.81898e+18,389.586,11527.2,83053,355,271,77328,75966,30594,42353,10860
29149,163,262,18041,11108,5.87261e+18,177.04,1836.34,29149,100,108,28815,28630,19043,17524,17753
16671,151,250,10326,6345,5.88412e+18,191.198,1575.76,16671,124,115,16224,15854,10934,10809,11593
40636,154,266,25020,15616,5.87114e+18,164,2116.21,40636,104,113,40238,40000,29342,27375,30849
31919,68,306,19664,12255,5.87058e+18,199.54,2020.45,31919,108,115,30737,29773,8764,12448,11986
11190,93,155,6864,4326,5.8702e+18,83.513,949.297,11190,64,65,11013,10943,6950,6523,6655
18807,196,247,11606,7201,5.8703e+18,104.576,1535.01,18807,76,82,18560,18488,14894,16732,13815
73885,222,327,45776,28109,5.87382e+18,198.03,3384.24,73885,139,135,73557,73412,68354,69272,68681
91079,258,397,56422,34657,5.87291e+18,219.356,3876.43,91079,155,169,90665,90556,65038,64816,56141
38426,219,255,23726,14700,5.87062e+18,104.278,2040.39,38426,89,89,38171,38136,35512,36989,37177
4888,33,81,3008,1880,5.86889e+18,62.7966,540.229,4888,58,65,4201,3121,2001,1978,2598
65567,154,257,40521,25046,5.87007e+18,172.203,2808.78,65567,95,100,65214,64934,42820,34340,44764
34469,208,260,21279,13190,5.86989e+18,142.304,2079.55,34469,88,94,34209,34165,28384,31619,27067
91208,269,270,56383,34825,5.87026e+18,203.518,3383.48,91208,111,114,90938,90938,90937,90938,90938
2450,26,192,1545,905,5.90996e+18,122.127,597.405,2450,72,64,1443,656,285,376,378
62790,256,426,39188,23602,5.88408e+18,193.111,3978.65,62790,175,181,62364,62296,49779,49456,39500
85847,18,381,53103,32744,5.87077e+18,177.659,3452.12,85847,127,134,62493,41433,9717,15998,6364
6019,89,107,3690,2329,5.86954e+18,53.1733,629.422,6019,58,59,5912,5912,5452,5643,5634
33605,52,173,20769,12836,5.87031e+18,100.234,1728.59,33605,80,84,32812,31740,10833,14222,14649
43845,95,260,27161,16684,5.8724e+18,201.974,2240.1,43845,124,127,42855,41957,19134,20033,22727
72841,71,307,45320,27521,5.88354e+18,234.219,3552.68,72841,195,182,66760,60479,15820,24558,19528
55395,101,307,34461,20934,5.88386e+18,216.067,3151.25,55395,174,170,52798,49791,23275,23132,23099
42502,106,173,26254,16248,5.8702e+18,110.247,1942.39,42502,83,88,42258,42040,29689,28000,34675
8063,85,215,5083,2980,5.89969e+18,143.475,1125.41,8063,108,99,7191,6183,3415,3254,3536
19149,14,272,11865,7284,5.87796e+18,125.224,1692.23,19149,103,104,11744,6713,2089,2498,1668
8981,25,144,5535,3446,5.86943e+18,86.7843,825.723,8981,61,66,7765,6304,1785,2508,2313
76190,24,276,47584,28606,5.88706e+18,228.042,3551.5,76190,195,195,53576,35999,8158,14716,7558
33398,56,248,20562,12836,5.87043e+18,112.519,1893.89,33398,90,90,32445,31351,12507,14682,15055
82936,78,271,51344,31592,5.87132e+18,190.484,2997.43,82936,132,142,81133,79659,20901,31699,33810
63679,177,229,39400,24279,5.87014e+18,127.441,2652.11,63679,91,92,63450,63403,61723,62273,61592
34823,291,307,21920,12903,5.89757e+18,207.98,2629.99,34823,173,176,34516,34499,33768,34203,33680
20614,192,253,12844,7770,5.88479e+18,197.165,1766.81,20614,131,134,20297,20031,16724,17984,17688
29463,76,274,18209,11254,5.87467e+18,207.694,1991.43,29463,121,109,28312,27307,8043,11158,6994
50703,131,265,31353,19350,5.8712e+18,170.711,2327.01,50703,113,119,50180,49785,29859,29551,35191
22915,5,239,14095,8820,5.87068e+18,98.4896,1550.49,22915,84,81,6513,0,154,1104,215
69861,88,285,43569,26292,5.88198e+18,247.912,3368.01,69861,184,181,66076,61768,22349,26239,24916
37147,205,279,23229,13918,5.8851e+18,217.884,2497.67,37147,167,165,36783,36456,28874,31069,27223
86991,149,277,53855,33136,5.87205e+18,196.466,3136.77,86991,144,146,86285,85684,50463,43877,51067
82925,150,281,51131,31794,5.87239e+18,203.864,3200.57,82925,154,160,82103,81386,48194,43871,41198
33878,209,258,20955,12923,5.87618e+18,193.012,2119.58,33878,135,130,33564,33311,28587,30791,31023
74805,135,285,46627,28178,5.88005e+18,242.106,3404.75,74805,189,187,73097,71157,37202,34221,37064
97442,340,342,60313,37129,5.87597e+18,206.178,4064.92,97442,173,164,97100,97094,97029,97032,97069
44001,118,173,27134,16867,5.86979e+18,103.829,2009.59,44001,81,90,43802,43655,33532,31636,36820
66126,27,269,40730,25396,5.87104e+18,201.027,2701.3,66126,128,138,56394,45629,9111,15935,9436
28234,132,158,17453,10781,5.87042e+18,82.4485,1609.91,28234,77,79,28076,28060,25948,27175,24464
38505,119,269,23785,14720,5.8746e+18,173.084,2241.26,38505,128,132,37640,36727,19027,19143,20544
22083,178,270,13657,8426,5.86956e+18,204.508,1832.01,22083,105,109,21676,21372,15954,14582,16164
41717,47,260,26041,15676,5.88618e+18,226.662,2588.57,41717,173,167,35083,28806,7397,12033,8747
55274,124,211,34112,21162,5.87016e+18,129.483,2341.58,55274,89,92,55018,54792,40792,42837,44562
2690,46,134,1648,1042,5.87101e+18,57.9814,467.797,2690,48,49,2503,2418,1087,1305,1298
87259,198,303,53845,33414,5.87094e+18,163.912,3213.05,87259,118,123,86892,86668,72410,70977,74240
73314,228,289,45174,28140,5.87059e+18,129.507,2877.45,73314,99,105,73025,73001,65812,69248,70222
1260,10,120,784,476,5.86573e+18,43.8889,336.023,1260,44,41,599,394,87,159,186
68263,184,222,42207,26056,5.86989e+18,155.887,2761.68,68263,92,91,68041,67983,63159,66092,66303
16621,210,211,10222,6399,5.87001e+18,93.7146,1229.03,16621,78,77,16410,16406,16410,16410,16410
58255,80,219,35986,22269,5.87032e+18,139.141,2504.57,58255,88,90,57825,57630,25204,23662,25903
26043,49,296,16155,9888,5.87652e+18,143.907,2052.21,26043,119,119,23647,21303,9196,10424,9701
69406,188,200,42850,26556,5.87008e+18,123.101,2691.91,69406,87,90,69206,69201,68037,68825,68807
19830,72,172,12168,7662,5.87054e+18,106.647,1282.09,19830,76,80,19478,19265,10195,9670,10246
55280,163,305,34907,20373,5.90175e+18,213.825,3147.36,55280,191,188,54318,52818,32710,32525,39115
19201,91,213,11875,7326,5.87029e+18,98.136,1308.16,19201,78,79,18900,18672,10093,9919,14396
28499,22,381,17649,10850,5.87174e+18,154.383,2216.76,28499,113,111,22200,17045,3493,6267,2369
82949,216,301,51092,31857,5.87082e+18,159.211,3121.41,82949,121,127,82625,82509,66219,74920,65095
40651,46,264,24980,15671,5.87187e+18,169.127,2116.52,40651,110,119,38534,36713,9322,13179,10316
57348,123,307,35617,21731,5.88204e+18,226.473,3143.77,57348,173,173,55698,53598,26759,26836,30231
99684,299,318,61755,37929,5.87796e+18,227.053,4002.37,99684,193,191,99366,99350,92748,96253,95798
95681,189,301,59040,36641,5.87085e+18,165.228,3349.08,95681,118,127,95296,95075,78109,74459,79375
94926,285,288,58582,36344,5.87011e+18,149.028,3219.74,94926,106,110,94638,94638,94636,94638,94634
64723,195,220,39852,24871,5.87022e+18,128.275,2589.12,64723,88,93,64503,64498,61565,62788,63303
95348,226,303,58861,36487,5.87066e+18,165.913,3344.08,95348,120,131,95023,94917,81555,87721,81940
53338,10,266,32774,20564,5.87243e+18,184.555,2448.15,53338,125,123,28877,19928,4438,6643,2245
69094,4,273,42445,26649,5.87157e+18,159.274,2689.2,69094,117,125,16393,0,9,2724,319
37595,28,270,23269,14326,5.87029e+18,194.504,2305.85,37595,111,112,29846,20723,6144,8153,5644
17976,132,217,11127,6849,5.8705e+18,95.9858,1303.64,17976,79,81,17759,17684,12854,12378,11876
63242,140,274,39026,24216,5.87354e+18,206.797,2827.01,63242,152,144,62376,61761,34150,32360,36098
1323,72,131,827,496,5.87284e+18,49.8337,336.433,1323,40,38,1192,1158,790,763,869
11700,50,208,7235,4465,5.87107e+18,89.5137,1028.69,11700,71,72,11189,10865,3562,4923,5381
46391,169,195,28621,17770,5.87008e+18,101.057,2205.36,46391,83,83,46196,46188,44176,45426,44709
65028,100,276,40124,24904,5.87375e+18,206.385,2881.44,65028,146,148,63489,61968,25722,27709,21165
54277,172,259,33463,20814,5.86984e+18,125.067,2395.78,54277,94,96,54018,53900,48680,49241,51766
9430,86,237,5849,3581,5.87668e+18,139.006,1086,9430,81,88,8974,8650,4184,4345,4325
20597,97,258,12834,7763,5.87849e+18,174.137,1710.12,20597,120,118,19635,18701,8790,8763,8512
46716,120,180,28886,17830,5.86992e+18,108.167,2139.74,46716,81,85,46512,46408,36498,36794,39221
56746,125,272,34996,21750,5.87334e+18,188.013,2665.55,56746,141,143,55832,54815,30560,30158,37126
45503,126,315,28168,17335,5.87403e+18,149.766,2640.66,45503,118,119,44846,44249,33167,35050,32331
14213,140,259,8876,5337,5.88368e+18,180.407,1522.3,14213,123,105,13773,13426,8894,8502,8380
91178,38,328,56517,34661,5.87682e+18,191.352,3910.58,91178,169,179,80007,69683,15794,25848,20045
22531,133,154,13959,8572,5.86956e+18,67.8616,1423.06,22531,74,76,22377,22377,21895,22146,21720
76231,172,237,46863,29368,5.87056e+18,138.633,2771.74,76231,102,112,75949,75835,60714,67864,63572
78339,264,397,48547,29792,5.87346e+18,224.66,3553.56,78339,152,167,77931,77820,53372,54700,44975
94937,49,352,58488,36449,5.87057e+18,176.23,3503.82,94937,119,119,90911,86222,19621,28708,21070
79263,232,426,49460,29803,5.88346e+18,208.286,4394.93,79263,186,195,78784,78595,60152,56860,46331
18084,55,218,11127,6957,5.86982e+18,103.063,1308.01,18084,76,79,17540,17077,6720,8141,8385
41058,162,342,25352,15706,5.87022e+18,157.71,2471.72,41058,105,102,40620,40333,33302,33328,34307
78253,97,307,48841,29412,5.88737e+18,231.483,3765.49,78253,194,200,73617,67913,27836,30001,30069
2176,52,201,1351,825,5.86935e+18,81.9393,539.819,2176,54,58,1849,1665,701,738,796
18965,119,283,11704,7261,5.87173e+18,120.575,1616.66,18965,95,94,18556,18262,11743,12149,10830
87559,144,327,54282,33277,5.8754e+18,210.983,3770.94,87559,160,160,86626,85714,53020,48214,58411
31561,32,263,19549,12012,5.87202e+18,173.417,1901.26,31561,97,110,27814,23534,4738,8483,6284
89606,121,217,55248,34358,5.8703e+18,139.665,3024.84,89606,92,100,89285,88967,61169,58385,68578
39742,271,307,24747,14995,5.88295e+18,170.444,2701.15,39742,156,157,39435,39399,36218,37702,36751
2505,43,98,1543,962,5.85952e+18,46.5469,408.307,2505,46,48,2366,2250,1549,1592,1652
88079,112,276,54311,33768,5.87272e+18,206.573,3272.73,88079,148,157,86611,85000,42709,42404,46395
98291,254,317,60670,37621,5.87193e+18,238.087,3629.15,98291,149,144,97959,97812,89563,92421,91834
49325,9,228,30497,18828,5.86981e+18,121.824,2134.11,49325,91,97,24514,0,3791,5095,3322
48387,4,290,29902,18485,5.87136e+18,154.424,2435.61,48387,108,116,11503,0,24,1544,1288
23481,165,191,14471,9010,5.86983e+18,92.5949,1501.09,23481,79,79,23290,23258,22711,23065,22956
26347,66,163,16207,10140,5.86967e+18,108.624,1500.97,26347,76,82,25935,25705,11709,12201,13690
79246,55,285,49311,29935,5.87829e+18,226.531,3427.89,79246,184,180,72640,67814,15892,25074,21483
80639,234,301,49650,30989,5.87107e+18,194.171,3086.21,80639,117,121,80338,80184,77591,78702,78000
73034,78,238,45144,27890,5.87031e+18,167.338,2899.49,73034,95,97,72377,72061,29947,30349,32725
90788,248,294,56073,34715,5.87032e+18,199.74,3165.87,90788,122,122,90494,90452,86928,88878,87831
33731,19,264,20747,12984,5.87334e+18,199.741,2000.14,33731,107,116,25563,17753,3581,6904,4542
16524,135,237,10229,6295,5.87682e+18,172.896,1472.04,16524,112,105,16073,15650,10213,9748,10524
85465,21,285,53130,32335,5.87802e+18,216.404,3537.56,85465,182,177,64150,47999,9282,17766,5822
51944,122,228,31985,19959,5.87004e+18,126.043,2197.5,51944,94,99,51636,51359,31721,29684,40425
95999,186,289,59157,36842,5.87047e+18,150.425,3234.65,95999,103,111,95705,95569,76562,82681,87700
38445,165,199,23719,14726,5.87035e+18,102.448,1981.39,38445,83,88,38246,38217,32768,35744,32791
55929,274,300,34548,21381,5.8711e+18,154.897,2635.53,55929,108,114,55629,55603,50122,53245,53104
32742,104,257,20286,12456,5.87502e+18,166.346,2021.72,32742,124,118,31886,31006,15070,14183,13024
19511,98,144,12061,7450,5.8699e+18,90.3475,1276.29,19511,71,72,19341,19267,15275,14390,17100
43411,36,264,26883,16528,5.87769e+18,197.368,2453.95,43411,153,150,37255,32013,6613,11716,7394
29992,55,285,18710,11282,5.8818e+18,168.152,2253.74,29992,140,135,27002,24606,6930,9614,8553
6844,96,150,4217,2627,5.86973e+18,80.995,765.941,6844,60,65,6683,6609,4956,4629,4185
66560,230,327,41307,25253,5.87905e+18,188.477,3458.65,66560,166,175,66192,65994,55082,55829,50882
86680,139,316,53757,32923,5.87896e+18,240.126,3761.63,86680,188,192,84924,83188,40172,40750,31381
31615,138,178,19467,12148,5.86962e+18,80.9255,1787.66,31615,77,82,31437,31409,27954,29423,27548
71712,16,277,44572,27140,5.87799e+18,233.226,3197.11,71712,175,176,48557,32982,7391,13246,4900
50053,22,291,30843,19210,5.87073e+18,157.463,2455.45,50053,110,113,39820,30906,6968,10732,5962
72312,256,270,44711,27601,5.87016e+18,195.885,2972.02,72312,97,102,72042,72038,72024,72036,71930
54517,61,284,33990,20527,5.88147e+18,208.75,2953.12,54517,166,174,49734,45494,13600,19107,14474
87291,194,280,54500,32791,5.8838e+18,212.267,3749.71,87291,201,192,86669,85820,64137,69673,70918
1649,98,111,1021,628,5.87117e+18,41.9709,346.329,1649,41,42,1538,1532,1475,1513,1451
75308,260,272,46294,29014,5.87205e+18,196.93,2876.95,75308,136,138,75036,75036,72201,73578,74731
42752,123,260,26318,16434,5.87116e+18,139.125,2130.63,42752,103,109,42290,41882,26416,27655,30451
56328,185,257,34776,21552,5.8701e+18,140.687,2439.69,56328,98,99,56071,56004,55210,55309,55214
90209,240,294,55715,34494,5.87016e+18,167.077,3120.5,90209,111,118,89915,89885,86300,88434,88329
92881,3,237,57386,35495,5.87013e+18,156.126,3221.9,92881,97,95,15727,0,560,739,799
66621,106,232,41183,25438,5.87057e+18,149.364,2511.52,66621,104,112,66091,65542,33973,31917,44676
4249,98,200,2659,1590,5.87706e+18,101.666,720.253,4249,71,68,3963,3738,1965,2082,2054
83355,188,277,51860,31495,5.87943e+18,231.198,3501.23,83355,188,184,82702,81895,59149,63248,59644
71035,95,262,43789,27246,5.87031e+18,126.353,2759.39,71035,97,102,70529,70123,35602,38220,40595
36563,85,263,23009,13554,5.89559e+18,188.802,2511.89,36563,178,165,32827,28342,13163,12807,14499
15265,86,228,9588,5677,5.89354e+18,181.52,1544.79,15265,134,126,13807,12098,6132,5982,6643
92209,60,295,56808,35401,5.87031e+18,162.484,3146.55,92209,112,118,90362,88726,21418,32639,32112
6075,83,146,3737,2338,5.86566e+18,82.5432,712.927,6075,57,58,5902,5831,3386,3237,2815
72721,229,290,45620,27101,5.89221e+18,234.623,3601.38,72721,207,199,72371,72082,60212,62194,65070
72956,240,276,45004,27952,5.87355e+18,202.654,3022.63,72956,145,152,72647,72510,61549,67980,65392
19034,150,211,11780,7254,5.86915e+18,94.6874,1301.57,19034,77,80,18823,18778,14296,16148,16284
40325,220,321,25038,15287,5.88085e+18,171.989,2705.9,40325,143,151,39973,39854,32746,33188,30667
24043,175,219,14761,9282,5.87052e+18,133.27,1505.56,24043,85,88,23824,23794,19895,21930,19723
35494,54,172,21836,13658,5.8701e+18,100.82,1799.44,35494,77,85,34727,33588,11508,14617,16327
13158,78,150,8156,5002,5.86934e+18,67.0527,1108.05,13158,68,73,13004,12968,10131,10364,9790
37417,101,190,23101,14316,5.8696e+18,97.8654,1887.66,37417,83,85,37167,37007,26800,25993,26648
55238,83,261,34103,21135,5.87023e+18,154.089,2499.57,55238,93,96,54602,54238,20511,19512,20924
2909,36,61,1807,1102,5.86674e+18,53.6164,367.754,2909,47,49,2686,2479,1571,1535,1736
86386,178,293,53378,33008,5.87034e+18,175.206,3062.83,86386,111,119,86042,85812,68156,74756,69939
70239,244,286,43556,26683,5.87937e+18,239.808,3275.67,70239,181,175,69927,69766,61173,64932,65574
37891,23,262,23593,14298,5.87893e+18,204.467,2315.48,37891,147,147,28981,21898,4146,8474,4037
20460,163,259,12808,7652,5.88795e+18,202.294,1835.44,20460,138,127,20002,19597,13955,14316,15490
8369,56,120,5200,3169,5.86981e+18,59.6368,749.303,8369,61,60,8197,7968,3943,3669,2822
84496,206,285,52727,31769,5.88294e+18,245.202,3707.47,84496,197,193,83961,83299,66723,72648,70803
51837,222,258,31989,19848,5.8701e+18,141.715,2360.27,51837,94,96,51579,51522,49664,50774,51190
18774,94,141,11546,7228,5.87044e+18,94.0988,1236.09,18774,71,74,18591,18519,13982,13981,14277
34578,256,262,21271,13307,5.87172e+18,166.46,1968.82,34578,104,110,34316,34316,34152,34241,34313
73461,186,237,45167,28294,5.87056e+18,140.171,2716.37,73461,102,110,73193,73109,61063,67788,63890
76209,65,328,47268,28941,5.8781e+18,186.116,3644.25,76209,166,175,71549,67106,23663,30752,26092
77246,67,276,48190,29056,5.88664e+18,226.364,3568.24,77246,201,194,69134,60928,16324,25989,19252
76754,48,262,47294,29460,5.87046e+18,134.679,2851.58,76754,100,106,74097,71144,18697,25903,24423
32579,251,272,20141,12438,5.87539e+18,180.256,2119.84,32579,124,127,32307,32256,30174,31406,31116
58363,206,266,35840,22523,5.87153e+18,185.882,2484.96,58363,119,127,58059,57842,50336,54379,52169
38606,242,261,23765,14841,5.87258e+18,205.331,2129.75,38606,115,124,38344,38281,36416,37344,37929
64706,44,222,40000,24706,5.87017e+18,133.264,2658.65,64706,89,90,61147,55932,14696,20592,20948
4736,170,204,2980,1756,5.8882e+18,149.141,818.387,4736,81,75,4522,4444,3906,4151,4142
54933,67,266,33819,21114,5.87148e+18,186.458,2423.56,54933,115,123,53421,52209,14285,21021,21912
54633,62,274,33861,20772,5.87837e+18,190.976,2805.66,54633,167,157,50625,47234,11620,19109,13851
74016,261,285,46153,27863,5.88207e+18,244.114,3460.77,74016,187,188,73716,73637,69962,72137,72152
74863,78,203,46134,28729,5.87003e+18,125.85,2738.61,74863,92,99,74268,73935,34513,33381,39680
98770,203,231,60981,37789,5.87001e+18,137.255,3223.28,98770,95,99,98539,98532,95620,97251,98014
57969,208,411,35929,22040,5.88128e+18,211.663,3494.01,57969,174,177,57420,57042,34740,31691,24353
3691,31,256,2299,1392,5.87589e+18,74.2373,791.93,3691,66,66,2901,2236,713,1016,609
72233,300,302,44553,27680,5.87071e+18,160.785,2955.14,72233,110,120,71931,71931,71929,71930,71931
92730,4,307,57152,35578,5.87296e+18,198.276,3523.21,92730,159,157,21800,0,10,3643,1654
50548,293,411,31379,19169,5.87639e+18,166.181,3337.94,50548,151,140,50137,50077,47419,47207,43396
3319,124,177,2060,1259,5.87373e+18,93.6698,596.656,3319,62,59,3131,3025,2286,2354,2281
51913,77,211,32046,19867,5.86978e+18,128.823,2268.29,51913,89,92,51373,51091,25317,24412,29249
34051,42,193,20979,13072,5.86993e+18,103.918,1826.14,34051,83,81,32255,29609,9657,11876,9260
90192,251,303,55689,34503,5.87076e+18,160.306,3259.98,90192,116,128,89889,89803,78891,85115,81266
3403,19,75,2093,1310,5.86966e+18,67.5375,449.491,3403,56,56,2352,1493,586,834,819
46038,123,260,28761,17277,5.88747e+18,228.242,2728.08,46038,177,170,44182,41733,21664,20914,23231
17493,154,160,10750,6743,5.87001e+18,102.036,1220.13,17493,72,75,17333,17333,17126,17279,17241
94088,262,381,58214,35874,5.87063e+18,165.544,3699.55,94088,128,129,93707,93593,83965,86390,83514
34960,42,199,21577,13383,5.86972e+18,115.654,1963.52,34960,82,86,32648,29246,8002,10668,9159
11175,60,240,6906,4269,5.87116e+18,68.8644,1077.97,11175,76,78,10778,10387,8260,7997,9312
16815,199,246,10590,6225,5.89277e+18,181.756,1659.5,16815,138,137,16548,16407,13781,14470,14128
38415,253,262,23798,14617,5.87823e+18,203.455,2329.81,38415,152,149,38153,38142,37476,37727,37861
23917,244,258,14808,9109,5.87706e+18,180.16,1813.44,23917,126,127,23659,23646,23003,23350,23347
55083,111,191,33859,21224,5.87001e+18,113.112,2282.39,55083,89,94,54818,54548,36217,31879,39280
62296,240,257,38490,23806,5.87017e+18,132.491,2794.51,62296,103,103,62039,61974,60750,61656,61171
30156,249,253,18705,11451,5.87336e+18,165.87,1895.67,30156,119,111,29903,29903,29837,29895,29903
38194,59,258,23631,14563,5.87684e+18,200.171,2260.61,38194,144,137,35412,33279,7845,13307,7598
81602,265,272,50162,31440,5.87127e+18,143.203,2988.91,81602,111,115,81330,81330,81181,81288,81266
95320,79,318,59072,36248,5.8784e+18,226.785,3941.69,95320,191,191,90398,85524,26482,39366,27352
78487,121,277,48539,29948,5.87075e+18,153.483,2943.08,78487,120,124,77884,77225,37419,35636,34026
40493,179,247,25063,15430,5.86986e+18,148.906,2293.1,40493,97,96,40206,40039,36763,37237,38681
9757,78,214,6033,3724,5.87208e+18,94.2554,959.256,9757,67,67,9472,9305,3695,4131,2166
12674,193,240,7795,4879,5.87521e+18,133.08,1224.58,12674,87,87,12431,12362,10821,11606,11181
97655,29,325,60504,37151,5.87821e+18,226.053,4058.47,97655,186,195,78735,61478,13946,23077,9719
43028,225,273,26740,16288,5.87466e+18,201.457,2384.69,43028,137,134,42732,42576,38064,39860,40106
25102,241,270,15520,9582,5.87024e+18,201.688,1934.74,25102,107,115,24828,24715,23871,24364,23286
56552,131,264,34760,21792,5.87118e+18,165.46,2449.01,56552,114,118,56040,55566,29456,25661,25691
50520,136,275,31152,19368,5.87567e+18,222.924,2605.95,50520,142,151,49643,48861,26545,23808,24652
27821,33,182,17166,10655,5.86976e+18,76.9023,1584.99,27821,80,82,24750,19825,8347,9218,10317
5087,122,201,3226,1861,5.90012e+18,145.797,868.788,5087,101,91,4722,4330,3157,3023,3559
8350,113,123,5163,3187,5.86993e+18,76.3174,785.206,8350,60,59,8227,8222,7949,8140,8204
53259,44,237,32888,20371,5.87013e+18,119.921,2296.26,53259,93,101,50931,47949,10171,16185,15545
31827,214,273,19760,12067,5.8755e+18,203.147,2084.76,31827,124,120,31526,31397,27400,29121,29611
14079,17,210,8704,5375,5.87114e+18,92.1813,1125.49,14079,72,76,10600,7528,1774,3103,2310
67258,77,286,41699,25559,5.87865e+18,203.093,3209.69,67258,175,177,63556,59888,18971,26778,22452
16146,173,217,9990,6156,5.87e+18,94.237,1244.04,16146,76,79,15929,15912,13802,15046,13973
83217,142,282,51320,31897,5.87316e+18,205.882,3212.89,83217,153,157,82286,81543,45396,42579,41777
12908,98,264,8015,4893,5.88095e+18,140.515,1416.41,12908,107,104,12213,11581,5402,5692,3602
29017,356,411,18031,10986,5.87638e+18,158.995,2597.22,29017,127,117,28606,28573,27861,27998,27004
45001,30,323,27947,17054,5.87959e+18,151.739,2863.48,45001,142,145,35918,27221,6940,11439,7785
31445,138,155,19433,12012,5.86991e+18,93.1747,1669.46,31445,74,81,31290,31285,30006,30672,30175
95857,81,259,59280,36577,5.87032e+18,151.469,3412.75,95857,108,108,94900,94399,39931,39289,42513
76968,316,397,47701,29267,5.87224e+18,165.099,3661.45,76968,139,131,76571,76478,73744,74653,71588
75732,120,300,46792,28940,5.87095e+18,161.89,2996.85,75732,115,128,75072,74466,44073,44938,45000
42413,52,220,26253,16160,5.87018e+18,132.431,1951.65,42413,94,97,41197,40099,10781,15462,15773
18310,151,185,11339,6971,5.86958e+18,79.7373,1241.1,18310,73,75,18125,18118,18044,18065,17974
45657,137,188,28201,17456,5.87006e+18,114.25,2015.36,45657,84,92,45465,45367,37584,40663,40485
92242,232,259,57001,35241,5.87025e+18,158.74,3356.07,92242,108,108,91983,91909,90547,91352,91645
64924,83,285,40425,24499,5.87937e+18,213.3,3151.01,64924,171,174,61577,58108,19705,25445,24222
75912,124,257,46974,28938,5.87024e+18,161.937,3036.39,75912,107,105,75377,74950,44190,39381,47913
60763,8524,8852,38236,22527,5.73908e+18,519.41,14382.8,60763,581,287,51911,51911,50158,50380,24734
64008,166,270,39609,24399,5.87123e+18,159.167,2596.7,64008,111,123,63650,63400,43195,38934,40774
38073,68,381,23580,14493,5.8718e+18,152.837,2520.86,38073,116,115,36697,35617,10923,14137,12484
39610,69,279,24683,14927,5.88458e+18,214.95,2570.56,39610,166,170,35893,32164,10053,15115,9437
56793,127,204,35097,21696,5.87008e+18,117.679,2463.23,56793,86,86,56571,56456,47362,47947,52321
64795,78,304,39911,24884,5.87435e+18,208.683,2924.02,64795,146,143,62567,60661,13792,23120,10713
91952,206,226,56817,35135,5.87008e+18,153.824,3171.93,91952,95,97,91726,91706,90964,91297,91318
80250,249,316,49537,30713,5.87318e+18,187.997,3401.6,80250,145,148,79918,79783,71161,74909,69686
38185,70,218,23486,14699,5.87017e+18,153.28,1878.48,38185,92,94,37441,36911,13533,15901,17611
96855,72,328,60026,36829,5.87783e+18,222.004,4068.71,96855,177,192,91797,87144,26114,36154,28083
94324,211,285,58150,36174,5.87269e+18,202.312,3397.25,94324,157,159,93940,93549,74234,83391,70373
72206,114,235,44639,27567,5.86994e+18,159.594,2871.22,72206,95,93,71838,71603,42919,39137,41982
44429,145,224,27329,17100,5.86996e+18,124.448,2003.83,44429,89,101,44188,44041,31978,31600,36093
56223,223,264,34800,21423,5.87116e+18,165.088,2427.27,56223,115,121,55950,55869,48494,52851,51233
98950,202,314,61010,37940,5.87188e+18,199.186,3646.79,98950,148,140,98524,98216,78208,81072,84234
7825,157,242,4888,2937,5.8871e+18,142.836,1114.57,7825,92,96,7513,7355,5653,5588,5141
74658,241,285,46443,28215,5.87842e+18,224.235,3373.59,74658,170,178,74327,74197,62536,67598,63369
50093,13,264,31018,19075,5.87097e+18,174.339,2309.58,50093,114,120,32245,19694,5280,7316,4235
66968,171,273,41473,25495,5.87086e+18,161.926,2649.75,66968,120,122,66599,66374,45324,40753,44120
16986,35,262,10508,6478,5.87984e+18,121.144,1590.29,16986,107,105,14329,11823,4185,5408,4550
79826,120,342,49259,30567,5.87203e+18,190.945,3429.66,79826,134,131,79002,78150,43771,40433,49938
66075,122,342,41072,25003,5.88076e+18,157.684,3613.7,66075,161,162,64638,62675,40937,42247,39444
71869,101,265,44461,27408,5.87125e+18,181.049,2731.81,71869,124,128,70949,70021,32080,33046,35013
9483,35,125,5875,3608,5.86903e+18,67.6337,841.722,9483,63,63,8690,7608,2569,3487,3411
94620,44,300,58434,36186,5.87077e+18,185.577,3316.19,94620,123,126,90067,84583,18407,29335,26750
3704,118,209,2283,1421,5.873e+18,52.8024,647.39,3704,52,55,3495,3484,3374,3382,3328
93216,174,285,57447,35769,5.87035e+18,148.919,3192.92,93216,106,109,92921,92743,68159,63686,76173
43986,194,307,27378,16608,5.8827e+18,174.178,2824.98,43986,163,163,43557,43227,32411,32086,30238
25278,140,214,15506,9772,5.87164e+18,132.507,1520.15,25278,84,86,25037,24910,20473,21697,22555
12670,66,228,7795,4875,5.87082e+18,111.397,1121.56,12670,78,79,12189,11779,4495,5766,5939
57222,8,274,35305,21917,5.87315e+18,187.44,2686.9,57222,133,137,25860,0,4406,5314,2448
86172,7,271,53312,32860,5.87015e+18,221.317,3410.14,86172,125,125,31323,0,3526,5472,2861
43066,121,222,26635,16431,5.86975e+18,113.158,2236.87,43066,87,87,42795,42666,34426,34543,34476
23383,158,162,14372,9011,5.87063e+18,96.6069,1385.78,23383,73,79,23221,23221,22662,23090,23079
80248,197,274,49311,30937,5.87149e+18,174.21,2892.65,80248,124,131,79909,79662,64556,69844,66834
66098,283,315,40830,25268,5.87308e+18,169.839,3102.65,66098,136,134,65783,65733,61632,64031,62631
2101,15,79,1295,806,5.8663e+18,45.05,334.33,2101,46,45,1425,842,436,572,683
30207,3554,4220,19039,11168,5.78333e+18,273.278,6927.71,30207,254,198,25987,25987,22118,22647,7247
13906,22,214,8549,5357,5.87004e+18,94.4873,1163.29,13906,76,79,11258,8955,2012,3348,2572
97153,271,279,60136,37017,5.8712e+18,182.57,3242.76,97153,134,143,96874,96874,96333,96641,96819
96850,337,342,60191,36659,5.88005e+18,216.107,4268.07,96850,184,182,96508,96487,95785,96213,96127
85313,164,306,52549,32764,5.87059e+18,163.645,3174.56,85313,119,126,84858,84583,57613,56284,63189
27213,237,245,16761,10452,5.87042e+18,83.6269,1673.23,27213,85,85,26968,26963,26818,26931,26927
42799,201,257,26501,16298,5.87034e+18,152.98,2361.36,42799,100,100,42516,42401,39601,41108,41541
12188,207,232,7668,4520,5.89694e+18,178.948,1407.78,12188,134,118,11951,11863,10809,11150,11379
29247,124,171,18062,11185,5.86964e+18,102.883,1693.81,29247,81,82,29070,29032,23770,24500,21920
22266,172,274,13777,8489,5.87573e+18,145.843,1783.08,22266,103,106,21950,21800,19806,19816,19329
22839,132,204,14146,8693,5.87017e+18,88.5174,1625.33,22839,83,80,22635,22587,20743,20632,20543
33584,26,262,20661,12923,5.87339e+18,196.778,1984.32,33584,108,117,28174,22395,3977,7691,5158
75731,6,217,46727,29004,5.87011e+18,143.096,2793.23,75731,90,97,25666,0,2320,3835,1710
38374,47,273,23827,14547,5.87508e+18,209.016,2244.55,38374,132,128,35517,33146,7140,11094,7333
38936,119,173,24037,14899,5.87013e+18,99.0425,1893.38,38936,81,87,38748,38645,28869,30239,29225
17466,44,170,10753,6713,5.86927e+18,107.492,1210.44,17466,71,77,16705,15880,3835,6152,3151
64048,184,271,39633,24415,5.8719e+18,202.314,2666.39,64048,129,135,63618,63276,44868,48303,49174
24786,133,237,15331,9455,5.86974e+18,126.462,1783.66,24786,91,90,24490,24265,19982,19379,20778
89810,2,230,55420,34390,5.87007e+18,137.549,3090.98,89810,95,98,8116,0,774,0,454
36578,70,184,22534,14044,5.86989e+18,117.969,1900.3,36578,81,83,36166,35846,16004,16211,16536
14565,208,215,8958,5607,5.87065e+18,97.6656,1196.3,14565,75,80,14350,14350,14319,14324,14326
34528,187,258,21275,13253,5.87154e+18,182.408,1951.62,34528,106,108,34209,34055,27935,30606,29646
73251,6,342,45191,28060,5.87043e+18,148.413,3122.75,73251,118,113,24534,0,2191,4333,2435
69269,372,376,42865,26404,5.87064e+18,159.245,3219.55,69269,116,109,68893,68890,68888,68887,68874
76964,258,288,47465,29499,5.87014e+18,138.533,2928.03,76964,104,106,76676,76674,75117,75800,76009
78156,57,279,48329,29827,5.86981e+18,147.883,3108.46,78156,107,106,75984,72886,27743,31081,33585
25182,347,357,15592,9590,5.87207e+18,138.12,1842.66,25182,95,101,24825,24825,24709,24660,24449
7877,195,248,4900,2977,5.88063e+18,130.986,1071.6,7877,86,81,7629,7561,7181,7133,7142
46673,175,274,28811,17862,5.87373e+18,171.159,2461.24,46673,128,133,46215,45863,33728,31705,32805
56627,5,194,34972,21655,5.87022e+18,128.808,2405.09,56627,85,88,16133,0,271,2046,1858
63047,34,198,38913,24134,5.87021e+18,118.565,2550.6,63047,86,88,56477,45867,11960,18560,17179
5178,29,131,3212,1966,5.86804e+18,70.6161,651.087,5178,60,66,4212,3030,1405,1585,1821
42578,22,180,26217,16361,5.86992e+18,116.284,2026,42578,83,83,33272,24768,6551,7460,7718
71740,179,235,44338,27402,5.87016e+18,140.91,2670.71,71740,103,110,71468,71367,58220,65226,60028
43042,244,269,26529,16513,5.87736e+18,184.347,2378.88,43042,141,137,42773,42751,39165,41158,41845
10462,63,203,6444,4018,5.87085e+18,93.0415,978.052,10462,69,73,10085,9817,3700,4464,4977
49556,198,267,31130,18426,5.8931e+18,217.409,2902.07,49556,185,182,49141,48671,39336,41682,42366
91852,141,285,56627,35225,5.87017e+18,147.093,3166.49,91852,105,112,91494,91232,62112,56768,75459
25860,143,246,16363,9497,5.90312e+18,193.499,2089.71,25860,167,155,24988,23626,15556,15263,18110
93761,102,303,57894,35867,5.87081e+18,161.589,3311.73,93761,117,129,92876,92019,44753,46419,52229
38874,155,260,24060,14814,5.87073e+18,148.686,2035.81,38874,106,107,38515,38338,30087,28952,32222
66130,140,270,40656,25474,5.87127e+18,160.805,2636.09,66130,116,121,65662,65290,36767,30246,32051
85930,168,293,53100,32830,5.87023e+18,176.105,3056.69,85930,112,119,85566,85298,64344,69927,64840
73754,203,300,45569,28185,5.87079e+18,157.123,2957.21,73754,113,122,73409,73220,55171,55831,57902
2837,23,123,1759,1078,5.8645e+18,63.1336,476.919,2837,53,56,2053,1397,465,656,359
92273,193,230,56966,35307,5.87003e+18,127.048,3124.72,92273,94,99,92043,92032,85043,88967,89171
58957,6,290,36955,22002,5.89114e+18,238.325,3261.99,58957,193,194,17326,0,1440,2920,1361
14729,79,170,9091,5638,5.86916e+18,84.8578,1215.82,14729,71,71,14509,14429,8410,8048,8321
41338,147,397,25644,15694,5.87474e+18,189.853,2863.01,41338,141,141,40558,39944,23525,22411,21596
98213,348,426,61076,37137,5.87835e+18,179.378,4669.52,98213,175,179,97787,97723,92283,92903,88027
22248,118,217,13672,8576,5.87147e+18,100.376,1436.09,22248,78,86,22000,21866,16282,15009,17769
46111,166,261,28325,17786,5.87152e+18,166.539,2213.97,46111,113,115,45723,45523,34006,34126,37099
8760,126,222,5474,3286,5.88033e+18,137.183,1084.07,8760,92,89,8391,8014,5394,4986,5108
60622,211,264,37532,23090,5.87099e+18,165.879,2519.45,60622,117,123,60333,60178,50698,55760,51182
83653,174,301,51519,32134,5.87072e+18,154.775,3129.37,83653,120,128,83249,83018,59376,54871,57072
40649,81,194,25120,15529,5.86995e+18,107.639,2079.73,40649,84,86,40351,40221,22472,22283,24362
82598,115,215,50901,31697,5.87005e+18,140.019,2904.09,82598,94,100,82261,81923,55179,53325,61795
82741,214,217,50949,31792,5.87027e+18,129.333,2858.5,82741,96,105,82524,82524,82523,82524,82521
6363,137,208,3928,2435,5.87019e+18,102.147,813.038,6363,66,66,6155,6102,5348,5681,5459
93331,120,276,57552,35779,5.87315e+18,223.453,3393.73,93331,162,163,91793,90012,44664,45156,47246
65153,119,279,40228,24925,5.8704e+18,157.947,2854.33,65153,105,112,64593,64152,35040,31303,37658
62357,125,228,38560,23797,5.87018e+18,152.169,2409.59,62357,99,108,61972,61576,35773,32249,36731
73981,223,274,45647,28334,5.87339e+18,219.971,3037.33,73981,146,157,73628,73350,63722,68528,66076
59984,68,316,37033,22951,5.87371e+18,162.135,2983.82,59984,132,129,58050,56237,21486,24977,24455
72765,184,426,45328,27437,5.88019e+18,189.119,4159.97,72765,166,171,72173,71740,55238,55799,50360
6823,46,193,4202,2621,5.87293e+18,89.1236,830.174,6823,72,68,6278,5878,1564,2369,1582
18795,70,159,11561,7234,5.87006e+18,92.5661,1233.63,18795,73,75,18510,18378,9363,9461,9894
69764,148,273,42930,26834,5.8707e+18,160.051,2701.13,69764,114,127,69308,68980,42192,38486,46836
53138,61,266,32666,20472,5.8726e+18,194.464,2453.11,53138,130,127,51100,49566,11940,18546,14238
51578,174,279,32172,19406,5.88223e+18,204.139,2861.96,51578,167,171,50943,50194,33842,32056,31408
48443,242,272,30097,18346,5.87799e+18,191.265,2596.39,48443,155,149,48168,48138,43072,45984,46503
5417,344,377,3389,2028,5.88785e+18,118.235,1172.17,5417,95,89,5040,5035,4869,4967,4587
61852,14,224,38051,23801,5.86996e+18,153.017,2385.95,61852,103,108,40820,24667,7850,8673,5374
57066,47,274,35393,21673,5.87904e+18,190.177,2908.83,57066,172,162,50869,45181,9976,16429,11210
42786,136,243,26331,16455,5.87016e+18,166.629,2049.92,42786,102,104,42422,42132,25671,24921,26943
18223,74,219,11270,6953,5.87065e+18,88.1496,1309.99,18223,78,80,17863,17659,9860,10930,11311
11668,62,146,7223,4445,5.86922e+18,67.1478,1039.61,11668,68,72,11429,11181,7107,6654,6644
89245,191,274,54834,34411,5.87114e+18,177.447,3044.12,89245,130,136,88862,88583,66899,74413,72059
55407,102,273,34480,20927,5.87711e+18,236.281,2807.88,55407,164,157,53572,51693,23200,22800,20422
34441,127,194,21281,13160,5.86991e+18,105.039,1912.77,34441,82,84,34247,34166,26564,27382,26194
36992,73,179,22719,14273,5.87064e+18,116.628,1757.72,36992,83,89,36492,36196,17133,16977,18580
56337,126,266,34688,21649,5.871e+18,169.172,2448.09,56337,111,122,55771,55209,31341,31458,35345
35936,44,173,22210,13726,5.86984e+18,102.331,1827.26,35936,78,83,34373,32237,7679,12149,11301
20902,22,256,12885,8017,5.87257e+18,129.198,1565.71,20902,93,96,16596,12970,2844,4920,3113
1944,57,62,1210,734,5.87035e+18,55.2881,306.032,1944,45,44,1877,1824,1595,1772,1831
33869,150,258,20792,13077,5.8728e+18,152.052,1912.69,33869,102,104,33516,33339,25963,25526,28179
68695,207,215,42367,26328,5.87004e+18,135.531,2672.75,68695,91,96,68480,68474,68041,68241,68228
63706,134,274,39320,24386,5.87344e+18,220.821,2848.74,63706,140,152,62760,61952,35632,34973,41282
87581,124,281,54506,33075,5.88319e+18,212.017,3753.71,87581,199,192,84901,81206,41382,40362,47161
75200,174,282,46285,28915,5.87443e+18,214.928,3086.12,75200,153,162,74587,74008,50856,44766,48704
15794,64,273,9754,6040,5.87391e+18,89.0743,1449.34,15794,93,87,15158,14529,8920,10264,9817
72734,209,264,44868,27866,5.87017e+18,113.391,2841.63,72734,99,104,72470,72433,62593,68175,62474
57159,154,266,35198,21961,5.87154e+18,187.818,2524.94,57159,128,126,56626,56260,37008,33236,39219
36335,133,173,22408,13927,5.86953e+18,106.052,1800.03,36335,79,85,36159,36084,30174,33324,31099
6069,35,76,3736,2333,5.86923e+18,67.3142,592.007,6069,59,63,5396,4487,2643,2566,3341
88421,26,227,54581,33840,5.86995e+18,140.121,3064.97,88421,93,98,72602,53515,13220,20584,14653
1775,23,74,1104,671,5.87182e+18,53.7746,324.629,1775,49,48,1328,944,456,541,694
13763,25,211,8464,5299,5.87112e+18,95.8592,1129.64,13763,72,79,11703,9312,1958,3435,2756
96276,232,317,59364,36912,5.87287e+18,203.976,3658.13,96276,152,157,95899,95679,78483,84691,73378
37493,902,4576,23621,13872,5.78915e+18,335.105,7950.87,37493,273,219,32789,30860,7918,15002,3362
95054,243,397,58879,36175,5.87222e+18,176.684,3995.1,95054,150,146,94646,94518,83982,82464,79044
50485,51,263,31079,19406,5.87059e+18,172.2,2331.94,50485,112,118,48409,46783,10228,16116,13519
88395,35,376,54629,33766,5.87048e+18,172.533,3536.52,88395,115,110,78276,64434,18318,25708,22287
89780,232,288,55351,34429,5.87011e+18,142.707,3137.38,89780,108,110,89492,89464,79449,84537,81867
66728,108,305,41755,24973,5.89018e+18,222.123,3527.01,66728,190,198,63156,58717,28223,30153,25778
48345,255,314,29873,18472,5.87208e+18,133.581,2606.7,48345,107,104,48031,47982,47213,47319,46857
95368,217,316,58826,36542,5.87281e+18,199.453,3597.59,95368,146,144,94993,94750,81784,84576,83415
8058,29,139,4983,3075,5.86923e+18,87.4721,779.947,8058,59,60,7172,6244,1660,2308,2233
79266,86,285,49349,29917,5.87953e+18,238.948,3512.97,79266,181,185,75474,71396,23538,31630,30345
21043,115,219,12934,8109,5.86979e+18,107.458,1404.15,21043,81,82,20786,20618,15240,14914,17995
72078,186,300,44493,27585,5.87095e+18,150.858,2919.38,72078,110,112,71719,71581,63995,62817,65506
23579,34,258,14602,8977,5.87308e+18,136.258,1642.51,23579,97,95,21057,18019,4271,6864,4927
72232,231,291,45341,26891,5.89314e+18,238.704,3612.8,72232,204,202,71875,71621,60759,63151,65546
53909,117,211,33204,20705,5.87007e+18,123.827,2319.11,53909,89,94,53644,53417,37904,36121,38135
2752,61,96,1694,1058,5.86514e+18,49.673,421.022,2752,46,45,2649,2642,2085,2143,2080
51685,68,211,31792,19893,5.8705e+18,126.871,2261.16,51685,88,95,51008,50477,21124,22414,23780
6252,43,145,3862,2390,5.87069e+18,63.1334,774.84,6252,64,65,5776,5159,2120,2392,2269
37845,56,195,23357,14488,5.86947e+18,99.0628,1943.79,37845,83,86,37049,36020,13949,16912,17298
14299,181,236,8814,5485,5.87409e+18,133.488,1251.3,14299,88,82,14063,14026,12274,13157,12401
21187,22,184,13081,8106,5.86941e+18,86.7669,1525.68,21187,77,79,15646,10999,3503,4473,3966
63337,11,281,39281,24056,5.87936e+18,201.264,3084.77,63337,175,176,34369,21233,5581,8034,2220
29434,118,161,18139,11295,5.86994e+18,81.3637,1654.47,29434,76,78,29273,29232,24161,26116,24301
96488,139,328,59848,36640,5.87609e+18,207.701,3964.13,96488,168,175,95345,94084,59256,53404,69869
39796,193,275,24521,15275,5.87654e+18,187.231,2304.26,39796,133,129,39434,39179,31662,33284,33194
6214,145,189,3833,2381,5.87203e+18,72.8983,795.019,6214,64,64,6025,5990,5096,5487,4702
64917,225,290,40166,24751,5.8709e+18,158.213,2744.64,64917,114,125,64627,64562,52454,58599,48329
66047,85,291,40670,25377,5.87057e+18,155.49,2773.07,66047,116,119,65029,64113,24668,32771,30769
69060,161,271,42745,26315,5.86988e+18,197.045,3034.57,69060,111,117,68597,68087,47546,41047,51924
10651,11,131,6595,4056,5.86931e+18,73.2645,914.151,10651,66,67,5902,3811,987,1154,1134
41408,169,327,25686,15722,5.8769e+18,126.566,2695.12,41408,126,120,41018,40823,36783,36161,34249
27413,224,253,17112,10301,5.88587e+18,202.017,2073.21,27413,153,145,27155,27056,25209,26208,26076
52337,80,274,32371,19966,5.87626e+18,227.941,2707.24,52337,156,155,49992,47809,14608,20966,18354
89099,227,279,54854,34245,5.87131e+18,189.524,3121.34,89099,139,140,88799,88670,74546,82759,80064
50022,116,183,30883,19139,5.87006e+18,115.426,2226.4,50022,82,89,49801,49655,35990,34870,38616
27784,370,381,17224,10560,5.87167e+18,149.11,2270.66,27784,111,110,27403,27398,27393,27393,27077
59973,47,270,37153,22820,5.87016e+18,231.908,2905.1,59973,119,125,55658,50959,12504,16587,15466
66623,128,282,41106,25517,5.87399e+18,222.402,2933.05,66623,148,151,65541,64397,31609,31483,27509
31361,239,307,19592,11769,5.88786e+18,211.453,2406.24,31361,162,161,31049,30971,25093,26572,24124
76132,640,3760,48012,28120,5.86164e+18,230.276,7659.55,76132,271,217,72372,71517,12791,37895,944
27603,84,226,17050,10553,5.86983e+18,108.957,1819.63,27603,86,87,27229,27073,18863,17955,18322
74368,58,216,45848,28520,5.87002e+18,128.024,2724.01,74368,93,100,73104,71537,23161,29294,31331
21451,73,255,13313,8138,5.87173e+18,137.9,1579.95,21451,96,95,20745,20291,8043,10391,9866
52409,166,215,32322,20087,5.87032e+18,118.454,2368.71,52409,88,92,52194,52154,45813,49230,45552
47129,129,202,29164,17965,5.86985e+18,105.345,2237.72,47129,85,85,46917,46842,39500,40550,37870
96424,112,270,59388,37036,5.87019e+18,145.791,3163.71,96424,105,111,95937,95368,53795,51546,59752
96753,251,286,60139,36614,5.88184e+18,249.191,3931.23,96753,199,203,96441,96216,85784,91075,90744
61120,88,264,37844,23276,5.87189e+18,200.166,2590.14,61120,127,130,59896,58697,20507,24391,20536
12700,102,162,7845,4855,5.87003e+18,88.6087,1007.27,12700,69,70,12529,12421,9065,8545,10263
68319,28,285,42065,26254,5.87024e+18,142.907,2778.27,68319,101,107,58170,45340,9398,17724,11547
81000,41,286,50234,30766,5.87909e+18,236.485,3540.59,81000,177,191,70913,60879,13907,22493,15782
95229,170,228,58704,36525,5.87008e+18,141.475,3105.98,95229,99,103,95001,94892,85036,89045,91535
82790,5892,7984,52153,30637,5.78695e+18,451.057,14207.8,82790,507,287,74806,74802,63474,67410,19836
31484,53,174,19397,12087,5.86931e+18,103.544,1736.7,31484,80,80,30715,29386,11144,12275,11809
55839,285,342,34674,21165,5.87911e+18,145.989,3290.62,55839,150,146,55497,55474,52404,52722,51416
82488,116,271,51065,31423,5.87132e+18,191.879,2992.31,82488,134,144,81529,80475,40276,38627,43821
17345,31,183,10715,6630,5.87067e+18,86.5235,1361.19,17345,75,77,14692,11007,3775,4978,4196
91851,110,328,56930,34921,5.87492e+18,199.417,3788.66,91851,159,157,90313,88557,44468,44368,51152
60522,231,276,37351,23171,5.87429e+18,214.267,2794.15,60522,145,145,60209,60047,49909,55573,48836
99253,205,261,61335,37918,5.87002e+18,171.066,3466.82,99253,109,107,98964,98835,95720,97422,98244
20192,42,217,12420,7772,5.87032e+18,91.5145,1365.92,20192,78,83,19150,17854,5587,6524,8288
21683,43,130,13358,8325,5.87028e+18,68.117,1347.27,21683,73,74,20526,18740,8454,9151,7913
54016,50,274,33336,20680,5.87364e+18,202.456,2612.05,54016,141,140,50570,47790,10282,17071,11004
79069,297,342,48870,30199,5.87429e+18,188.508,3606.83,79069,147,141,78727,78679,77182,77429,76546
77434,4,342,47833,29601,5.87018e+18,145.807,3204.81,77434,116,106,17579,0,5,2632,1715
29765,213,287,18352,11413,5.87055e+18,128.497,1942.47,29765,99,101,29478,29386,24450,26640,22613
28222,52,178,17332,10890,5.87042e+18,112.478,1533.46,28222,79,87,27447,26713,8623,10587,11873
16352,103,152,10129,6223,5.8704e+18,67.0627,1238.21,16352,73,75,16200,16185,14072,13892,12529
37620,160,265,23240,14380,5.87458e+18,159.5,2203.4,37620,127,122,37183,36851,25392,23443,21993
32012,3,162,19815,12197,5.86974e+18,111.717,1617.99,32012,81,85,5651,0,263,160,507
75929,170,279,46904,29025,5.87011e+18,156.413,3082.17,75929,107,109,75557,75301,62424,60321,66098
51593,196,233,31664,19929,5.87116e+18,154.04,2197,51593,104,110,51342,51254,43635,48104,46726
64894,31,426,40560,24334,5.88513e+18,196.576,4015.42,64894,185,187,48500,33687,9948,14210,6845
69664,115,197,42991,26673,5.86973e+18,125.704,2717.35,69664,87,90,69400,69217,46128,43802,54275
45335,164,197,27992,17343,5.86965e+18,122.293,2108.11,45335,82,86,45138,45059,43377,44431,44948
87135,187,257,53859,33276,5.87003e+18,183.783,3269.02,87135,110,108,86806,86553,69322,66424,77466
8700,22,131,5387,3313,5.86995e+18,69.1816,827.975,8700,57,62,6910,5235,1609,2436,1723
23715,94,165,14673,9042,5.87029e+18,111.863,1415.43,23715,73,84,23472,23301,14346,13200,13084
75692,82,217,46688,29004,5.87012e+18,133.549,2802.22,75692,91,97,75141,74854,35202,35738,38191
47043,169,307,29168,17875,5.8803e+18,217.041,2824.43,47043,158,155,46495,46016,31236,30876,32298
74948,6,211,46331,28617,5.87023e+18,120.499,2823.67,74948,89,91,24758,0,2110,3446,2561
90363,68,285,55723,34640,5.87014e+18,150.663,3153.18,90363,101,108,89182,88080,27935,36190,37359
63619,194,278,39492,24127,5.88062e+18,213.885,3102.19,63619,180,177,63106,62500,46762,50461,50447
98502,176,294,61601,36901,5.88871e+18,240.833,4140.73,98502,212,210,97370,95486,62685,61505,67769
64056,200,286,40329,23727,5.89578e+18,219.254,3396.72,64056,200,193,63589,63066,49464,51295,53591
88918,60,254,54949,33969,5.87014e+18,153.227,3298.23,88918,107,109,86993,84302,27605,31878,31457
55398,177,300,34161,21237,5.87114e+18,136.571,2615.53,55398,105,107,55043,54910,46345,44981,46274
14690,36,125,9052,5638,5.87052e+18,61.6127,1091.24,14690,70,68,13438,11841,4592,5638,4716
45298,257,296,27929,17369,5.87137e+18,136.034,2376.69,45298,101,103,45002,44936,41094,43378,42472
8596,2,77,5292,3304,5.86919e+18,62.0033,681.132,8596,60,63,787,0,108,0,68
33128,175,262,20553,12575,5.8795e+18,201.355,2187.44,33128,147,144,32653,32141,23505,24399,23701
14988,8,137,9290,5698,5.86897e+18,68.6129,1087.47,14988,72,73,6273,0,748,1200,1477
35045,97,258,21526,13519,5.87259e+18,175.35,1962.4,35045,104,107,34364,33791,16382,16103,16808
61816,25,198,38149,23667,5.87044e+18,128.513,2522.4,61816,87,89,49955,36107,9834,10495,10175
34568,147,285,21540,13028,5.882e+18,188.292,2388.87,34568,146,142,33891,33239,21782,22106,22858
98282,252,281,60896,37386,5.87267e+18,206.134,3436.69,98282,156,163,97987,97892,83668,92001,91299
76542,220,286,47467,29075,5.87929e+18,238.993,3451.51,76542,177,187,76115,75705,62128,66075,58833
56727,6,211,35043,21684,5.87009e+18,115.725,2475.66,56727,86,87,18734,0,1503,3034,2462
77188,186,397,47764,29424,5.87076e+18,189.818,3454.61,77188,118,113,76742,76550,70570,72200,73869
73548,88,213,45299,28249,5.87016e+18,131.409,2696.49,73548,96,101,72988,72528,36595,35550,42548
56836,219,258,35066,21770,5.8704e+18,139.087,2465.49,56836,95,98,56578,56509,53478,55343,55825
8306,104,397,5175,3131,5.8839e+18,138.221,1471.61,8306,104,94,7661,7158,3430,3652,2735
10837,132,201,6668,4169,5.86969e+18,86.7482,1036.72,10837,70,72,10636,10559,9672,9958,9908
35672,256,274,22016,13656,5.87372e+18,208.806,2137.1,35672,121,122,35398,35346,35350,35375,35308
9368,64,254,5831,3537,5.88591e+18,135.567,1253.72,9368,99,98,8369,7535,4050,4755,3964
68498,154,214,42237,26261,5.87037e+18,132.394,2616.86,68498,92,99,68277,68162,59124,59909,62368
88208,331,397,54623,33585,5.87275e+18,189.266,3905.59,88208,150,158,87811,87707,79881,83833,76353
80947,31,215,49872,31075,5.87012e+18,139.833,2868.19,80947,95,100,71060,57522,13635,20221,17974
57631,129,392,35673,21958,5.88151e+18,209.587,3179.22,57631,175,167,56067,54214,21174,22116,5190
90022,27,286,55993,34029,5.88272e+18,248.371,3823.59,90022,200,200,68679,49789,11097,19184,9184
68744,208,281,42614,26130,5.87915e+18,198.078,3217.68,68744,171,172,68330,67859,54688,59262,55828
27850,227,260,17364,10486,5.88137e+18,202.645,2015.8,27850,142,133,27583,27462,24777,26163,26391
77012,20,196,47550,29462,5.87002e+18,123.433,2824.32,77012,88,92,56831,40988,10392,12549,10895
22654,101,246,14070,8584,5.87514e+18,179.215,1686.07,22654,119,111,21848,21104,10080,10027,10102
15823,27,242,9848,5975,5.88283e+18,150.636,1512.94,15823,119,108,12087,8979,1926,3664,2497
11261,14,74,7016,4245,5.86989e+18,64.0076,781.25,11261,63,65,6966,4155,1505,1926,2636
93984,283,300,57877,36107,5.87087e+18,189.248,3296.9,93984,122,128,93684,93629,91100,92294,92316
64363,196,215,39672,24691,5.87022e+18,129.893,2592.6,64363,88,93,64148,64138,63134,63622,63639
36947,191,273,22936,14011,5.8753e+18,175.91,2240.21,36947,131,133,36578,36348,29396,30927,28828
57429,188,323,35662,21767,5.87976e+18,174.399,3225.6,57429,159,169,56927,56530,43541,42741,38436
44357,55,191,27272,17085,5.87005e+18,95.1295,2077.53,44357,83,88,43441,42110,15834,18893,18995
27989,290,296,17362,10627,5.87695e+18,144.48,2116.79,27989,118,119,27693,27691,27557,27655,27574
14717,132,179,9090,5627,5.86861e+18,86.4918,1106.01,14717,74,71,14538,14535,12266,13173,13431
78293,187,271,48436,29857,5.86986e+18,192.985,3217.14,78293,114,119,77910,77584,61521,59715,70292
90601,132,290,56703,33898,5.88951e+18,239.686,3982.92,90601,212,209,87570,83391,40480,39740,46390
91899,313,316,56677,35222,5.87315e+18,204.129,3578.75,91899,151,155,91583,91583,91556,91557,91583
38902,217,279,24023,14879,5.87013e+18,121.701,2194.03,38902,90,99,38623,38509,32436,34997,34593
3853,80,115,2364,1489,5.86584e+18,60.1687,538.998,3853,49,50,3738,3709,2992,2926,2813
21915,99,162,13479,8436,5.86893e+18,103.484,1348.34,21915,75,79,21705,21562,15937,15744,16863
13454,103,208,8280,5174,5.87065e+18,96.3869,1095.67,13454,73,77,13207,13050,8781,8606,10714
54480,221,270,33760,20720,5.87022e+18,211.544,2732.41,54480,114,118,54170,53998,46713,50759,50977
52333,100,285,32915,19418,5.89498e+18,219.378,3066.42,52333,195,183,48367,43549,19796,19203,21584
4389,72,146,2703,1686,5.86711e+18,70.3008,589.815,4389,53,53,4227,4151,2677,2689,2564
77749,66,277,48359,29390,5.88278e+18,216.122,3516.97,77749,195,190,70795,63985,16111,26756,19275
90707,207,226,56062,34645,5.86998e+18,154.609,3158.44,90707,93,99,90481,90465,89769,90226,90049
92395,124,234,57054,35341,5.87016e+18,154.152,3211.87,92395,98,98,92043,91773,64686,60708,73844
94934,154,352,58508,36426,5.87044e+18,171.953,3523.24,94934,120,118,94410,93990,59072,57354,67162
9408,301,401,5913,3495,5.89801e+18,141.081,1579.37,9408,118,117,9007,9001,7523,7596,5971
30007,7,273,18791,11216,5.88615e+18,194.247,2276.12,30007,156,155,10562,0,1187,1996,1115
47797,390,426,29979,17818,5.889e+18,196.478,3516.5,47797,175,181,47371,47334,46022,46638,42043
77046,216,220,47506,29540,5.87025e+18,121.218,2861.26,77046,90,97,76826,76825,76824,76826,76813
29984,79,179,18427,11557,5.87016e+18,116.053,1584.53,29984,81,88,29577,29281,15368,15492,19601
40389,106,183,24859,15530,5.86962e+18,121.572,1856.69,40389,84,91,40116,39845,27000,24926,31731
40548,247,262,25384,15164,5.89132e+18,216.326,2595.57,40548,174,172,40283,40191,38649,39476,39692
97340,116,303,60146,37194,5.87068e+18,160.327,3362.84,97340,118,128,96615,95868,51345,53975,55766
12362,46,152,7655,4707,5.86911e+18,89.9539,1006.22,12362,64,65,11870,11446,4477,5144,4367
63100,165,226,38925,24175,5.86994e+18,136.064,2497.59,63100,94,97,62874,62777,56971,59402,57790
61412,282,286,38101,23311,5.87965e+18,233.101,3088.37,61412,177,169,61126,61106,61012,61073,60887
38826,116,274,23988,14838,5.87466e+18,169.129,2278.89,38826,124,131,37940,37047,23018,23704,24063
23311,92,250,14359,8952,5.87142e+18,141.982,1588.51,23311,95,100,22726,22179,10867,11770,11948
63803,189,202,39355,24448,5.86993e+18,120.404,2534.74,63803,86,93,63601,63581,61090,62871,62841
77087,242,264,47537,29550,5.87033e+18,134.495,2861.21,77087,100,105,76823,76803,73777,73811,75866
49265,27,285,30607,18658,5.87551e+18,227.443,2597.94,49265,145,145,40551,32012,5903,11980,5647
60272,63,381,37291,22981,5.87097e+18,157.003,3079.44,60272,124,118,58381,56524,20160,22877,22126
71507,103,289,44035,27472,5.87036e+18,134.431,2838.35,71507,101,106,71015,70592,36780,36985,39365
54253,78,217,33400,20853,5.87015e+18,132,2385.31,54253,87,93,53720,53444,23320,24295,27478
87814,136,273,54446,33368,5.87414e+18,232.505,3330.67,87814,168,164,86533,85295,45246,40958,46970
78514,250,303,48431,30083,5.87076e+18,166.085,3077.67,78514,115,121,78211,78114,72507,75705,73142
24392,9,183,15113,9279,5.87006e+18,85.5826,1647.87,24392,79,80,10874,0,1703,2010,1324
80209,250,277,50046,30163,5.8832e+18,216.973,3575.42,80209,198,190,79921,79815,73327,77159,77442
96422,33,316,59452,36970,5.87303e+18,204.053,3642.97,96422,152,156,84843,70173,12836,24764,16088
52528,45,279,32484,20044,5.86996e+18,150.663,2616.7,52528,106,105,49344,45650,12409,16504,13833
38063,79,180,23460,14603,5.87031e+18,119.957,1939.43,38063,82,83,37720,37558,19091,17918,21318
25866,47,271,16114,9752,5.87769e+18,160.121,1938.49,25866,119,121,23414,21219,7158,9155,6417
51723,133,260,31886,19837,5.86974e+18,124.199,2335.23,51723,96,97,51434,51246,28574,26014,28498
52104,137,220,32235,19869,5.87064e+18,153.376,2182.4,52104,101,111,51772,51466,35170,31707,40844
33922,102,173,20947,12975,5.87011e+18,103.813,1767.77,33922,79,86,33688,33527,21132,19135,21343
14700,124,213,9100,5600,5.87012e+18,118.456,1351.19,14700,79,84,14443,14312,11509,11362,11742
77346,161,256,47798,29548,5.87049e+18,139.278,2843.65,77346,104,112,77032,76846,54186,60214,57426
60052,199,211,37095,22957,5.87031e+18,113.512,2545.21,60052,86,87,59841,59841,59713,59681,59716
32286,136,163,19854,12432,5.87068e+18,113.305,1650.74,32286,78,84,32123,32051,27797,30142,28947
28553,230,253,17540,11013,5.87277e+18,169.236,1776.82,28553,100,103,28300,28245,27324,27890,27728
94622,13,320,58204,36418,5.87162e+18,233.069,3444.81,94622,130,139,58273,34246,9547,11266,6176
18600,83,151,11460,7140,5.8705e+18,83.4177,1283.08,18600,69,71,18406,18347,10824,9608,10076
4459,207,214,2805,1654,5.88564e+18,118.208,814.518,4459,82,73,4245,4245,4242,4245,4245
16634,67,147,10246,6388,5.86926e+18,85.2573,1220.08,16634,68,74,16399,16287,8470,8098,8874
62259,223,226,38508,23751,5.87049e+18,153.844,2396.15,62259,102,112,62033,62033,61510,61847,62033
91842,216,285,56622,35220,5.87014e+18,153.805,3173.76,91842,105,109,91557,91475,79112,86373,84793
24327,99,186,15021,9306,5.86946e+18,91.0745,1539.46,24327,80,81,24112,24000,17935,17481,17772
9369,232,271,5837,3532,5.87523e+18,71.5583,1220.05,9369,81,78,9098,9095,8858,8852,8714
54656,4,260,34181,20475,5.88866e+18,231.785,3005.22,54656,184,183,11197,0,5,1151,630
63441,136,274,39155,24286,5.87369e+18,224.33,2847.2,63441,141,152,62521,61797,35894,34046,41934
83323,101,316,51282,32041,5.87246e+18,200.478,3324.27,83323,133,133,82226,81167,39480,37115,37838
74193,145,257,45872,28321,5.87026e+18,144.433,3033.28,74193,106,104,73774,73357,55704,51390,58704
35087,19,170,21670,13417,5.86957e+18,96.9852,1824.42,35087,77,80,25240,16503,5105,7400,5885
75850,40,313,46934,28916,5.87328e+18,196.601,3302.33,75850,144,152,69251,61826,13592,22390,16786
24729,248,251,15308,9421,5.87082e+18,102.024,1640.62,24729,83,81,24478,24478,24476,24478,24478
76429,163,214,47066,29363,5.87014e+18,132.279,2743.21,76429,97,101,76215,76119,69321,72385,72426
22275,100,130,13785,8490,5.86979e+18,67.4299,1366.28,22275,71,74,22145,22145,18441,19499,17912
54692,73,257,33815,20877,5.87035e+18,146.741,2521.73,54692,90,95,54010,53504,15147,18299,19649
68909,102,328,42741,26168,5.87627e+18,159.751,3401.28,68909,146,152,67340,65639,37957,36253,40746
6467,45,147,3996,2471,5.86798e+18,73.1019,761.925,6467,60,66,6053,5680,2434,2624,3113
70230,27,234,43401,26829,5.87056e+18,130.001,2614.06,70230,103,108,59884,46927,9437,17403,11772
66596,261,273,41304,25292,5.87391e+18,207.893,2904.9,66596,148,153,66320,66276,61735,64496,64577
89048,233,286,55418,33630,5.88311e+18,245.383,3823.42,89048,200,197,88683,88311,76031,81793,81100
74696,88,241,46041,28655,5.87015e+18,138.144,2772.6,74696,103,111,73994,73349,31466,32186,23943
87056,109,291,54772,32284,5.89557e+18,230.697,3966.2,87056,208,205,81510,74231,34087,32613,38595
14614,53,173,9011,5603,5.87027e+18,83.7471,1195.8,14614,70,70,14243,13813,4300,5722,4686
69824,255,278,43148,26676,5.87944e+18,237.309,3188.45,69824,183,178,69536,69429,65414,67465,67424
91178,224,397,56495,34683,5.87221e+18,176.554,3932.37,91178,147,145,90746,90561,80192,78825,75963
83029,84,302,51200,31829,5.87048e+18,165.719,3144.9,83029,115,122,81879,80888,30365,35675,38054
69553,250,268,42918,26635,5.8701e+18,142.695,2700.93,69553,103,102,69285,69276,68409,68466,68988
44093,183,295,27653,16440,5.89303e+18,224.357,2881.16,44093,174,182,43534,42889,28714,28495,25764
20735,189,282,12998,7737,5.89177e+18,174.505,1978.61,20735,145,138,20421,20252,15734,15727,14710
13839,56,86,8525,5314,5.86987e+18,72.4048,926.704,13839,70,74,13500,12862,9359,9032,10889
45364,84,262,28196,17168,5.88204e+18,205.891,2624.19,45364,164,159,42505,39446,14698,17715,15831
63383,139,198,39127,24256,5.87015e+18,117.156,2561.93,63383,84,89,63177,63049,52705,54404,58738
65900,134,273,40890,25010,5.87412e+18,231.349,2902.64,65900,152,154,64910,63982,34856,32800,33931
42661,88,285,26579,16082,5.87991e+18,187.643,2597.96,42661,153,146,40667,38373,15756,17670,20523
21168,206,217,13006,8162,5.87081e+18,153.704,1424.11,21168,78,90,20951,20913,20774,20791,20892
29124,54,272,18395,10729,5.90157e+18,202.182,2254.48,29124,171,161,22084,16335,4942,6645,7533
9468,35,118,5858,3610,5.86791e+18,57.9066,859.474,9468,63,64,8607,7389,3246,3760,4034
89588,206,231,55235,34353,5.87002e+18,141.935,3020.34,89588,98,103,89357,89356,86801,88237,88860
15454,62,327,9560,5894,5.8709e+18,122.743,1613.85,15454,91,88,14644,14011,5813,6236,6314
20148,51,183,12448,7700,5.86985e+18,84.9831,1470.53,20148,78,78,19340,17981,8275,8420,7516
66637,114,272,41178,25459,5.87549e+18,225.942,3006.71,66637,161,166,64971,63089,30658,31097,32273
1036,65,75,635,401,5.87556e+18,36.1004,230.247,1036,30,34,961,951,908,940,918
91224,15,288,56218,35006,5.87011e+18,150.032,3160.85,91224,107,109,60398,35775,10389,12259,8422
30712,49,246,18878,11834,5.87075e+18,124.037,1801.68,30712,91,94,29497,28459,7761,10771,9480
30496,156,171,18849,11647,5.8698e+18,97.2875,1723.44,30496,81,82,30325,30292,30038,30226,30245
55184,6,272,34074,21110,5.87504e+18,220.104,2697.26,55184,149,154,19507,0,2341,3360,1633
90136,257,285,55559,34577,5.87021e+18,143.423,3138.72,90136,107,111,89851,89844,87216,88149,89309
94232,102,295,58143,36089,5.87026e+18,167.489,3182.18,94232,115,119,93521,92813,42655,44097,50907
18622,61,177,11524,7098,5.86992e+18,83.0335,1374.87,18622,73,76,18299,18061,7059,7798,8029
54839,211,226,33928,20911,5.87079e+18,155.364,2252.14,54839,102,108,54607,54538,51382,53469,53469
39871,52,275,24572,15299,5.87622e+18,173.069,2306.97,39871,131,132,37211,35425,9873,13659,11184
72610,143,302,44746,27864,5.8707e+18,156.77,2963.58,72610,111,120,72092,71804,47963,48836,53186
96800,17,322,59706,37094,5.8707e+18,199.887,3464.82,96800,128,131,68615,45291,12300,16371,7750
58171,14,279,35983,22188,5.87008e+18,147.307,2727.15,58171,106,107,35388,20823,6356,7851,4094
4475,40,171,2762,1713,5.87437e+18,65.7743,644.707,4475,58,57,4097,3734,1830,2229,2455
46463,192,397,28817,17646,5.87441e+18,184.842,3037.98,46463,143,142,45953,45640,33060,32577,31615
81858,70,275,50888,30970,5.87658e+18,226.912,3346.21,81858,181,170,77582,73767,17560,29001,24308
56242,300,327,34904,21338,5.87644e+18,147.664,3120.6,56242,139,140,55915,55892,54884,55389,54202
23946,95,203,14782,9164,5.86927e+18,90.0113,1530.95,23946,77,83,23734,23692,13432,11438,3511
97116,272,308,60569,36547,5.88609e+18,228.832,4129.01,97116,204,206,96808,96779,86093,92040,89666
5929,37,112,3653,2276,5.86798e+18,54.8828,671.474,5929,57,57,5447,4919,1829,2282,1911
88955,104,381,55010,33945,5.87094e+18,170.09,3602.84,88955,132,133,87854,86927,39901,43616,44231
51437,202,266,31614,19823,5.8719e+18,163.643,2343.58,51437,113,117,51137,50957,43167,47073,42452
69289,37,323,42956,26333,5.87883e+18,191.469,3465.62,69289,171,178,59166,50048,11493,18857,9223
74098,72,411,45987,28111,5.87763e+18,178.871,3983.87,74098,169,168,70276,66374,29998,33691,29852
38945,37,173,24067,14878,5.87051e+18,91.7461,1931.59,38945,79,80,35555,31415,12006,13899,13890
93342,96,294,57635,35707,5.87022e+18,172.763,3179.79,93342,117,121,92508,91740,38194,40204,41838
45227,93,264,27984,17243,5.87284e+18,199.759,2273.08,45227,120,123,44217,43267,17137,18479,17410
83446,66,271,51620,31826,5.87017e+18,200.104,3321.29,83446,116,120,81565,79557,25113,29530,32384
39551,205,342,24385,15166,5.87042e+18,139.327,2396.97,39551,108,106,39188,39079,31829,29626,34111
71660,72,426,44986,26674,5.89084e+18,240.707,4038.88,71660,201,208,63367,54512,13625,21812,9547
32437,48,262,20338,12099,5.89295e+18,217.845,2354.22,32437,169,163,26268,20239,5549,8466,7572
2046,71,73,1260,786,5.86712e+18,55.2297,334.33,2046,44,48,1973,1973,1935,1959,1973
23171,109,219,14346,8825,5.87023e+18,114.268,1472.1,23171,78,87,22896,22738,13912,13372,13903
76686,193,285,47791,28895,5.88026e+18,247.052,3462.28,76686,187,189,76064,75382,51872,53783,50973
36912,132,178,22781,14131,5.86995e+18,110.681,1897.76,36912,80,83,36729,36655,32729,34055,33729
96491,235,411,59641,36850,5.87949e+18,243.904,4151.49,96491,196,198,95972,95681,60570,51821,32064
54718,138,312,33879,20839,5.8739e+18,154.922,2801.62,54718,132,134,54005,53437,34343,33526,29852
94318,298,397,58419,35899,5.87198e+18,170.222,3981.67,94318,150,147,93921,93814,86389,89257,81226
6314,74,119,3887,2427,5.86884e+18,70.179,677.132,6314,56,59,6168,6125,4288,4147,4510
56871,170,264,34961,21910,5.87128e+18,162.983,2456.5,56871,114,119,56519,56265,39362,35592,34689
70893,207,215,43761,27132,5.87009e+18,122.538,2725.83,70893,91,95,70678,70672,69737,70234,70313
9185,83,128,5649,3536,5.87067e+18,76.3179,854.073,9185,63,61,9047,9014,6901,6887,6915
96387,200,246,59423,36964,5.86996e+18,142.34,3136.08,96387,101,106,96141,96136,88793,92711,94270
57780,182,300,35694,22086,5.87117e+18,158.374,2654.37,57780,111,119,57402,57203,43586,40225,42012
84896,142,273,52543,32353,5.8709e+18,171.084,2956.73,84896,125,133,84329,83871,49218,45491,56457
3519,48,80,2181,1338,5.86567e+18,68.5592,465.613,3519,57,59,3280,3005,2025,1918,2404
73221,16,293,45246,27975,5.87027e+18,162.629,2821.36,73221,104,109,50835,34179,8406,11574,7709
21125,113,167,13003,8122,5.87072e+18,94.5482,1329.34,21125,74,77,20958,20892,18756,19227,19086
73339,235,260,45188,28151,5.87009e+18,147.269,2716.79,73339,111,114,73079,73079,69325,70994,70504
43744,157,189,27055,16689,5.86944e+18,108.974,2070.33,43744,83,82,43555,43519,41972,42881,42966
83264,155,215,51389,31875,5.87029e+18,128.332,2975.17,83264,90,92,83049,82918,70788,75334,78271
79093,325,327,49039,30054,5.87497e+18,200.519,3579.8,79093,156,151,78766,78753,78760,78761,78656
76042,104,324,47107,28935,5.87781e+18,192.244,3586.66,76042,175,178,73695,71207,34851,39943,30912
98060,204,302,60495,37565,5.8705e+18,173.938,3385.85,98060,122,129,97700,97466,82552,83384,86345
27928,40,177,17267,10661,5.87048e+18,82.205,1685.51,27928,77,80,26078,23484,6619,9269,8369
40060,239,263,24922,15138,5.88291e+18,201.96,2465.93,40060,164,158,39793,39742,37043,38566,38963
11596,136,173,7159,4437,5.86997e+18,87.6302,978.632,11596,68,69,11423,11417,10097,10731,10882
37676,15,245,23286,14390,5.87073e+18,120.067,2022.54,37676,84,89,24578,14519,4546,4411,4580
44958,100,259,27713,17245,5.87037e+18,119.08,2208.96,44958,90,90,44594,44356,26841,26188,29161
64229,24,306,39798,24431,5.87397e+18,190.109,3039.83,64229,140,149,50972,38075,9155,15776,9742
14351,20,246,8925,5426,5.87229e+18,117.972,1318.28,14351,89,89,10816,8137,2069,3463,3056
88248,288,309,54646,33602,5.87311e+18,197.605,3459.44,88248,152,159,87939,87920,80646,84917,84006
92441,290,335,57827,34614,5.8866e+18,208.932,4230.39,92441,197,206,92106,92051,80111,84353,81273
45081,90,274,27852,17229,5.87488e+18,217.52,2460.14,45081,144,138,43520,41948,17300,19252,22060
38957,184,195,24084,14873,5.87011e+18,108.955,2003.83,38957,81,85,38762,38757,38163,38446,38760
51551,139,284,32151,19400,5.88208e+18,204.082,2884.85,51551,164,171,50377,49118,29028,28167,27233
24003,108,169,14803,9200,5.87028e+18,95.9451,1486.6,24003,76,75,23829,23768,19572,20617,17464
73773,137,286,45837,27936,5.88163e+18,236.333,3422.35,73773,193,180,72091,70307,38089,36036,39882
29267,182,246,18486,10781,5.90182e+18,196.452,2219.79,29267,165,165,28889,28426,23331,23991,25698
97784,35,294,60376,37408,5.87034e+18,185.736,3257.12,97784,121,124,89336,78700,14278,25293,13647
73208,38,301,45102,28106,5.87125e+18,161.796,2941.69,73208,115,116,67866,62281,13436,21748,19240
62118,342,381,38437,23681,5.87125e+18,176.52,2983.31,62118,125,133,61737,61679,52468,58001,55122
14022,1,134,8696,5326,5.86952e+18,75.2068,1040.63,14022,69,71,0,0,0,0,0
7402,121,149,4601,2801,5.86871e+18,59.0773,806.396,7402,60,62,7253,7252,6328,6840,5724
20661,34,174,12705,7956,5.86953e+18,108.397,1320.95,20661,73,80,18852,16283,3920,6309,5348
81683,234,411,50631,31052,5.87511e+18,173.729,4030.37,81683,157,151,81272,81159,74342,73434,69521
6387,91,118,3919,2468,5.86938e+18,55.9762,702.206,6387,59,58,6269,6269,5360,5728,5010
5260,2,112,3250,2010,5.8682e+18,51.2376,613.905,5260,52,54,497,0,44,0,20
18673,19,130,11515,7158,5.86896e+18,69.5694,1228.05,18673,72,74,13180,8501,2910,3186,2356
56563,57,274,34975,21588,5.87606e+18,223.793,2788.86,56563,156,158,52790,49906,12242,19605,12888
71336,245,257,44125,27211,5.87002e+18,147.599,2970.37,71336,106,105,71079,71010,70855,70778,69070
20971,200,286,12920,8051,5.87218e+18,89.5451,1586.81,20971,88,85,20685,20638,19796,19951,19461
21308,81,156,13133,8175,5.8706e+18,98.9938,1372.19,21308,76,77,21114,21074,13688,12418,10533
75637,55,342,47087,28550,5.88263e+18,170.886,3889.67,75637,171,181,68061,61238,17380,23832,19222
98407,102,352,60658,37749,5.87021e+18,171.783,3507.9,98407,117,122,97507,96725,33952,37430,40879
44660,179,188,27455,17205,5.87025e+18,112.558,2014.93,44660,83,91,44472,44472,44220,44393,44309
47139,62,257,29158,17981,5.87036e+18,147.124,2339.86,47139,89,92,46219,45358,10594,15599,15387
98005,23,426,61303,36702,5.88627e+18,235.046,4641.44,98005,205,216,67422,44774,10270,18784,4418
37459,228,258,23186,14273,5.87236e+18,186.683,2031.11,37459,109,113,37194,37103,33739,35752,35487
62855,232,235,38710,24145,5.87012e+18,129.064,2451.01,62855,99,103,62620,62620,62533,62545,62620
90363,234,328,55993,34370,5.87691e+18,194.638,3886.46,90363,169,179,89992,89786,74364,77602,70915
80348,137,411,49747,30601,5.88092e+18,253.562,3903.64,80348,188,195,78493,76645,31806,31660,21353
54661,5,285,34039,20622,5.88039e+18,230.937,2936.15,54661,166,166,15485,0,248,2735,737
8108,35,227,5099,3009,5.9032e+18,162.611,1162.11,8108,113,100,5596,3526,1093,1596,1314
64336,3,210,39773,24563,5.86981e+18,112.669,2634.56,64336,88,89,10932,0,474,538,927
53245,105,312,33087,20158,5.88116e+18,179.297,3063.29,53245,164,166,51206,49077,28708,29935,23185
39663,279,285,24710,14953,5.88073e+18,216.301,2533.73,39663,152,145,39378,39363,39215,39296,39240
72615,132,381,44942,27673,5.87111e+18,168.325,3244.21,72615,129,134,71870,71180,37294,35831,38994
44571,99,184,27441,17130,5.87007e+18,119.134,2099.49,44571,82,86,44305,44142,28469,25758,29599
68474,215,271,42783,25691,5.88806e+18,227.699,3367.72,68474,199,192,68094,67630,57273,61233,61505
62299,89,272,38431,23868,5.87358e+18,223.652,2826.56,62299,145,153,60541,58768,21526,27140,29539
84428,260,328,52306,32122,5.87724e+18,188.435,3776.76,84428,167,176,84092,83995,72821,76716,70007
98423,12,285,60642,37781,5.87003e+18,141.196,3269.91,98423,105,110,57396,35330,10341,10756,7250
93740,87,257,57972,35768,5.87022e+18,172.731,3378.94,93740,111,111,92810,92314,40975,37539,40504
95459,208,232,58891,36568,5.87017e+18,147.44,3211.26,95459,95,100,95227,95206,92018,92688,94096
84025,140,215,51755,32270,5.86987e+18,130.756,2881.44,84025,97,103,83786,83598,64804,64783,74532
81082,182,300,49934,31148,5.8711e+18,194.707,3100.61,81082,116,124,80697,80486,64599,69046,71699
9647,65,144,5932,3715,5.87072e+18,85.7749,857.424,9647,65,64,9404,9246,5088,5242,6069
27706,135,253,17083,10623,5.87274e+18,164.332,1798.7,27706,113,109,27235,26843,15498,14479,14679
42847,23,224,26500,16347,5.86989e+18,131.242,1982.46,42847,89,100,35064,26861,5740,9842,7886
73481,47,309,45555,27926,5.87363e+18,221.63,3099.63,73481,152,154,68584,64577,12563,20608,9249
82009,188,262,50565,31444,5.87019e+18,144.609,2930.56,82009,103,110,81747,81628,72567,77095,77761
75794,87,270,47208,28586,5.88393e+18,225.123,3478.38,75794,193,192,70806,65009,23952,28550,28276
64928,52,264,40186,24742,5.87127e+18,183.194,2610.82,64928,124,126,62439,60590,13805,21422,16267
49870,145,264,30949,18921,5.87976e+18,199.195,2700.4,49870,163,160,48926,47952,29933,27266,29328
68631,33,335,42993,25638,5.88872e+18,206.209,3688.5,68631,186,197,51423,35303,9564,15093,6817
45504,166,223,27949,17555,5.87087e+18,131.946,2031.59,45504,93,100,45281,45182,38130,41264,41732
44199,209,262,27203,16996,5.87394e+18,211.419,2310.48,44199,133,125,43881,43622,37027,40788,39184
52913,210,227,32507,20406,5.871e+18,153.103,2212.66,52913,102,109,52679,52611,47880,50524,50991
7246,49,137,4468,2778,5.86956e+18,80.1518,733.443,7246,58,60,6966,6839,3053,3231,3733
94707,181,331,58719,35988,5.8747e+18,244.046,3808.75,94707,166,150,94164,93723,61642,61186,58164
83474,126,302,51445,32029,5.87078e+18,158.746,3146.76,83474,116,123,82842,82265,51370,53944,54517
26800,185,255,16580,10220,5.87638e+18,179.86,1880.81,26800,127,122,26486,26274,20724,23054,21085
25075,87,150,15424,9651,5.87018e+18,80.9998,1500.78,25075,74,76,24890,24824,15458,14401,15519
72867,147,266,44755,28112,5.87145e+18,190.064,2766.92,72867,127,133,72313,71849,44619,38864,43953
78797,15,276,49260,29537,5.88882e+18,221.695,3637.84,78797,198,196,45072,23057,6170,11318,4550
65414,128,274,40367,25047,5.87376e+18,226.412,2886.06,65414,142,155,64360,63309,34363,33839,40631
11441,95,188,7067,4374,5.86969e+18,80.5244,1147.5,11441,78,78,11242,11195,8865,8320,7898
91835,204,294,56601,35234,5.87034e+18,179.058,3146.81,91835,116,124,91521,91326,75583,83053,82585
51404,136,195,31695,19709,5.87019e+18,113.919,2303.27,51404,83,84,51209,51090,43440,43416,45591
94805,100,224,58498,36307,5.87029e+18,141.404,3184.16,94805,94,98,94367,94070,53629,49510,61777
24265,94,179,14956,9309,5.8702e+18,79.3439,1471.13,24265,79,79,24062,23950,20372,20080,19812
68239,177,231,42170,26069,5.8702e+18,160.654,2765.03,68239,95,94,68008,67926,61767,65158,65580
14689,50,165,9071,5618,5.86987e+18,82.3487,1200.8,14689,74,75,14110,13407,5346,5993,7631
74482,2,270,46130,28352,5.87013e+18,221.528,3219.55,74482,127,134,6578,0,661,0,640
45305,375,426,28345,16960,5.88643e+18,189.601,3447.46,45305,164,169,44879,44834,41867,42562,39438
68757,179,273,42720,26037,5.87583e+18,227.494,3048.61,68757,165,163,68136,67468,45781,45675,46240
18986,193,215,11714,7272,5.87001e+18,71.9098,1342.68,18986,78,79,18771,18767,18633,18698,18613
26477,16,397,16439,10038,5.87488e+18,158.548,2400.07,26477,124,118,16677,10299,2844,4523,1656
35308,140,226,21835,13473,5.86995e+18,126.222,1807.35,35308,86,93,35069,34919,23976,21926,23086
21604,9,293,13413,8191,5.8778e+18,112.686,1859.36,21604,113,109,9784,0,1330,2219,1419
96488,229,279,59572,36916,5.87017e+18,149.354,3432.12,96488,111,115,96209,96075,86905,92338,91446
48995,175,259,30217,18778,5.87013e+18,119.58,2292.52,48995,91,90,48736,48623,43570,44583,45639
44292,74,397,27469,16823,5.87418e+18,170.744,2984.59,44292,142,137,42367,40857,17327,19675,17391
2881,36,74,1797,1084,5.86812e+18,68.3339,413.563,2881,52,56,2547,2170,1230,1230,1188
96517,102,298,59591,36926,5.87059e+18,199.589,3374.99,96517,125,132,95546,94620,43549,45818,56735
53882,171,315,33307,20575,5.87373e+18,166.892,2844.95,53882,133,135,53383,53045,41334,39421,39656
17261,85,155,10612,6649,5.87014e+18,99.3332,1185.48,17261,69,74,17035,16876,11637,10880,12428
15453,135,271,9562,5891,5.87234e+18,90.2601,1437.52,15453,90,86,15155,15041,11956,12150,11814
60564,221,237,37430,23134,5.8703e+18,122.586,2403.5,60564,93,103,60327,60327,58804,59741,59829
90398,222,236,55875,34523,5.87031e+18,160.101,3204.72,90398,97,102,90162,90136,90080,90112,90158
21404,107,243,13475,7929,5.8969e+18,189.44,1873.18,21404,160,143,19902,18137,9577,9112,11128
27938,35,257,17173,10765,5.87176e+18,136.606,1763.53,27938,97,101,25311,22425,5335,8016,7100
31946,100,175,19758,12188,5.86937e+18,93.6615,1762.25,31946,82,81,31749,31696,23904,22371,20253
3010,18,77,1857,1153,5.86687e+18,59.9635,418.772,3010,51,54,2034,1225,544,721,685
44366,313,314,27894,16472,5.89546e+18,214.251,2863.21,44366,181,180,44052,44052,44049,44049,44052
45413,128,248,27945,17468,5.87018e+18,108.673,2158.84,45413,93,93,45138,44955,31357,30323,29136
87475,18,270,54139,33336,5.87025e+18,193.028,3416.67,87475,124,127,57847,34466,11793,13760,7950
11834,177,182,7298,4536,5.8696e+18,85.6929,1083.56,11834,71,72,11652,11647,11480,11605,11603
89353,86,397,55339,34014,5.87309e+18,219.251,3801.13,89353,154,167,86813,84457,22438,33116,25053
75444,309,318,46747,28697,5.87802e+18,193.961,3556.14,75444,168,174,75126,75123,74901,75063,75074
7850,46,76,4871,2979,5.87008e+18,67.7898,663.817,7850,61,64,7497,7037,4649,4412,5588
88904,260,411,55048,33856,5.8797e+18,247.601,4199.96,88904,188,199,88470,88297,60546,58602,41954
49594,138,273,30810,18784,5.87523e+18,216.425,2566.29,49594,145,146,48770,47962,28710,27170,31131
77931,146,262,48017,29914,5.87004e+18,134.365,2848.55,77931,100,108,77630,77451,58989,57968,66736
95221,166,220,58713,36508,5.87016e+18,136.679,3132.01,95221,92,101,95001,94860,81985,88376,90804
45699,12,261,28493,17206,5.88214e+18,203.532,2611.57,45699,165,160,25803,15369,3944,6126,2044
80472,236,342,49727,30745,5.87047e+18,163.29,3260.69,80472,111,107,80130,79989,77758,78487,78331
27017,43,214,16728,10289,5.87021e+18,105.083,1782.03,27017,85,85,25042,22271,9220,10591,11252
96335,70,278,59194,37141,5.87202e+18,184.352,3241.01,96335,142,141,93926,91981,21556,34055,28760
56055,45,260,34648,21407,5.86969e+18,175.839,2681.57,56055,103,106,52353,47685,12073,16845,14182
12584,41,123,7786,4798,5.86845e+18,58.4027,1009.67,12584,66,67,11930,10868,5545,5692,5997
36241,9,263,22552,13689,5.88359e+18,205.958,2351.75,36241,162,153,16542,0,2533,3888,1528
2281,81,93,1407,874,5.86674e+18,42.0254,380.09,2281,45,46,2188,2188,2093,2121,2088
29816,88,258,18566,11250,5.87754e+18,192.077,2014.36,29816,137,130,28351,26883,11601,12186,12496
44969,176,260,27686,17283,5.87112e+18,162.234,2189.61,44969,108,113,44629,44441,33706,35565,36905
22174,161,247,13708,8466,5.86937e+18,157.404,1751.98,22174,95,92,21878,21644,18892,19003,19588
57773,264,274,35646,22127,5.87299e+18,185.196,2687.66,57773,133,140,57499,57460,55759,56170,56278
65857,174,219,40697,25160,5.86997e+18,156.638,2706.14,65857,93,94,65637,65578,59777,62457,62672
37824,85,279,23391,14433,5.86957e+18,131.382,2264.05,37824,102,97,37124,36739,21948,20432,21914
39381,43,265,24781,14600,5.89401e+18,215.815,2616.59,39381,176,169,30468,22495,6223,8899,7529
63301,150,203,39013,24288,5.87016e+18,119.05,2519.49,63301,90,94,63097,62991,54969,57579,59608
76211,87,426,47562,28649,5.8833e+18,212.817,4320.97,76211,186,194,71544,66252,26176,28884,23339
84999,239,270,52641,32358,5.87026e+18,250.04,3587.52,84999,153,162,84645,84315,78489,81781,78090
3236,98,116,1989,1247,5.86979e+18,47.4629,483.034,3236,49,50,3120,3119,3080,3110,3082
47659,140,226,29472,18187,5.86997e+18,135.817,2073.81,47659,92,99,47383,47185,35247,32961,40977
27018,68,250,16617,10401,5.87055e+18,123.516,1705.81,27018,85,94,26408,25948,8360,11736,11966
13730,62,140,8479,5251,5.87016e+18,69.7866,1080.54,13730,71,71,13474,13208,9563,9845,9868
88242,52,263,54363,33879,5.87022e+18,144.675,3046.63,88242,103,110,85877,82734,21618,31270,31176
66200,60,273,41051,25149,5.87367e+18,209.931,2899.47,66200,147,152,63055,60549,16712,23797,19052
83056,179,307,51750,31306,5.885e+18,236.357,3822.85,83056,205,193,82233,81060,53938,53914,57203
3191,21,210,1995,1196,5.87174e+18,62.1717,639.01,3191,59,57,2330,1655,593,798,510
62168,92,271,38478,23690,5.87209e+18,205.162,2649.7,62168,129,137,60879,59688,22484,25057,21351
10956,26,238,6784,4172,5.87792e+18,125.968,1214.34,10956,97,89,8619,6632,1369,2684,920
9911,129,135,6137,3774,5.86941e+18,83.0027,888.748,9911,64,65,9776,9763,9614,9733,9682
17458,226,245,10828,6630,5.879e+18,172.889,1552.8,17458,121,112,17213,17181,16087,16721,16698
20914,80,150,12859,8055,5.86979e+18,82.9416,1362.08,20914,71,72,20715,20662,11196,10695,11518
96672,219,294,60730,35942,5.89397e+18,233.345,4177.02,96672,215,206,96255,95791,77717,81906,83077
92343,36,271,56930,35413,5.87017e+18,150.382,3108.79,92343,110,112,84977,76797,15625,24589,20491
93018,66,288,57376,35642,5.87026e+18,151.863,3193.16,93018,106,110,91666,90474,26214,35697,36733
27286,49,154,16876,10410,5.86951e+18,70.987,1593,27286,75,78,26269,24722,12097,12778,13249
96726,67,348,59744,36982,5.87023e+18,169.179,3542.81,96726,105,108,95258,93721,38592,38501,43472
92260,302,420,57018,35242,5.87043e+18,177.093,3704.67,92260,116,114,91840,91832,91591,91589,91216
5963,13,145,3692,2271,5.86945e+18,56.6477,707.953,5963,59,64,3695,2236,783,1114,1172
83862,188,277,51854,32008,5.8759e+18,226.39,3383.64,83862,189,169,83235,82521,58941,62717,60992
82475,334,426,51151,31324,5.87484e+18,169.398,4108.25,82475,151,143,82049,82010,79608,79749,76751
67515,131,285,42075,25440,5.87998e+18,228.901,3228.59,67515,184,177,65911,63925,33307,30663,33512
51212,86,197,31614,19598,5.87002e+18,108.912,2223.82,51212,86,92,50810,50511,25572,23746,27110
62767,157,214,38740,24027,5.87006e+18,126.52,2563.24,62767,92,92,62549,62458,51382,56717,49734
45714,123,188,28099,17615,5.87016e+18,113.27,2016.06,45714,84,93,45506,45312,34072,33843,38554
66492,163,397,41207,25285,5.87304e+18,181.606,3475.98,66492,149,146,65803,65209,44167,44343,41706
2878,50,134,1789,1089,5.86572e+18,54.378,520.895,2878,53,57,2682,2483,1393,1259,1363
29892,46,193,18495,11397,5.86994e+18,99.2449,1703.19,29892,79,78,28612,27068,9775,11360,9423
8995,147,227,5562,3433,5.87362e+18,97.0884,1028.47,8995,77,78,8753,8705,6367,6187,6403
15056,191,236,9499,5557,5.90044e+18,182.884,1583.97,15056,147,133,14789,14625,12953,13524,13838
92696,239,289,57121,35575,5.8704e+18,149.876,3186.91,92696,103,110,92407,92373,85628,87962,91311
66750,240,272,41180,25570,5.87319e+18,213.802,2911.97,66750,146,155,66447,66306,56862,62374,59416
76877,158,276,47559,29318,5.87077e+18,156.009,2838.15,76877,113,123,76461,76172,49653,43227,50466
65504,111,293,40394,25110,5.87027e+18,165.777,2693.05,65504,102,112,65024,64575,33859,31965,35452
21965,246,254,13583,8382,5.87265e+18,125.489,1577.44,21965,89,94,21711,21700,21374,21608,21651
45918,130,268,28479,17439,5.87471e+18,209.29,2428.92,45918,136,132,45096,44198,23575,21790,23144
17227,52,234,10566,6661,5.87172e+18,114.655,1300.93,17227,85,88,16422,15933,4341,6120,3807
17763,32,221,10938,6825,5.87059e+18,76.795,1343.68,17763,82,79,15416,12227,5427,5975,6794
25708,213,248,16209,9499,5.89906e+18,192.007,2086.84,25708,169,153,25453,25364,23729,24333,24623
27815,54,174,17170,10645,5.87043e+18,79.7886,1669.19,27815,79,78,27163,25998,12583,13301,15374
21466,16,166,13222,8244,5.8694e+18,94.0525,1348.53,21466,78,77,14138,8863,3192,2957,1582
90837,255,262,55958,34879,5.87045e+18,143.202,3085.7,90837,104,110,90575,90571,90207,90300,90530
61520,12,197,37988,23532,5.87002e+18,119.963,2525.36,61520,86,90,34725,21194,6229,6147,5046
38060,2,247,23583,14477,5.87018e+18,153.787,2215.69,38060,98,96,3393,0,298,0,136
57909,63,266,35576,22333,5.87155e+18,159.952,2474.68,57909,115,121,56366,55226,15209,23035,22108
37934,283,284,23696,14238,5.88298e+18,200.535,2541.59,37934,151,156,37650,37650,37643,37643,37640
44538,5,262,27380,17158,5.87284e+18,200.042,2258.92,44538,123,126,13462,0,305,2783,857
61222,210,211,37833,23389,5.87018e+18,114.579,2568.11,61222,88,88,61011,61011,61010,61011,61011
21035,113,219,12954,8081,5.86982e+18,100.665,1373.66,21035,78,86,20779,20591,12797,12641,16719
9949,158,214,6154,3795,5.87232e+18,105.75,988.025,9949,75,73,9735,9681,8540,8962,8917
19168,134,217,11858,7310,5.86987e+18,107.024,1349.94,19168,78,79,18937,18842,14561,14247,16101
86362,368,411,53479,32883,5.87967e+18,241.684,4159.92,86362,186,194,85951,85874,74493,80770,73322
71109,94,309,44087,27022,5.87371e+18,198.789,3145.42,71109,149,152,69373,67646,23521,30608,23655
90415,206,289,55719,34696,5.87012e+18,145.684,3114.6,90415,102,106,90126,90081,70238,79894,69363
1787,72,109,1105,682,5.86215e+18,44.4152,349.637,1787,41,40,1678,1664,1215,1218,1043
15550,104,210,9628,5922,5.86954e+18,106.55,1371.81,15550,83,82,15287,15213,11585,11075,10864
55596,224,272,34296,21300,5.87346e+18,202.87,2645.77,55596,145,142,55275,55090,48468,51662,51354
81358,116,307,50759,30599,5.88634e+18,236.872,3828.48,81358,193,199,78107,73959,34088,34536,36822
44528,67,268,27596,16932,5.87325e+18,212.19,2324.42,44528,130,132,42688,41142,10142,16303,13312
65910,134,270,40784,25126,5.87014e+18,219.834,3140.65,65910,141,149,64714,63333,38769,33792,43282
88593,18,264,54663,33930,5.87018e+18,134.245,3047.09,88593,102,109,64391,41976,11071,12925,8708
24800,85,248,15281,9519,5.87044e+18,123.978,1627.13,24800,93,92,24259,23747,8838,10324,6711
58898,298,342,36292,22606,5.87034e+18,137.829,2817.23,58898,111,109,58556,58512,53812,56421,55733
57096,174,274,35314,21782,5.87608e+18,226.161,2802.32,57096,163,152,56507,55877,38689,38475,37203
71382,154,300,44128,27254,5.87091e+18,186.658,2898.54,71382,110,118,70989,70784,50031,50581,61043
54629,259,304,33704,20925,5.87457e+18,200.726,2833.63,54629,144,143,54325,54276,46333,50737,46111
84746,73,277,52710,32036,5.87673e+18,228.02,3435.45,84746,187,178,80319,76513,18676,30302,24107
1468,59,74,907,561,5.86122e+18,54.2098,292.151,1468,45,46,1381,1327,1234,1180,1283
50032,123,257,30823,19209,5.87028e+18,118.815,2308.1,50032,91,98,49718,49501,35560,35781,39885
5729,11,139,3525,2204,5.87084e+18,74.5017,660.503,5729,56,58,3480,2320,575,823,720
46484,179,199,28728,17756,5.87001e+18,101.794,2171.33,46484,84,82,46285,46283,46201,46191,46122
87676,33,288,54050,33626,5.87016e+18,139.674,3101.48,87676,107,108,78422,63871,15203,22404,16247
16656,158,243,10276,6380,5.87115e+18,146.604,1372.62,16656,88,94,16360,16224,11653,11400,12210
16251,64,125,10005,6246,5.86965e+18,63.6102,1152.37,16251,69,69,16080,15944,10727,10701,9534
18283,48,139,11328,6955,5.86979e+18,91.8438,1193.04,18283,71,74,17743,17223,6286,7544,8334
59126,260,342,36468,22658,5.8704e+18,154.902,2863.23,59126,115,111,58784,58680,54256,56161,54261
50253,19,224,31095,19158,5.86994e+18,128.709,2127.28,50253,92,103,38216,26477,6512,10046,7281
50262,176,199,31018,19244,5.87e+18,119.073,2231.1,50262,84,88,50063,50005,47147,48695,49160
71364,6,234,43975,27389,5.86994e+18,141.022,2662.57,71364,104,111,25073,0,2735,3508,1522
2714,57,71,1669,1045,5.86578e+18,54.5947,377.593,2714,48,52,2637,2568,2311,2384,2611
44235,87,175,27206,17029,5.87042e+18,101.029,2026.73,44235,81,89,43921,43711,25562,24660,30275
3280,463,2566,2202,1078,4.82374e+18,70.3841,2775.53,3280,141,100,714,573,194,302,136
28620,162,164,17619,11001,5.86954e+18,106.177,1557.28,28620,77,82,28456,28456,28426,28427,28456
55818,242,272,34524,21294,5.87628e+18,231.075,2800.12,55818,165,156,55524,55413,49053,52598,52934
77313,226,293,47613,29700,5.87074e+18,154.887,2974.7,77313,120,129,77020,76957,64219,70770,58946
45217,81,273,28035,17182,5.87443e+18,178.118,2425.14,45217,133,134,43631,42163,14891,18822,15869
85785,30,285,53519,32266,5.88296e+18,247.396,3724.67,85785,195,198,67645,53262,10737,19691,10178
75073,198,272,46304,28769,5.87272e+18,211.429,3048.18,75073,152,157,74615,74192,58070,62827,58277
80735,174,209,49844,30891,5.87009e+18,130.281,2932.74,80735,92,94,80526,80508,75259,78255,78443
13459,133,161,8274,5185,5.86966e+18,95.6245,1073.06,13459,69,70,13298,13268,11205,12449,11552
34048,146,174,21010,13038,5.87001e+18,79.2793,1829.67,34048,80,79,33874,33864,31720,33024,32138
26689,106,162,16513,10176,5.86975e+18,114.077,1486.06,26689,75,84,26479,26308,19929,19474,23302
82270,209,274,50827,31443,5.87489e+18,223.083,3302.45,82270,179,168,81808,81270,66686,73146,70838
9765,40,199,6041,3724,5.8697e+18,85.6365,939.908,9765,66,70,9132,8471,2611,3673,3929
4456,174,263,2773,1683,5.88208e+18,86.7527,867.609,4456,70,67,4193,4158,3369,3427,3223
19327,181,255,11968,7359,5.87748e+18,151.939,1628.23,19327,119,109,19009,18817,15530,16143,15811
75864,54,209,46853,29011,5.8701e+18,130.993,2834.63,75864,90,93,74107,70629,21250,28481,29231
28584,168,251,17978,10606,5.896e+18,192.784,2175.62,28584,167,156,28070,27346,20259,20421,22727
19416,139,158,11934,7482,5.86963e+18,102.665,1263.36,19416,71,75,19258,19205,18162,18821,19151
57326,111,256,35263,22063,5.87054e+18,120.444,2480.36,57326,97,102,56968,56624,30483,29266,32140
71381,103,318,44303,27078,5.87965e+18,234.525,3496.63,71381,176,184,68676,65801,26667,30839,21739
72863,41,259,44901,27962,5.87062e+18,124.432,2789.34,72863,99,103,68848,62939,16158,22642,17842
72466,87,328,44933,27533,5.87861e+18,192.706,3560.11,72466,166,175,69377,66038,25935,30301,26501
32190,174,250,20302,11888,5.8974e+18,191.348,2326.08,32190,175,164,31712,31020,24505,25338,27092
85662,105,342,52774,32888,5.87042e+18,149.663,3327.61,85662,117,116,84876,84230,38754,37303,37851
61062,141,274,37682,23380,5.87378e+18,214.753,2785.22,61062,153,146,60169,59495,34480,32701,36783
89716,224,295,55269,34447,5.87014e+18,162.647,3110.47,89716,112,118,89421,89335,83457,86183,84984
32632,78,291,20105,12527,5.87092e+18,176.184,2028.39,32632,105,109,31733,31093,8993,13560,12231
71864,155,262,44293,27571,5.86996e+18,126.208,2784.39,71864,97,104,71587,71457,51702,48583,57614
4683,107,135,2874,1809,5.87187e+18,70.5851,598.089,4683,52,55,4548,4512,4293,4401,4468
59429,76,300,36689,22740,5.87089e+18,149.915,2701.99,59429,105,108,58447,57773,24168,26313,29894
57489,194,257,35535,21954,5.87002e+18,141.56,2674.81,57489,103,101,57189,57030,49340,52682,53901
23984,70,216,14851,9133,5.87061e+18,100.912,1479.09,23984,78,82,23534,23260,9916,11254,13783
29034,116,250,18313,10721,5.89656e+18,195.5,2199.16,29034,170,159,27347,25154,14117,12920,16224
2772,20,145,1710,1062,5.8695e+18,55.5339,524.033,2772,48,51,2098,1587,490,602,617
7441,266,271,4604,2837,5.87439e+18,124.357,1020.88,7441,78,76,7170,7170,7165,7170,7165
82102,133,285,51047,31055,5.87779e+18,205.99,3480.69,82102,174,176,80605,78938,42075,40350,47146
80643,54,411,50042,30601,5.87716e+18,193.573,4124.27,80643,168,169,74300,67846,19401,24570,22148
59872,295,393,37040,22832,5.87054e+18,156.192,2996.99,59872,108,105,59479,59475,59329,59325,59175
65642,205,219,40555,25087,5.87009e+18,154.9,2690.88,65642,92,94,65423,65408,64785,65228,65175
75550,85,285,47067,28483,5.88101e+18,239.2,3426,75550,183,184,71502,67164,21045,27391,24676
55608,285,304,34290,21318,5.875e+18,214.434,2835.77,55608,145,148,55304,55288,50244,52990,53685
97528,46,411,60410,37118,5.87682e+18,185.993,4408.38,97528,180,181,88027,78418,23958,31401,22435
29230,84,248,18437,10793,5.89979e+18,193.9,2214.92,29230,174,161,25731,21506,10412,9972,11877
8190,237,259,5089,3101,5.87687e+18,125.963,1088.18,8190,81,78,7931,7904,7857,7888,7767
6774,52,77,4151,2623,5.87128e+18,57.9495,603.738,6774,59,59,6618,6378,5130,5117,5887
70866,134,215,43743,27123,5.87001e+18,122.68,2726.39,70866,91,95,70618,70466,50230,49082,47010
82017,162,285,51158,30859,5.88166e+18,243.958,3608.64,82017,195,190,80868,79579,51118,46927,53851
29414,216,262,18112,11302,5.87207e+18,170.357,1846.88,29414,99,110,29152,29072,24702,27246,23039
24657,180,244,15241,9416,5.87094e+18,84.5516,1615.52,24657,84,83,24413,24369,22402,23287,21509
29963,39,165,18523,11440,5.87012e+18,102.943,1607.19,29963,78,82,28200,25880,7285,10356,10395
96769,65,411,59979,36790,5.87685e+18,193.221,4426.99,96769,177,179,91506,86018,29959,35364,30825
68131,105,272,42040,26091,5.87416e+18,214.969,2946.06,68131,156,159,66493,64777,29402,30488,31004
83345,255,290,52215,31130,5.89028e+18,242.594,3844.53,83345,209,210,83040,82854,73010,76508,78136
44823,10,226,27582,17241,5.86995e+18,138.106,2023.37,44823,94,100,24153,16645,4664,4415,3301
63953,264,426,39831,24122,5.88107e+18,170.947,3943.18,63953,163,168,63527,63465,54626,54286,46477
65910,266,279,40815,25095,5.87766e+18,230.944,3088.58,65910,174,168,65631,65583,64789,65066,65463
68624,55,376,42449,26175,5.87075e+18,151.082,3217.91,68624,116,109,66049,62512,24710,26652,28616
44464,107,196,27503,16961,5.86995e+18,107.442,2147.98,44464,83,85,44229,44097,26985,23815,24482
57538,162,270,35647,21891,5.87003e+18,204.334,2808.32,57538,114,120,57041,56524,40445,34683,44857
56016,202,226,34566,21450,5.87003e+18,131.568,2368.06,56016,90,96,55790,55789,55755,55755,55766
89833,17,279,55619,34214,5.87134e+18,185.505,3119.26,89833,139,136,65618,45045,9973,17078,6868
32844,103,261,20346,12498,5.87174e+18,130.411,1899.15,32844,99,103,32309,31896,17655,17416,19963
50434,9,262,31207,19227,5.87141e+18,168.721,2328.84,50434,110,119,25538,0,4023,6039,2579
79670,111,411,49283,30387,5.87845e+18,196.397,4006.03,79670,179,180,77360,74783,27726,33907,24760
35019,335,374,21730,13289,5.87594e+18,184.743,2370.9,35019,130,133,34645,34608,29479,32544,28708
1820,63,85,1112,708,5.87006e+18,41.4066,330.117,1820,40,41,1735,1710,1601,1642,1573
67671,105,207,41789,25882,5.86996e+18,111.34,2701.35,67671,91,90,67394,67235,43565,40908,43609
58093,258,268,35700,22393,5.87124e+18,165.613,2480.67,58093,114,119,57825,57825,56192,57297,57447
92778,352,397,57468,35310,5.87216e+18,193.442,3971.29,92778,141,139,92381,92306,90051,91344,89631
36083,111,258,22228,13855,5.87186e+18,173.58,1984.53,36083,104,110,35489,34939,19367,19005,25105
8281,180,225,5113,3168,5.8751e+18,93.409,992.779,8281,74,73,8056,8019,6987,7489,6316
33570,198,257,20862,12708,5.87794e+18,199.187,2128.69,33570,140,137,33230,32937,27242,29608,28118
97234,107,298,60047,37187,5.87045e+18,186.872,3345.11,97234,122,128,96403,95510,47650,47916,58742
19113,138,217,11839,7274,5.87085e+18,94.9239,1337.03,19113,78,84,18896,18820,13556,13326,12641
47945,14,226,29672,18273,5.87062e+18,129.278,2088.22,47945,91,99,31470,19194,5267,8066,4214
73803,193,274,45747,28056,5.87317e+18,208.029,2993.03,73803,151,147,73378,72948,54505,61179,55893
87682,66,269,54077,33605,5.87007e+18,148.336,3021.36,87682,105,110,86318,85204,26225,34165,38542
76581,86,296,47353,29228,5.87094e+18,157.392,2969.53,76581,116,125,75485,74504,21862,31975,30474
59635,208,290,36877,22758,5.87129e+18,164.942,2640.93,59635,113,122,59329,59170,42686,50177,41200
71722,81,234,44201,27521,5.87016e+18,139.364,2675.42,71722,103,108,70910,70282,26823,29636,19305
42329,171,298,26107,16222,5.87149e+18,124.353,2314.35,42329,100,101,41976,41856,34081,33077,33209
20677,69,128,12836,7841,5.86931e+18,65.9153,1304.15,20677,72,71,20529,20350,13641,13140,10557
44732,68,226,27532,17200,5.86977e+18,128.276,2030.01,44732,92,96,43970,43478,13745,19278,21442
77393,283,291,48571,28822,5.89255e+18,238.305,3725.21,77393,209,203,77102,77092,76706,76965,76758
16159,109,229,10139,6020,5.89003e+18,171.508,1563.55,16159,131,122,15253,14193,7933,7339,8832
18031,174,217,11079,6952,5.87069e+18,101.354,1303.71,18031,78,84,17814,17765,15731,16829,16707
71328,36,260,44081,27247,5.86995e+18,176.932,3018.15,71328,108,110,63225,54708,14905,19940,17466
5432,8,75,3371,2061,5.86864e+18,66.1892,551.191,5432,59,60,2278,0,262,441,755
64715,279,301,39928,24787,5.87077e+18,149.976,2803.29,64715,110,109,64414,64369,60825,62897,63234
63236,16,198,39042,24194,5.87033e+18,127.278,2552.21,63236,87,90,42093,26587,7505,7438,6048
9416,49,77,5800,3616,5.86891e+18,66.7746,727.184,9416,62,67,9096,8642,5982,5742,7161
85676,11,426,53336,32340,5.87938e+18,175.185,4442.57,85676,173,175,40732,23319,6005,8827,4551
58916,46,216,36326,22590,5.86979e+18,125.31,2492.08,58916,90,94,56434,53476,15539,20717,19662
83988,218,294,51912,32076,5.87109e+18,194.539,3137.98,83988,122,122,83672,83545,69675,77750,69850
25166,193,258,15586,9580,5.87675e+18,171.121,1850.21,25166,118,123,24835,24642,20152,21266,19795
70788,57,215,43620,27168,5.87022e+18,132.684,2665.85,70788,93,98,69460,67717,18780,26525,27313
41277,24,245,25530,15747,5.87047e+18,154.38,2000.92,41277,101,104,34565,27034,4955,9691,5800
25969,169,173,15970,9999,5.86966e+18,98.0134,1545.39,25969,78,79,25796,25795,25734,25794,25702
71179,294,328,44138,27041,5.87609e+18,170.142,3454.54,71179,146,156,70851,70804,67551,69142,67951
50331,122,294,31786,18545,5.9007e+18,215.521,2995.77,50331,190,185,47446,42972,21720,20967,27798
76661,168,270,47463,29198,5.8702e+18,232.215,3359,76661,140,148,75826,74871,54874,49214,52795
10533,1943,3092,6599,3934,5.60557e+18,758.537,4817.24,10533,184,194,7441,7369,6789,6794,6863
31071,126,174,19164,11907,5.87003e+18,80.3569,1749.22,31071,80,79,30897,30853,27267,28648,27304
99885,110,285,62334,37551,5.88251e+18,251.542,4013.49,99885,200,204,95941,91262,41454,39972,42153
2338,90,157,1445,893,5.87593e+18,51.142,471.758,2338,49,48,2181,2148,1645,1581,1387
36254,204,272,22396,13858,5.87522e+18,180.472,2224.53,36254,129,134,35909,35692,29553,31693,28086
33118,55,286,20496,12622,5.87174e+18,126.067,2044.32,33118,103,105,31787,30567,9721,12627,10265
88459,256,279,54647,33812,5.87003e+18,173.301,3329.61,88459,111,106,88180,88135,87928,88110,88031
52930,60,238,32747,20183,5.87024e+18,146.94,2514.63,52930,92,93,51677,49890,19244,20391,22748
50732,40,217,31250,19482,5.87e+18,122.76,2317.3,50732,88,91,47582,43202,10821,15811,13347
25433,76,195,15674,9759,5.86986e+18,95.3926,1523.66,25433,81,82,25138,24969,14252,13368,13225
51863,236,274,32078,19785,5.87651e+18,234.176,2691.21,51863,152,156,51557,51405,45231,48558,48475
16273,13,138,9998,6275,5.87008e+18,70.7343,1175.03,16273,69,70,9664,5547,1957,1870,1963
18187,83,214,11230,6957,5.86945e+18,121.61,1485.7,18187,82,84,17851,17712,9955,9056,9628
80315,28,296,49440,30875,5.87067e+18,147.849,3021.78,80315,118,122,68745,54782,13848,19939,15067
86294,42,282,53214,33080,5.87299e+18,213.259,3261.29,86294,152,159,79926,73354,14677,24158,18086
94435,244,281,58533,35902,5.87296e+18,200.104,3388.28,94435,155,160,94143,94060,79150,87943,83345
67883,145,285,42318,25565,5.88122e+18,239.591,3273.45,67883,179,181,66591,65232,36906,32687,36180
54991,118,323,34142,20849,5.88074e+18,194.835,3142.5,54991,166,173,53288,51364,30430,32149,26645
89429,135,238,55221,34208,5.87007e+18,151.589,3169.52,89429,95,95,89122,88844,68046,64349,73874
65906,230,264,40486,25420,5.87161e+18,165.22,2614.52,65906,120,127,65641,65575,56575,61885,59601
67801,28,227,41882,25919,5.87002e+18,140.508,2690.5,67801,91,96,57233,43729,10341,14177,11922
58943,112,299,36329,22614,5.87064e+18,152.437,2697.36,58943,108,115,58287,57721,35859,38436,39530
70139,47,259,43240,26899,5.87018e+18,137.021,2712.03,70139,96,105,67545,65008,15394,23739,21074
9203,120,145,5705,3498,5.87082e+18,66.0111,920.996,9203,65,68,9058,9058,7905,8492,7368
80136,18,215,49360,30776,5.86989e+18,132.46,2811.76,80136,95,102,58145,37569,9956,11590,9157
61739,408,426,38209,23530,5.87131e+18,155.107,3280.59,61739,120,112,61313,61313,61295,61308,61115
69783,26,300,43140,26643,5.87104e+18,190.344,2875.82,69783,111,115,58166,44681,9155,17268,11368
27258,78,260,17008,10250,5.886e+18,193.238,2090.1,27258,157,141,24903,22406,7505,10037,8736
94241,278,307,58674,35567,5.8845e+18,250.465,4042.01,94241,206,199,93934,93799,88215,90448,90580
68953,37,220,42576,26377,5.87009e+18,128.344,2753.17,68953,92,91,62766,55365,15471,21269,17996
72000,16,285,44822,27178,5.87843e+18,196.712,3308.82,72000,173,174,47655,31147,7070,12450,5989
4548,39,114,2785,1763,5.8681e+18,50.9169,585.64,4548,55,56,4248,3883,1607,1744,1557
86505,108,260,53491,33014,5.86993e+18,163.411,3289.33,86505,111,111,85856,85422,51857,47110,52243
87502,8,222,54034,33468,5.87e+18,152.366,3104.05,87502,94,97,36695,0,5164,6319,4917
65715,24,250,40649,25066,5.87001e+18,157.571,2831.32,65715,99,98,50643,34998,10113,14377,10704
77760,150,328,48244,29516,5.87584e+18,198.174,3558.26,77760,152,151,77037,76256,49394,47197,45958
68637,122,291,43207,25430,5.89559e+18,223.504,3512.61,68637,202,196,65336,60362,31186,29289,36454
11476,158,183,7086,4390,5.8682e+18,84.688,1122.96,11476,73,76,11293,11274,10764,11040,10325
90495,47,277,56216,34279,5.87709e+18,224.487,3558.24,90495,187,179,82274,75106,16044,26122,16021
6671,194,215,4170,2501,5.87941e+18,130.696,934.472,6671,83,81,6456,6429,5833,6240,6288
72644,275,312,44856,27788,5.87382e+18,193.944,3239.09,72644,146,148,72332,72269,63310,68314,65718
12888,144,154,7944,4944,5.86985e+18,66.3866,1071.71,12888,68,71,12734,12734,12483,12655,12397
24775,45,164,15304,9471,5.87013e+18,113.82,1459.22,24775,75,82,23793,22727,5535,8636,8453
92865,117,276,57202,35663,5.87155e+18,193.048,3253.05,92865,146,150,91696,90332,44118,43306,39463
64407,77,238,39824,24583,5.8701e+18,151.804,2451.83,64407,106,111,63428,62670,21463,25370,23510
88937,208,322,54856,34081,5.8705e+18,211.143,3307.06,88937,127,130,88565,88321,62309,71714,58502
81201,218,381,50231,30970,5.87065e+18,158.204,3473.57,81201,120,115,80811,80674,76183,75387,75729
97310,84,342,60061,37249,5.87048e+18,153.932,3521.14,97310,120,117,96149,95355,39189,43771,48047
12565,78,182,7745,4820,5.87052e+18,84.811,1113.62,12565,73,75,12329,12213,8053,8386,8554
18872,32,284,11723,7149,5.8801e+18,94.415,1724.25,18872,108,99,15125,10737,5778,6004,6907
9069,84,223,5721,3348,5.90072e+18,167.746,1212.19,9069,112,107,8000,6814,3715,3526,4074
67190,260,271,41766,25424,5.8819e+18,219.099,3214.16,67190,187,185,66919,66902,65245,65912,66203
79300,73,316,48796,30504,5.8719e+18,200.3,3200.9,79300,126,131,77701,76414,24426,29577,30601
43105,95,270,26694,16411,5.87017e+18,179.424,2414.69,43105,103,110,42358,41897,20428,17404,21943
18592,84,244,11553,7039,5.86953e+18,107.221,1516.37,18592,86,92,18127,17867,8503,7667,8560
32025,171,175,19759,12266,5.86995e+18,98.3806,1766.74,32025,78,79,31850,31849,31848,31850,31845
65272,169,279,40339,24933,5.87016e+18,141.637,2872.35,65272,106,107,64907,64673,53071,51565,55350
85683,170,342,52914,32769,5.87047e+18,151.925,3349.25,85683,118,114,85245,84960,69771,68235,73945
76279,270,300,46963,29316,5.87132e+18,193.318,3018.34,76279,116,122,75979,75891,73609,74964,74359
42393,273,275,26119,16274,5.87614e+18,175.723,2362.08,42393,132,135,42118,42118,41935,41945,42019
17043,138,211,10448,6595,5.87136e+18,93.3234,1242.08,17043,74,81,16832,16772,12254,13140,11365
94811,261,262,58488,36323,5.87005e+18,145.387,3132.42,94811,107,112,94549,94549,94549,94549,94549
49945,151,254,30805,19140,5.87025e+18,119.644,2304.61,49945,95,96,49681,49545,39293,37183,41783
52313,345,381,32374,19939,5.87134e+18,144.517,2886.78,52313,122,117,51932,51883,48434,50465,49732
10670,134,149,6570,4100,5.86879e+18,77.7526,911.719,10670,61,65,10521,10521,10357,10391,10300
47623,186,275,29336,18287,5.87659e+18,197.882,2523.19,47623,141,138,47192,46843,33955,36736,35139
8953,105,142,5539,3414,5.87016e+18,66.4135,906.115,8953,71,70,8811,8809,8192,8346,7670
82375,241,279,50876,31499,5.87032e+18,132.061,3194.67,82375,107,112,82096,81994,77945,79211,78585
74935,31,276,46226,28709,5.87323e+18,205.458,3058.74,74935,145,153,64924,54835,11172,18430,12459
47229,172,316,29142,18087,5.87294e+18,145.127,2649.5,47229,116,112,46859,46687,43895,43463,42949
57392,23,220,35447,21945,5.86976e+18,138.644,2465.38,57392,88,91,44301,31524,8336,10913,6327
74143,218,266,45576,28567,5.87212e+18,193.523,2822.27,74143,133,130,73844,73711,61907,68569,66654
28810,124,244,17726,11084,5.87025e+18,159.089,1697.84,28810,96,95,28454,28142,16363,16348,18584
2488,28,76,1542,946,5.87471e+18,58.4244,379.215,2488,46,49,2057,1551,826,895,1113
70626,12,285,43999,26627,5.87973e+18,243.678,3333.64,70626,177,181,39652,23506,6225,8722,2951
64677,212,217,39815,24862,5.8701e+18,127.614,2596.82,64677,89,97,64460,64455,64457,64329,64460
98380,152,285,60666,37714,5.87018e+18,151.683,3266.28,98380,105,109,98049,97799,71180,67716,85029
90995,59,306,56079,34916,5.87044e+18,158.127,3271.32,90995,117,125,88827,86832,24550,33034,30017
64180,78,260,39553,24627,5.86996e+18,134.092,2600.09,64180,96,100,63439,62936,26205,28656,33761
3257,47,61,1986,1271,5.86511e+18,52.7479,389.071,3257,47,49,3154,3084,2502,2554,2770
96861,125,342,60002,36859,5.87732e+18,207.077,4150.6,96861,174,169,95320,93285,49917,44498,49441
59232,137,222,36630,22602,5.87003e+18,127.443,2539.53,59232,89,88,58995,58860,43501,45096,44815
31517,106,173,19521,11996,5.86993e+18,97.2317,1754.96,31517,79,79,31324,31284,22909,21414,20049
49351,271,285,30750,18601,5.88051e+18,219.558,2801.28,49351,161,160,49066,49027,47446,48342,47816
84563,141,381,52301,32262,5.87071e+18,160.043,3532.2,84563,124,116,83934,83409,65529,65018,70215
83030,250,307,51678,31352,5.88407e+18,230.29,3795.28,83030,197,195,82706,82539,72438,74938,77470
55510,243,265,34341,21169,5.87103e+18,170.131,2434.63,55510,111,122,55245,55211,48065,52187,52841
88948,193,294,55536,33412,5.88735e+18,233.118,3933.49,88948,205,204,88253,87336,58336,58191,58667
87268,268,281,53952,33316,5.8707e+18,156.514,3050.93,87268,119,130,86987,86984,85978,86572,86422
14192,78,235,8970,5222,5.8993e+18,182.064,1540.55,14192,140,129,12247,9967,5117,4748,5812
43788,170,173,27088,16700,5.86972e+18,111.261,2044.87,43788,84,84,43615,43607,43613,43612,43615
48800,191,204,29995,18805,5.87032e+18,116.892,2116.12,48800,86,94,48596,48596,47955,48259,48341
38180,37,224,23487,14693,5.86989e+18,126.336,1872.03,38180,87,100,35459,32573,6561,10419,8445
55768,238,291,34342,21426,5.87058e+18,167.391,2563.86,55768,115,119,55477,55428,46206,51619,44129
25442,12,171,15664,9778,5.87039e+18,92.6975,1528.34,25442,77,78,14386,8775,2457,3284,1613
49375,5264,5585,31094,18281,5.76968e+18,473.245,10253.3,49375,333,269,43790,43789,42244,42378,19106
35903,76,304,22407,13496,5.8858e+18,196.226,2581.95,35903,158,165,32848,29753,10483,15056,9087
79429,46,217,49084,30345,5.87004e+18,118.476,2881.64,79429,92,95,76146,71941,22053,28926,26009
80735,172,225,49830,30905,5.87031e+18,131.496,2959.37,80735,90,92,80510,80455,74110,77054,77795
78143,3,260,48154,29989,5.87022e+18,123.739,2903.97,78143,97,105,13370,0,182,1052,551
88140,82,328,54687,33453,5.87657e+18,213.433,3840.88,88140,168,172,84997,81704,29535,34644,34441
85447,176,257,52831,32616,5.87021e+18,167.048,3211.98,85447,109,108,85102,84847,64240,60859,73932
63195,301,306,39178,24017,5.87415e+18,207.024,2984.29,63195,148,151,62889,62888,61939,62637,62733
31989,81,261,20052,11937,5.89076e+18,214.731,2325.48,31989,165,159,28902,25449,10309,11228,12497
35008,10178,13726,22230,12778,5.48226e+18,1003.73,17758.2,35008,822,312,21282,21194,18315,18402,15742
83625,216,260,51512,32113,5.87052e+18,146.284,2950.78,83625,103,111,83365,83277,76675,80575,80462
64158,169,259,39551,24607,5.87034e+18,142.296,2621.33,64158,98,102,63889,63749,56807,55716,60825
85864,109,273,53097,32767,5.87075e+18,159.904,2975.26,85864,121,130,85080,84213,41449,41119,46065
82516,62,316,50933,31583,5.87331e+18,191.151,3440.96,82516,147,151,79373,76746,24752,32349,25657
52120,206,260,32192,19928,5.87005e+18,155.79,2574,52120,101,104,51836,51757,45539,49013,49893
65331,169,269,40235,25096,5.87112e+18,202.517,2690.12,65331,128,138,64828,64405,43981,41740,42943
55164,146,213,33984,21180,5.87015e+18,127.445,2362.57,55164,91,95,54945,54831,45602,47770,48306
85862,115,277,53167,32695,5.87148e+18,186.859,3053.32,85862,132,141,84914,83846,40446,38485,40807
6790,92,133,4206,2584,5.8701e+18,76.0869,707.929,6790,58,59,6646,6584,5168,5325,5858
79552,203,216,49055,30497,5.87004e+18,131.864,2875.9,79552,92,96,79336,79330,77883,78913,79208
50679,119,251,31309,19370,5.87018e+18,161.13,2506.05,50679,94,94,50265,49966,34501,33765,32670
38061,49,201,23525,14536,5.86979e+18,108.986,1996.82,38061,84,84,36461,34030,11587,14494,15040
93522,65,259,57798,35724,5.87006e+18,142.838,3353.84,93522,105,106,92055,90297,33894,37347,40633
36001,287,303,22620,13381,5.89447e+18,185.915,2701.75,36001,165,175,35698,35680,34990,35393,34889
65334,100,293,40412,24922,5.87111e+18,165.714,2742.25,65334,115,124,64518,63733,25267,28167,25991
8482,110,145,5236,3246,5.8686e+18,79.4895,820.873,8482,64,65,8337,8297,7021,7638,6999
84371,95,271,52186,32185,5.87007e+18,192.091,3332.47,84371,117,119,83360,82668,40840,35446,41152
39632,66,181,24413,15219,5.8699e+18,80.1547,1995.8,39632,79,83,39220,38700,22266,23762,23773
39785,266,297,24591,15194,5.87119e+18,132.071,2216.93,39785,105,103,39488,39444,35722,37970,36806
14483,63,246,9160,5323,5.90266e+18,184.221,1577.35,14483,141,135,11482,8435,3310,3876,2315
50745,131,181,31338,19407,5.86987e+18,115.715,2245.06,50745,83,86,50543,50458,40885,41665,44283
40793,46,307,25371,15422,5.88438e+18,214.247,2729.3,40793,165,151,35072,29877,6639,10637,6612
44789,87,224,27729,17060,5.87003e+18,122.917,2007.86,44789,91,99,44292,43857,22110,22323,28931
22381,134,151,13761,8620,5.86999e+18,89.9468,1400.73,22381,73,77,22230,22227,21772,22011,22012
68149,69,203,41992,26157,5.86988e+18,123.082,2604.47,68149,91,97,67448,66820,27829,28722,33956
46004,109,317,28847,17157,5.89142e+18,187.272,3028.53,46004,175,176,43468,40296,20263,19891,12627
16865,32,160,10375,6490,5.87058e+18,102.11,1196.05,16865,73,76,15086,12673,3742,4968,5078
82445,286,293,50803,31642,5.86988e+18,170.205,2974.1,82445,111,118,82152,82152,82041,82114,82152
24272,157,199,15002,9270,5.87012e+18,109.673,1678.19,24272,83,80,24073,24011,22647,23302,22426
99569,90,325,61708,37861,5.87796e+18,219.188,4098.25,99569,187,192,95691,91346,36141,46191,34916
92691,82,307,57298,35393,5.87134e+18,238.399,3384.54,92691,132,141,91089,89754,21713,33662,31232
31773,141,273,19903,11870,5.88675e+18,202.298,2330.8,31773,162,161,30842,29870,18071,16612,16483
16335,36,271,10099,6236,5.87325e+18,87.8794,1462.66,16335,89,85,14351,12405,5108,5836,6035
80609,112,381,49870,30739,5.87102e+18,176.971,3406.34,80609,131,135,79636,78667,31586,34345,33254
27066,196,260,16935,10131,5.88894e+18,205.711,2112.97,27066,154,150,26722,26421,21671,22854,23447
96806,20,307,60322,36484,5.88518e+18,236.117,4107.49,96806,202,203,65051,43636,9563,17355,7875
59291,8,286,37342,21949,5.89595e+18,222.409,3268.34,59291,197,192,20425,0,2047,3793,1954
26755,142,191,16478,10277,5.87024e+18,96.4369,1613.16,26755,78,79,26564,26501,25281,25437,25651
36171,164,258,22394,13777,5.87197e+18,170.709,1981.26,36171,106,112,35813,35609,27133,28433,30325
83047,194,216,51272,31775,5.87024e+18,132.167,2960.92,83047,91,98,82831,82815,77801,80406,80636
92241,197,279,57093,35148,5.87153e+18,188.839,3181.53,92241,136,144,91843,91477,69353,78351,74329
25519,123,165,15704,9815,5.8698e+18,106.655,1450.86,25519,77,82,25349,25252,22167,23539,23675
63866,155,275,39276,24590,5.87262e+18,211.129,2736.5,63866,136,141,63245,62720,40542,35144,37002
33840,31,157,20883,12957,5.87024e+18,92.5644,1745.23,33840,77,82,29772,24084,6278,9864,7715
54652,210,228,33607,21045,5.87029e+18,127.461,2334.36,54652,92,94,54424,54424,54254,54290,54362
25932,49,174,16044,9888,5.86983e+18,107.243,1459.2,25932,77,81,25139,24532,7266,9600,9634
2211,42,95,1361,850,5.86746e+18,45.1153,378.534,2211,43,43,2085,1984,1312,1342,1458
48309,129,259,29914,18395,5.87005e+18,151.601,2483.27,48309,101,101,47862,47509,31980,30719,34731
43822,167,226,27105,16717,5.87021e+18,130.752,1999.62,43822,89,97,43596,43497,34857,39066,39560
84490,225,298,52128,32362,5.8706e+18,162.093,3166.31,84490,120,124,84169,84057,75011,79315,72889
41514,52,215,25537,15977,5.87042e+18,164.614,1968.09,41514,96,106,40154,39001,9637,14790,14984
37393,54,173,23134,14259,5.86998e+18,94.3147,1903.73,37393,80,80,36441,34440,15629,16267,18621
96867,174,278,59912,36955,5.87069e+18,163.655,3243.68,96867,124,131,96449,96165,66955,63786,71475
59925,64,202,36968,22957,5.87027e+18,123.508,2455.24,59925,86,93,59149,58472,20513,23143,22730
14661,59,231,9029,5632,5.87087e+18,115.666,1217.84,14661,85,80,14012,13548,4225,5800,5732
16472,55,156,10133,6339,5.86898e+18,90.7692,1156.23,16472,69,75,16090,15762,6636,7480,6912
94580,276,289,58291,36289,5.87015e+18,142.867,3205.6,94580,105,110,94291,94285,94025,93566,93808
97216,236,294,59863,37353,5.87023e+18,160.806,3216.25,97216,109,120,96922,96877,91676,94597,95144
9701,139,155,5955,3746,5.86979e+18,86.5437,897.183,9701,62,64,9546,9535,8867,9218,9057
75383,158,426,47147,28236,5.88597e+18,207.49,4316.2,75383,187,198,74162,72629,43108,42515,35647
74736,21,276,46350,28386,5.87917e+18,234.516,3349.02,74736,185,179,54709,39645,8226,15328,6218
58020,11,230,35872,22148,5.87035e+18,120.541,2551.11,58020,90,90,29986,18895,4833,6346,4912
77092,6,307,47838,29254,5.88034e+18,248.413,3557.94,77092,185,187,25462,0,2768,4361,1910
91845,275,382,57850,33995,5.89631e+18,231.768,4221.2,91845,217,203,91463,91417,76906,79490,75786
14745,164,239,9288,5457,5.89578e+18,191.769,1563.38,14745,138,125,14347,13968,10503,10949,11755
40969,171,272,25302,15667,5.87459e+18,198.299,2336.14,40969,135,135,40499,40147,30343,30499,32893
84801,52,263,52246,32555,5.87019e+18,132.237,2992.31,84801,99,108,82586,79436,21210,30079,26382
72531,258,273,45012,27519,5.87582e+18,224.158,3111.59,72531,163,167,72249,72165,67926,70359,70383
44554,99,197,27441,17113,5.87038e+18,123.96,2093.15,44554,89,91,44254,44043,28099,26534,32074
46399,100,229,28514,17885,5.87042e+18,126.254,2069.89,46399,90,97,45992,45636,24206,22546,26257
5136,77,100,3161,1975,5.86603e+18,52.1632,553.125,5136,56,55,5036,5036,4215,4408,4350
21392,166,214,13126,8266,5.87091e+18,130.284,1417.94,21392,81,85,21178,21133,17416,19181,17248
2644,166,191,1672,972,5.89623e+18,118.487,611.72,2644,71,67,2453,2426,2275,2275,2329
26186,20,248,16099,10087,5.8695e+18,131.274,1615.68,26186,82,85,20588,15669,3591,5499,1743
60495,129,300,37400,23095,5.87106e+18,187.497,2659.3,60495,100,111,60084,59803,36851,31939,32482
76903,36,285,47916,28987,5.88062e+18,239.087,3450.68,76903,183,185,64680,54084,10678,18388,10690
61384,18,269,37855,23529,5.87002e+18,144.496,2547.45,61384,94,103,44788,29443,7897,8647,6709
40810,92,272,25213,15597,5.87493e+18,221.773,2350.92,40810,136,137,39455,38075,15309,17152,15333
58021,111,238,35855,22166,5.87051e+18,115.937,2409.83,58021,94,103,57681,57351,30323,27737,29735
49705,21,328,30817,18888,5.87524e+18,146.504,2892.55,49705,126,124,36284,25807,6048,10490,6394
86380,278,281,53257,33123,5.87266e+18,213.882,3262.39,86380,154,164,86099,86099,85961,86073,86099
68800,283,288,42448,26352,5.87017e+18,134.507,2800.08,68800,101,105,68512,68512,68510,68509,68510
26162,206,252,16118,10044,5.87197e+18,166.1,1712.49,26162,97,98,25909,25798,24542,25132,24899
86467,46,294,53378,33089,5.8703e+18,165.001,3037.57,86467,112,113,83010,79578,17359,26986,23710
16745,23,214,10284,6461,5.87142e+18,95.8304,1264.88,16745,78,81,13769,10765,2277,3938,2953
3053,15,71,1876,1177,5.86873e+18,52.889,398.058,3053,50,52,1900,1075,489,609,813
73081,52,271,45505,27576,5.88456e+18,223.844,3412.97,73081,195,189,63634,57422,12944,21726,16706
70568,235,270,43706,26862,5.87011e+18,228.346,3142.59,70568,128,133,70248,70026,63808,67236,67350
72821,8,426,45485,27336,5.88455e+18,214.139,4235.75,72821,186,195,27233,0,3100,5299,2158
58800,677,3622,37112,21688,5.85595e+18,228.878,6983.97,58800,261,211,55178,54488,11187,28054,1098
18194,200,251,11182,7012,5.87412e+18,114.788,1454.43,18194,86,85,17943,17891,17190,17457,17229
58147,87,266,35799,22348,5.87097e+18,160.245,2472.99,58147,111,121,57201,56317,21164,25924,24722
99201,53,286,61440,37761,5.87757e+18,226.149,3820.41,99201,196,182,90942,85131,18364,30425,20936
70115,39,215,43226,26889,5.87013e+18,139.153,2696.24,70115,91,95,65435,59539,13637,21958,17507
17414,29,213,10781,6633,5.8709e+18,101.063,1277.07,17414,73,81,15224,12721,3242,5085,4568
44612,69,221,27416,17196,5.87065e+18,160.161,2040.97,44612,96,106,43702,43020,13361,17128,18241
59838,73,285,37270,22568,5.87927e+18,233.398,3035.17,59838,174,160,56141,52691,13483,20944,18037
69041,105,273,42735,26306,5.87096e+18,159.223,2683.59,69041,113,124,68286,67523,31871,32777,38394
14675,136,167,9065,5610,5.86925e+18,84.6385,1206.54,14675,74,73,14508,14481,13134,13812,13082
3498,1,61,2178,1320,5.87369e+18,52.9646,406.415,3498,48,50,0,0,0,0,0
41351,18,175,25537,15814,5.87e+18,80.5127,2046.93,41351,83,84,28740,17862,5881,6581,6973
70241,2204,5113,44289,25952,5.82591e+18,345.979,10095.1,70241,324,247,65128,64861,39027,43130,9438
23967,69,160,14747,9220,5.86949e+18,72.8435,1443.44,23967,76,77,23716,23438,17794,18542,18732
63979,202,216,39468,24511,5.87015e+18,131.883,2587.07,63979,92,94,63763,63760,63348,63642,63723
79288,124,277,49031,30257,5.87084e+18,152.835,2970.61,79288,120,121,78716,78102,37600,35566,32739
57748,136,265,35544,22204,5.87041e+18,162.545,2470.99,57748,115,118,57264,56892,31606,30387,30468
59941,206,252,37068,22873,5.87035e+18,156.353,2409.77,59941,108,112,59676,59586,50259,55769,51679
76702,170,271,47461,29241,5.87015e+18,197.536,3185.69,76702,115,117,76259,75866,53191,47987,62303
93286,30,232,57547,35739,5.87015e+18,145.591,3145.88,93286,94,101,80610,64134,14959,23106,15490
26048,54,279,16454,9594,5.90182e+18,204.432,2180.12,26048,165,164,20091,15352,4421,6005,2098
80777,145,282,49711,31066,5.87423e+18,214.933,3178.87,80777,157,162,79871,79145,48367,42968,51779
35065,143,158,21661,13404,5.87028e+18,90.8881,1788.23,35065,80,81,34907,34905,33554,34369,33752
40334,182,226,24952,15382,5.86966e+18,128.636,1920.4,40334,86,94,40108,40044,34010,37656,37236
44446,116,173,27485,16961,5.87018e+18,109.374,2054.1,44446,84,83,44251,44180,37687,38210,41209
45266,152,262,28228,17038,5.8811e+18,204.563,2592.1,45266,167,156,44432,43471,28529,26807,28327
56994,118,274,35162,21832,5.87338e+18,197.463,2676.54,56994,141,141,55964,54856,28705,28787,32331
26160,216,275,16078,10082,5.873e+18,188.592,1761.47,26160,94,102,25869,25809,24282,24787,24855
16717,207,216,10334,6383,5.86978e+18,104.599,1265.76,16717,76,81,16501,16501,16367,16450,16494
17181,47,187,10615,6566,5.86997e+18,82.3817,1396.07,17181,80,79,16152,14830,6682,6961,7316
79476,110,281,49417,30059,5.88238e+18,208.635,3541.75,79476,195,183,76432,72772,34522,34592,35659
10005,5,245,6265,3740,5.88019e+18,91.5732,1223.36,10005,92,87,2715,0,54,450,531
35195,126,180,21689,13506,5.87002e+18,103.4,1867.95,35195,79,83,35011,34926,30913,30456,32323
28579,225,261,17913,10666,5.8921e+18,213.78,2214.07,28579,161,156,28295,28180,25474,26577,26623
71499,5,202,44077,27422,5.87017e+18,124.239,2655.65,71499,89,98,20635,0,483,3264,2334
35656,21,426,22360,13296,5.88951e+18,192.237,3090.11,35656,161,166,21380,12298,3488,5016,1979
97328,60,274,60114,37214,5.87476e+18,237.11,3563.72,97328,176,176,92115,87960,20155,33851,25413
33078,49,261,20345,12733,5.87207e+18,133.629,1905.57,33078,99,102,31605,30344,8377,11286,8811
56647,35,299,34906,21741,5.87099e+18,154.89,2649.65,56647,108,115,51141,44218,10627,16893,10901
80431,56,316,49908,30523,5.87945e+18,239.111,3680.7,80431,181,192,73229,67632,16569,26260,14647
14040,110,181,8671,5369,5.86967e+18,78.9323,1231.17,14040,80,76,13859,13843,11910,11798,10420
69272,199,276,42909,26363,5.87248e+18,208.7,2836.5,69272,140,144,68883,68495,53582,60074,55270
72696,51,296,44765,27931,5.8706e+18,153.72,2903.35,72696,118,122,69973,67288,18582,25171,24977
82063,28,271,50805,31258,5.87152e+18,191.335,2984.09,82063,132,142,70807,58253,10478,20321,11672
11418,51,243,7084,4334,5.86942e+18,99.9737,1234.78,11418,80,84,10604,9770,2990,3455,3093
96884,85,319,59865,37019,5.87077e+18,218.298,3424.47,96884,125,135,95519,94325,23560,36004,34694
17851,66,249,11141,6710,5.88196e+18,184.292,1611.48,17851,130,113,16277,14854,4275,6345,5505
80661,76,342,50160,30501,5.8816e+18,168.28,3982.96,80661,171,181,75894,70776,29490,32285,31962
50485,134,260,31563,18922,5.88891e+18,232.917,2888.53,50485,181,182,48791,46729,25964,24517,26518
2818,85,126,1734,1084,5.86522e+18,55.0248,468.65,2818,49,49,2692,2658,2069,2135,1878
96844,289,302,59829,37015,5.87082e+18,158.387,3383.38,96844,116,129,96542,96521,91105,94898,93806
7147,28,75,4399,2748,5.86964e+18,58.7785,620.455,7147,59,61,6017,4554,2472,2839,3498
32722,184,226,20235,12487,5.86999e+18,126.56,1745.55,32722,85,93,32496,32469,27262,30333,27888
85365,247,269,52671,32694,5.87006e+18,148.005,2988.54,85365,103,110,85096,85080,80346,83120,84944
91292,110,232,56329,34963,5.87026e+18,134.469,3111.57,91292,93,98,90912,90577,57069,54773,65295
11834,87,235,7361,4473,5.87946e+18,122.991,1262.8,11834,98,90,11204,10598,5041,4924,4411
55063,52,258,34008,21055,5.87043e+18,136.6,2421.36,55063,94,96,53481,51443,15329,21577,21420
45133,63,411,28039,17094,5.88162e+18,193.633,3261.89,45133,165,165,40992,36995,13196,15972,12057
45421,120,196,28072,17349,5.87016e+18,103.123,2189.8,45421,84,85,45208,45113,32663,30975,30234
76857,140,301,47367,29490,5.87063e+18,157.823,2981.1,76857,118,129,76355,76019,38110,37333,33345
27047,185,274,16710,10337,5.87489e+18,140.421,1936.86,27047,110,111,26723,26591,23204,23233,22514
76076,181,273,47210,28866,5.87438e+18,234.478,3120.51,76076,160,162,75480,74857,53292,54801,59820
45530,21,221,27976,17554,5.8706e+18,159.929,2058.5,45530,97,104,36418,28135,4624,8948,6482
12547,188,249,7841,4706,5.87962e+18,177.525,1360.99,12547,107,102,12267,12129,10156,10908,10611
51297,222,273,31837,19460,5.87473e+18,219.5,2615.59,51297,141,148,50976,50771,42189,46907,40932
6791,56,109,4172,2619,5.8698e+18,57.7868,697.197,6791,56,56,6653,6596,3829,3496,4294
98273,160,273,60973,37300,5.87477e+18,235.35,3575.54,98273,176,174,97243,96323,61501,53308,56845
46738,283,397,28988,17750,5.87397e+18,167.469,3039.38,46738,143,137,46341,46247,41374,42105,37100
15906,84,126,9790,6116,5.87007e+18,65.6318,1129.59,15906,67,70,15780,15779,11738,11607,9436
53265,215,250,32960,20305,5.86972e+18,131.599,2600.48,53265,99,100,53009,52950,51452,52318,52600
12110,78,244,7443,4667,5.8702e+18,96.2956,1143.06,12110,75,75,11762,11567,4241,5000,2705
70202,128,289,43195,27007,5.87043e+18,141.985,2793.98,70202,100,108,69841,69497,37734,34335,38732
26536,113,256,16435,10101,5.8713e+18,138.926,1729.06,26536,97,96,26083,25676,17250,18193,20063
60305,76,235,37267,23038,5.87026e+18,130.373,2389.92,60305,96,105,59508,58964,21623,24676,26174
44376,98,199,27408,16968,5.87043e+18,126.293,2104.85,44376,83,87,44053,43849,26744,24847,27925
82416,134,285,51429,30987,5.88259e+18,248.445,3658.26,82416,193,194,80400,77994,40327,36900,43173
81935,273,278,50613,31322,5.87964e+18,232.377,3442.31,81935,191,180,81657,81646,80914,81347,81657
79511,284,291,50002,29509,5.8948e+18,232.962,3790.69,79511,206,202,79220,79216,79037,79125,79080
85780,218,328,53122,32658,5.87346e+18,206.202,3518.94,85780,146,140,85443,85316,78062,80611,80520
23234,145,171,14333,8901,5.87025e+18,82.8643,1529.49,23234,78,79,23063,23045,21476,22412,21596
20449,25,153,12648,7801,5.87012e+18,67.2615,1375.97,20449,73,73,16244,11443,4393,6107,4638
79409,271,274,49186,30223,5.87216e+18,197.158,3006.45,79409,141,145,79135,79135,78007,78866,79092
70403,235,273,43583,26820,5.87093e+18,160.835,2706.21,70403,118,125,70130,70076,59722,65734,64234
27279,1547,10969,17262,10017,5.51714e+18,707.884,14172.5,27279,759,261,16310,15150,2749,3530,880
94992,230,273,58951,36041,5.87438e+18,231.138,3477.25,94992,176,171,94637,94339,79812,87717,86355
71022,68,268,43969,27053,5.87182e+18,199.715,2811.67,71022,136,140,68825,66952,16341,25698,22140
65557,41,309,40662,24895,5.879e+18,183.406,3329.4,65557,172,176,57024,48441,15151,20023,14754
38267,45,326,23736,14531,5.87677e+18,125.929,2611.22,38267,125,120,34670,30818,9078,12524,12071
73309,279,285,45617,27692,5.87941e+18,224.294,3324.46,73309,180,183,73024,72999,71077,72408,72516
58953,179,259,36336,22617,5.86988e+18,119.309,2509.37,58953,99,101,58694,58636,45125,51271,41598
18322,97,230,11485,6837,5.89236e+18,173.194,1694.74,18322,141,131,16975,15401,8068,7809,8583
43687,280,296,26949,16738,5.87152e+18,123.325,2333.4,43687,95,94,43391,43374,42770,43133,42911
90409,142,285,55712,34697,5.87024e+18,145.202,3143.85,90409,105,109,90072,89822,52848,47336,52769
24104,154,258,15005,9099,5.87754e+18,176.11,1817.68,24104,120,123,23627,23294,16591,15844,16366
12739,93,154,7823,4916,5.87122e+18,94.0396,1027.01,12739,66,70,12563,12456,9581,9223,9871
16508,205,342,10176,6332,5.86972e+18,114.435,1583.61,16508,88,89,16166,16084,11621,10613,10820
45691,73,260,28229,17462,5.86992e+18,176.439,2411.56,45691,94,98,44962,44267,15671,15244,13697
24627,153,272,15224,9403,5.87617e+18,149.52,1870.44,24627,117,112,24245,23998,20210,19966,20084
70187,147,222,43365,26822,5.87019e+18,122.266,2774.46,70187,90,90,69956,69832,57471,61462,60027
38180,35,257,23612,14568,5.87031e+18,123.715,2114.14,38180,87,89,34319,29272,6996,8429,6246
20108,170,250,12448,7660,5.86975e+18,127.949,1667.75,20108,92,92,19834,19683,17541,17698,18103
93341,30,426,58286,35055,5.88429e+18,203.194,4731.99,93341,190,202,69888,48944,14595,20943,13172
56029,102,338,35041,20988,5.8871e+18,175.658,3404.62,56029,173,177,53221,49961,26591,26559,23618
82297,161,313,50943,31354,5.87293e+18,191.799,3396.08,82297,149,152,81564,81039,52421,49822,49795
63087,62,285,39295,23792,5.87967e+18,194.421,3121.95,63087,173,171,58218,53916,15369,23100,16049
19861,3,263,12431,7430,5.88932e+18,162.67,1874.31,19861,139,137,2858,0,64,220,197
49598,147,264,30708,18890,5.87144e+18,186.776,2319.34,49598,117,117,49116,48811,30523,29915,32077
31781,3,297,19652,12129,5.87158e+18,123.024,2027.52,31781,100,96,5462,0,195,537,367
53897,53,200,33218,20679,5.87035e+18,125.639,2322.63,53897,89,92,52577,50534,15383,19811,19040
61467,203,271,38032,23435,5.87029e+18,194.114,2852.92,61467,107,109,61156,61043,49375,54838,49609
35722,103,197,21981,13741,5.86995e+18,112.261,1883.52,35722,85,84,35480,35335,26150,25511,27410
25719,183,268,15893,9826,5.87923e+18,178.44,1924.95,25719,126,128,25366,25117,18288,19327,16907
57736,85,194,35640,22096,5.86999e+18,130.874,2437.19,57736,86,90,57348,57175,29322,27120,34576
28167,61,154,17326,10841,5.86958e+18,89.5115,1586.07,28167,73,77,27787,27535,12331,12523,14415
20182,33,248,12435,7747,5.87157e+18,131.878,1496.19,20182,93,90,17965,15527,3021,5328,1452
19008,131,271,11837,7171,5.87919e+18,129.763,1690.78,19008,113,108,18517,18117,12711,12850,12095
5794,4,109,3579,2215,5.86992e+18,52.494,656.289,5794,58,60,1345,0,6,262,248
49017,2752,8706,30812,18205,5.701e+18,593.839,13750.1,49017,552,287,40311,40153,16955,20875,2850
99519,228,316,61303,38216,5.87278e+18,224.411,3663.37,99519,148,151,99174,98986,87059,91727,88970
76801,252,260,47485,29316,5.8701e+18,147.816,3094.41,76801,107,107,76541,76539,76532,76535,76541
86484,174,303,53398,33086,5.87086e+18,160.84,3194.42,86484,115,129,86070,85812,66378,61927,68032
69109,36,391,42765,26344,5.87023e+18,157.977,3126.15,69109,106,105,61567,53154,14392,20225,16490
73293,404,426,45894,27399,5.88741e+18,220.223,4261.01,73293,190,201,72867,72841,71814,72466,67988
93876,275,322,57871,36005,5.87059e+18,219.429,3358.21,93876,128,130,93554,93506,81759,88406,87041
42581,61,262,26217,16364,5.8716e+18,166.588,2156.79,42581,107,115,41207,40182,10252,16043,13391
4405,23,211,2758,1647,5.88662e+18,140.277,806.325,4405,81,79,2914,1902,495,877,594
49554,62,197,30531,19023,5.86973e+18,121.232,2201.74,49554,90,93,48791,48210,18755,20469,23454
51276,211,275,31653,19623,5.87803e+18,229.564,2690.26,51276,154,158,50888,50596,41515,45372,41858
80142,287,303,49490,30652,5.87103e+18,156.112,3085.03,80142,114,124,79839,79822,76425,78547,77672
18870,39,187,11659,7211,5.87013e+18,82.7727,1462.56,18870,80,80,17081,15106,5736,6481,6741
80590,72,215,49716,30874,5.87015e+18,132.284,2913.73,80590,90,93,79927,79372,33470,34028,40605
26008,257,268,16071,9937,5.8788e+18,176.372,1933.23,26008,126,128,25740,25731,25148,25442,25321
2128,8,62,1301,827,5.87404e+18,44.7039,315.162,2128,45,46,899,0,151,230,375
92965,72,301,57229,35736,5.87106e+18,203.827,3297.72,92965,128,128,91236,89970,24128,34514,34826
97680,68,228,60221,37459,5.87021e+18,142.446,3159.44,97680,98,103,96599,95648,34422,40256,45489
48146,24,275,29656,18490,5.87508e+18,195.867,2493.28,48146,136,135,38927,30016,5122,10826,6130
40780,218,257,25186,15594,5.87034e+18,117.02,2114.13,40780,86,88,40523,40471,38834,39843,39728
43496,26,271,27073,16423,5.88366e+18,212.717,2625.71,43496,165,164,32505,23188,5495,9913,4772
53560,225,265,33127,20433,5.87114e+18,166.561,2382.42,53560,115,121,53291,53215,45993,50196,49750
42381,11,270,26257,16124,5.87006e+18,193.583,2401.51,42381,106,105,21379,13418,3673,4653,1991
17361,144,276,10728,6633,5.87323e+18,88.1764,1519.31,17361,94,87,17069,17020,13421,13315,13162
66292,121,290,41557,24735,5.89137e+18,234.377,3442,66292,198,196,63304,59041,27538,27263,29676
35206,167,262,21873,13333,5.88154e+18,202.323,2280.55,35206,151,151,34658,34044,24180,24257,24982
57286,154,304,35355,21931,5.87479e+18,194.965,2889.89,57286,144,143,56605,56134,34465,31517,31908
25242,69,146,15643,9599,5.87052e+18,69.5444,1513.92,25242,77,76,25043,24727,19227,19653,18714
83872,256,275,51693,32179,5.87669e+18,223.898,3346.14,83872,177,172,83583,83460,77059,80502,81395
94049,241,381,58180,35869,5.87067e+18,175.21,3654.53,94049,134,136,93662,93512,72671,67480,70927
30579,74,285,19004,11575,5.87796e+18,190.51,2170.57,30579,130,121,29039,27501,9178,11375,14311
27157,194,257,16776,10381,5.86987e+18,147.307,1936.96,27157,97,95,26873,26746,25522,26131,26393
20747,53,219,12775,7972,5.86928e+18,101.321,1367.78,20747,78,86,20079,19584,5270,7474,6469
29920,44,187,18483,11437,5.86992e+18,95.5715,1687.56,29920,81,84,28500,26639,9521,11521,11693
29628,30,226,18316,11312,5.87044e+18,164.505,1677.01,29628,93,95,26207,22712,4467,7765,6495
88265,68,342,54850,33415,5.88071e+18,182.067,4109.76,88265,176,182,82432,76228,25944,31746,30689
35763,80,273,22226,13537,5.87463e+18,210.508,2203.52,35763,130,131,34368,33132,10936,14934,15809
69576,242,281,43147,26429,5.87908e+18,200.818,3226.61,69576,181,177,69279,69138,60028,65326,63675
51130,252,300,31525,19605,5.87102e+18,138.88,2523.27,51130,102,105,50830,50750,46633,49039,47770
52321,208,286,32440,19881,5.87881e+18,218.979,2846.14,52321,169,155,51945,51622,41935,45465,43659
64598,60,317,40512,24086,5.89102e+18,210.549,3549.74,64598,190,198,55199,46393,15372,20767,13666
55741,230,252,34512,21229,5.87011e+18,161.253,2662.48,55741,100,101,55489,55430,55323,55382,55424
24890,95,254,15325,9565,5.87181e+18,165.776,1682.4,24890,91,101,24354,23939,13257,12539,17059
38133,153,273,23663,14470,5.8755e+18,167.405,2270.62,38133,129,132,37609,37220,24588,21958,20636
9828,147,250,6147,3681,5.88592e+18,150.058,1231.1,9828,103,96,9492,9284,6036,5551,5092
53617,160,272,33081,20536,5.87351e+18,193.978,2598.95,53617,143,142,53042,52612,36711,36113,41140
7759,95,224,4861,2898,5.88566e+18,157.179,1075.94,7759,96,92,7127,6515,3600,3493,4191
59592,118,217,36678,22914,5.87011e+18,131.526,2495.38,59592,89,96,59302,59060,36785,32434,36410
73300,193,232,45296,28004,5.86981e+18,153.726,2887.92,73300,97,96,73068,73012,70564,71927,72325
87679,254,302,54048,33631,5.8705e+18,161.444,3209.93,87679,118,127,87377,87295,78210,83487,80562
95208,301,397,58974,36234,5.87214e+18,168.715,3992.49,95208,150,147,94811,94704,88059,90462,82862
80547,61,217,49673,30874,5.8704e+18,138.468,2876.74,80547,90,100,79367,78204,24231,30760,33426
64484,163,411,40053,24431,5.87575e+18,178.101,3679.82,64484,153,146,63839,63248,50107,50571,50194
6450,171,188,3962,2488,5.86812e+18,73.9628,771.221,6450,63,66,6262,6262,6256,6259,6248
30606,159,219,18918,11688,5.86994e+18,125.551,1661.93,30606,85,91,30368,30266,25706,27389,29173
80970,216,328,50171,30799,5.87364e+18,191.896,3471.17,80970,141,136,80636,80476,73996,75372,75197
36351,64,260,22783,13568,5.89071e+18,216.44,2474.55,36351,175,166,31421,26613,7483,11568,10417
79315,167,306,49999,29316,5.89752e+18,232.776,3815.5,79315,207,200,78148,76175,47869,47519,55319
54172,187,257,33513,20659,5.87005e+18,132.004,2613.1,54172,100,99,53868,53679,50724,50133,52808
71991,247,397,44609,27382,5.87367e+18,211.921,3462.99,71991,152,160,71568,71411,49095,44932,39463
45069,128,266,27710,17359,5.8716e+18,176.213,2212.28,45069,108,117,44536,44156,26958,26634,30728
14809,25,202,9099,5710,5.8703e+18,97.1517,1181.72,14809,73,77,12419,9685,2591,3439,3180
91867,247,352,56623,35244,5.87017e+18,166.978,3416.95,91867,119,120,91515,91345,72752,79679,76463
17246,87,267,10657,6589,5.87377e+18,76.1626,1464.51,17246,90,85,16833,16595,15874,15830,15415
44656,179,183,27525,17131,5.87009e+18,101.624,2130.48,44656,80,84,44473,44471,44472,44473,44459
99566,101,302,61391,38175,5.87052e+18,167.674,3402.73,99566,120,130,98613,97665,46264,48592,56822
53798,44,316,33198,20600,5.87267e+18,145.667,2799.22,53798,122,116,50137,45884,11446,17425,15554
59406,7,260,36630,22776,5.87054e+18,137.385,2517.16,59406,98,101,23500,0,3084,4347,2642
93858,223,308,57827,36031,5.87298e+18,195.029,3540.93,93858,154,155,93489,93257,72886,80225,67112
48232,142,190,29728,18504,5.86997e+18,109.843,2116.05,48232,85,93,48042,47976,39888,43602,42701
19266,168,270,11926,7340,5.87639e+18,143.145,1699.79,19266,107,103,18936,18772,16514,16316,15878
51665,101,281,32100,19565,5.88107e+18,212.623,2859.77,51665,173,173,49296,46749,19949,21660,16301
77877,110,227,48086,29791,5.86988e+18,137.8,2883.42,77877,93,98,77517,77196,42651,38842,41185
97261,293,309,60238,37023,5.87279e+18,198.887,3589.13,97261,155,161,96952,96939,91129,94539,94481
93929,178,256,58057,35872,5.87021e+18,156.29,3377.23,93929,107,109,93601,93370,81825,82080,89196
95469,10,261,59012,36457,5.87006e+18,167.993,3407.8,95469,108,106,47042,31510,7904,8302,4676
99359,160,286,61541,37818,5.87797e+18,230.605,3823.95,99359,197,191,98129,96821,61008,54080,61974
57529,249,307,35677,21852,5.88026e+18,226.567,3106.31,57529,167,168,57208,57068,52008,53368,54964
80897,130,298,49839,31058,5.87061e+18,161.94,3092.7,80897,119,125,80303,79824,48949,50976,51248
16316,191,211,10080,6236,5.87091e+18,100.635,1214.35,16316,75,80,16105,16098,15141,15578,15958
52103,250,270,32242,19861,5.87035e+18,178.74,2677.25,52103,113,116,51833,51812,51720,51772,51615
73107,263,294,45156,27951,5.87052e+18,165.312,2820.86,73107,105,111,72813,72807,71864,72432,72444
48602,45,247,30054,18548,5.87015e+18,136.466,2486.62,48602,97,97,45461,41517,15259,16887,17265
75901,23,279,46708,29193,5.87404e+18,198.598,3076.47,75901,152,157,60996,47001,8273,16490,10154
98805,249,342,61598,37207,5.88386e+18,198.827,4423.66,98805,191,203,98442,98269,81813,84885,76913
90376,256,318,55846,34530,5.87075e+18,212.205,3330.61,90376,125,132,90058,89986,74421,83744,75884
48227,7285,10765,30297,17930,5.6793e+18,617.314,15771.1,48227,734,290,37462,37430,31762,32562,17022
96082,251,279,59335,36747,5.87022e+18,151.707,3426.62,96082,111,115,95803,95751,91660,93202,91593
93679,203,307,57689,35990,5.87292e+18,205.329,3534,93679,161,159,93216,92784,64890,63316,61860
3857,37,76,2377,1480,5.86754e+18,59.2066,468.182,3857,54,55,3498,3104,1790,1800,2055
84871,247,327,52604,32267,5.87493e+18,198.681,3687.42,84871,160,155,84544,84410,80199,80744,78772
70330,96,273,43515,26815,5.87078e+18,159.739,2738.35,70330,120,119,69469,68574,25406,28514,21286
68385,75,290,42853,25532,5.89128e+18,237.214,3505.84,68385,197,204,60793,52373,15164,23039,17692
60946,254,274,37612,23334,5.87342e+18,208.4,2785.69,60946,152,144,60667,60556,55372,58467,59961
63372,114,381,39182,24190,5.87087e+18,147.569,3148.17,63372,123,117,62594,61919,39955,40451,39912
2932,75,112,1796,1136,5.86716e+18,46.9918,462.019,2932,47,45,2820,2805,2143,2064,1953
14323,44,249,8920,5403,5.88021e+18,159.541,1441.68,14323,112,112,12404,10707,3032,4670,4185
57832,73,275,35655,22177,5.87734e+18,219.538,2786.41,57832,157,152,55101,52903,13026,20490,16756
59385,186,426,37163,22222,5.88626e+18,192.678,3886.31,59385,178,187,58755,58195,38035,37562,31372
68195,174,300,42158,26037,5.87082e+18,162.205,2847.15,68195,114,124,67789,67549,48039,43796,47922
90121,181,322,55579,34542,5.87061e+18,209.57,3327.37,90121,127,130,89691,89367,58911,50984,52470
67932,249,335,42481,25451,5.88676e+18,193.525,3703.95,67932,182,190,67585,67447,56744,57859,51222
22749,34,292,14214,8535,5.88509e+18,135.409,2065.32,22749,134,134,17535,12232,5559,6268,5937
78341,195,274,48367,29974,5.87402e+18,238.093,3187.31,78341,166,160,77819,77272,58653,65527,59879
23503,90,153,14514,8989,5.86998e+18,88.1977,1438.89,23503,75,75,23303,23228,16353,15504,17055
19067,120,244,12049,7018,5.90001e+18,188.201,1804.07,19067,152,142,17884,16304,10231,9536,11425
32490,130,200,20112,12378,5.87007e+18,113.44,1874.08,32490,79,83,32289,32219,26593,26446,26503
82186,146,235,50775,31411,5.87e+18,147.401,3050.36,82186,96,93,81913,81681,64700,67501,68907
32595,94,275,20110,12485,5.87606e+18,189.767,2105.13,32595,120,123,31561,30617,14197,13923,15000
78114,200,241,48121,29993,5.87005e+18,138.77,2831.6,78114,105,112,77856,77775,66840,73161,70413
22429,232,306,13879,8550,5.87347e+18,95.2437,1836.81,22429,99,96,22123,22081,21361,21425,20925
68600,38,222,42412,26188,5.87002e+18,130.145,2748.95,68600,91,91,62867,56568,15121,21365,18163
39732,65,184,24470,15262,5.87008e+18,117.534,1981.56,39732,81,83,39216,38797,16407,17580,18242
59380,61,326,36755,22625,5.8734e+18,149.491,2938.82,59380,121,115,57536,55852,18120,22422,24234
79774,12,279,49061,30713,5.87113e+18,151.532,2961.37,79774,116,125,47635,29647,7902,9914,4653
89897,104,227,55478,34419,5.87011e+18,141.656,3089.09,89897,93,100,89476,89119,51576,49978,61459
71048,86,273,43752,27296,5.8706e+18,159.708,2746.74,71048,119,122,69980,68982,20216,29006,26556
75911,135,294,46939,28972,5.87084e+18,150.082,2952.39,75911,115,125,75390,74943,44031,43335,42602
40561,355,381,25105,15456,5.8717e+18,185.741,2488.63,40561,117,122,40180,40160,37140,38442,36978
14770,49,149,9063,5707,5.86981e+18,83.2566,1070.32,14770,68,70,14334,13974,5225,5887,6505
84103,144,352,51831,32272,5.87041e+18,169.763,3262.83,84103,116,118,83595,83199,43648,41610,53119
10932,17,215,6919,4013,5.90797e+18,167.64,1301.12,10932,132,121,4916,1206,521,855,1029
81781,195,275,50378,31403,5.87519e+18,237.148,3236.47,81781,161,160,81244,80648,61109,66820,62239
27066,273,290,16707,10359,5.87172e+18,99.4488,1872.77,27066,91,88,26776,26763,26285,26581,26292
58363,84,224,36099,22264,5.87008e+18,139.184,2509.65,58363,86,90,57953,57779,26069,24866,27809
65517,110,203,40398,25119,5.87025e+18,120.969,2579.11,65517,90,92,65218,64981,42529,40741,47313
94349,247,282,58168,36181,5.87282e+18,204.422,3382.11,94349,154,161,94046,93937,79766,88184,85749
62837,180,274,38789,24048,5.87405e+18,209.724,2838.96,62837,141,151,62298,61822,44014,41441,43737
27882,250,258,17195,10687,5.87932e+18,193.924,1946.27,27882,132,130,27624,27613,27312,27442,27483
63672,40,285,39669,24003,5.87956e+18,233.031,3143.88,63672,179,172,55029,46679,10288,16313,10870
98177,114,238,60701,37476,5.87015e+18,153.347,3303.44,98177,96,103,97768,97464,63207,58722,68676
84470,240,286,52526,31944,5.882e+18,245.367,3701.69,84470,195,193,84130,83888,73798,79496,79122
16586,8,342,10239,6347,5.87035e+18,129.045,1660.58,16586,93,89,7241,0,1047,1630,497
1642,15,83,1005,637,5.86333e+18,41.5591,304.521,1642,36,36,1229,773,268,345,326
81796,255,271,50633,31163,5.87133e+18,192.293,2982.9,81796,134,144,81525,81510,76872,79399,80427
22556,181,239,13887,8669,5.87091e+18,112.086,1490.17,22556,90,88,22317,22283,19212,20696,20199
55078,45,285,34322,20756,5.88039e+18,229.277,2950.39,55078,169,165,48534,42459,10043,14863,10894
56804,181,273,35242,21562,5.87484e+18,219.786,2720.5,56804,145,148,56302,55826,37569,36364,35963
96657,110,274,59737,36920,5.87555e+18,240.543,3610.45,96657,188,177,94251,91568,43065,42718,41440
84112,223,289,51820,32292,5.87047e+18,146.513,3053.93,84112,102,109,83823,83758,73109,79256,80364
31206,111,259,19347,11859,5.86969e+18,129.694,2037.58,31206,94,99,30762,30473,18204,16153,19758
83651,213,227,51628,32023,5.87021e+18,137.027,3006.94,83651,91,94,83424,83422,83412,83345,83424
33111,152,155,20449,12662,5.87015e+18,89.3833,1741.76,33111,79,79,32956,32956,32921,32928,32935
25106,140,278,15529,9577,5.87047e+18,181.256,1681.9,25106,88,98,24730,24600,17135,16588,18246
12421,203,265,7766,4655,5.8811e+18,125.214,1406.03,12421,101,96,12152,12088,10821,10978,10292
45970,46,266,28496,17474,5.87871e+18,200.884,2552.66,45970,162,152,40874,36405,7893,13490,8593
20957,200,216,12891,8066,5.86977e+18,102.632,1370.29,20957,78,84,20741,20732,20135,20194,20587
42990,34,310,26618,16372,5.87468e+18,158.868,2564.49,42990,128,131,37037,30044,7318,12082,5533
5075,140,221,3136,1939,5.87602e+18,77.1823,796.597,5075,65,64,4831,4787,3962,4018,4092
67228,246,268,41377,25851,5.87057e+18,165.184,2644.31,67228,117,122,66960,66938,59914,63768,63530
97682,178,300,60317,37365,5.87076e+18,190.069,3346.37,97682,128,127,97262,97006,76422,80476,85321
88629,83,271,54829,33800,5.8702e+18,235.584,3484.7,88629,133,126,87070,86048,34071,31653,37305
96504,118,397,59774,36730,5.87198e+18,190.051,4048.34,96504,145,142,95351,94180,55855,51468,52327
11462,79,142,7068,4394,5.869e+18,88.4819,985.773,11462,66,66,11274,11205,6508,6236,6429
8927,51,80,5551,3376,5.86838e+18,68.9134,729.659,8927,64,67,8581,7954,5724,5321,6683
43436,238,259,26778,16658,5.86987e+18,118.344,2169.22,43436,90,88,43177,43162,42473,42557,43007
42516,144,279,26473,16043,5.88359e+18,204.149,2644.93,42516,166,170,41515,40492,24919,23743,22761
53814,360,397,33349,20465,5.8735e+18,173,3157.04,53814,145,142,53417,53354,47764,51078,47314
80562,75,277,50285,30277,5.8831e+18,218.023,3578.33,80562,199,190,74376,68091,18542,27773,26417
99315,86,426,62131,37184,5.88635e+18,237.167,4708.99,99315,205,217,92039,83733,22753,33865,19511
16883,190,216,10448,6435,5.87e+18,100.293,1268.18,16883,75,75,16667,16651,16084,16462,16561
9270,208,232,5726,3544,5.8721e+18,114.216,1052.62,9270,84,77,9038,9014,8334,8729,8566
46693,209,211,28841,17852,5.86998e+18,122.062,2288.21,46693,87,90,46482,46482,46480,46482,46482
20579,208,253,12744,7835,5.87213e+18,131.001,1533.06,20579,87,92,20326,20275,19625,19858,19601
66264,116,266,40791,25473,5.8707e+18,189.323,2665.87,66264,123,125,65468,64587,33504,32955,33744
1537,48,75,949,588,5.86148e+18,57.2414,304.346,1537,45,45,1411,1298,975,883,1127
72328,191,268,44436,27892,5.8713e+18,178.09,2749.98,72328,122,128,71982,71716,55919,60666,58209
35987,70,173,22188,13799,5.86946e+18,105.783,1790.79,35987,79,85,35562,35307,16424,16993,18277
78486,207,281,48647,29839,5.87319e+18,212.328,3134.86,78486,152,157,78090,77690,60079,67354,56855
75935,160,274,46862,29073,5.8737e+18,235.709,3111.24,75935,156,159,75138,74473,47703,42438,47827
82944,207,286,51446,31498,5.87915e+18,235.393,3549.76,82944,189,183,82428,81795,64398,69646,68102
72155,179,328,44722,27433,5.87388e+18,195.549,3329.94,72155,136,132,71739,71504,56390,60978,59197
14016,9,224,8863,5153,5.90127e+18,171.086,1506.81,14016,141,127,4882,0,411,894,655
6795,54,134,4183,2612,5.86986e+18,74.1339,707.368,6795,56,60,6577,6455,3096,3388,3505
71359,293,352,43967,27392,5.87029e+18,171.556,3072.11,71359,110,116,71007,70933,60880,66664,65809
84404,178,231,52146,32258,5.87013e+18,129.548,2999.32,84404,94,96,84173,84146,75415,79579,76532
33977,246,310,21049,12928,5.87397e+18,119.252,2296.66,33977,115,105,33667,33594,31203,32119,30107
50951,216,267,31531,19420,5.87159e+18,186.186,2347.42,50951,111,123,50661,50510,44985,48224,46639
56273,27,210,34801,21472,5.87006e+18,118.579,2441.08,56273,87,87,46159,33664,9237,13889,9136
33601,89,263,20691,12910,5.87108e+18,169.196,1950.7,33601,105,109,32870,32234,12929,15468,13867
94430,67,302,58345,36085,5.87089e+18,143.34,3352.42,94430,116,128,92694,91116,28153,40229,35072
51842,82,264,32110,19732,5.87091e+18,161.702,2346.4,51842,111,119,50861,50057,16013,22717,23936
22960,41,217,14120,8840,5.8709e+18,158.207,1489.09,22960,85,92,21616,20051,4742,7059,6680
45075,43,189,27783,17292,5.86989e+18,111.338,2030.77,45075,82,91,43096,40199,9749,15157,13380
35000,118,180,21671,13329,5.87015e+18,111.805,1700.86,35000,81,86,34796,34620,25201,24732,27519
58554,226,260,36099,22455,5.86978e+18,134.568,2505.49,58554,95,99,58294,58251,54438,56644,56654
25214,34,158,15490,9724,5.87066e+18,101.398,1432.62,25214,76,83,23062,19891,5359,7529,7317
80864,122,232,49872,30992,5.87038e+18,132.505,2944.67,80864,93,98,80553,80291,50769,44746,47976
87582,246,294,53966,33616,5.87016e+18,165.645,3053.21,87582,111,116,87288,87276,84754,86222,86331
57834,45,234,35747,22087,5.87047e+18,121.322,2372.71,57834,94,102,55525,52967,12621,18888,17443
19096,140,164,11740,7356,5.86926e+18,105.31,1273.02,19096,71,78,18932,18908,16872,18088,17534
72394,70,275,44614,27780,5.87221e+18,206.648,2903.86,72394,144,142,70039,68265,16585,26371,18675
22650,88,219,14001,8649,5.87052e+18,127.936,1467,22650,82,87,22282,21998,10373,10627,11761
45163,242,258,27889,17274,5.87013e+18,123.755,2203.36,45163,91,90,44905,44903,44798,44829,44871
85741,257,303,52960,32781,5.87086e+18,156.607,3180.67,85741,117,128,85438,85365,75246,81252,77746
70596,148,279,43627,26969,5.87e+18,156.156,2983.01,70596,108,106,70163,69773,55199,53209,59653
69415,159,306,43023,26392,5.87886e+18,245.201,3311.54,69415,168,184,68408,67416,43837,38922,44167
53098,41,304,32794,20304,5.87494e+18,196.944,2812.96,53098,138,141,48147,42777,11698,16443,12818
13197,23,245,8339,4858,5.90138e+18,173.833,1464.79,13197,140,131,6901,2738,967,1459,1600
71760,189,274,44114,27646,5.87324e+18,204.656,2886.47,71760,143,144,71329,70894,52437,57876,53739
82118,161,215,50601,31517,5.87002e+18,139.732,2894.88,82118,94,100,81900,81758,72185,75905,78416
98094,69,327,60739,37355,5.87614e+18,183.888,4001.88,98094,175,182,93524,88952,28330,37391,30847
6497,186,254,4065,2432,5.89045e+18,107.794,1088.59,6497,87,94,6243,6223,5311,5196,4679
27567,2791,6097,17266,10301,5.61085e+18,849.682,9910.12,27567,302,282,21470,21360,16796,16924,14652
65678,224,250,40605,25073,5.8701e+18,140.56,2863.31,65678,105,104,65425,65344,63542,64659,65211
83237,219,273,51523,31714,5.87059e+18,163.202,2923.13,83237,121,130,82951,82853,70304,77481,72288
47932,111,266,29737,18195,5.87439e+18,214.275,2475.18,47932,140,136,46839,45638,22176,21001,20383
46853,79,192,28911,17942,5.8699e+18,118.598,2208.26,46853,85,85,46513,46392,23888,22476,24503
49405,101,227,30428,18977,5.87017e+18,120.514,2146.32,49405,92,102,49011,48654,25955,25364,27918
29273,53,165,18119,11154,5.87003e+18,111.854,1549.11,29273,77,83,28581,27812,8813,11240,12587
2769,38,80,1719,1050,5.86552e+18,63.2611,411.12,2769,50,53,2465,2204,1227,1213,1483
19477,143,162,11972,7505,5.87118e+18,101.308,1277.18,19477,70,77,19315,19308,17657,18438,18375
21590,171,204,13348,8242,5.87029e+18,102.903,1595.71,21590,83,84,21386,21355,20543,21040,20428
15478,25,182,9518,5960,5.86938e+18,87.4809,1232.15,15478,74,77,12772,9651,2562,3850,3186
73791,204,285,46039,27752,5.88221e+18,236.983,3448.6,73791,194,183,73309,72738,58014,62929,58324
7650,166,196,4687,2963,5.87264e+18,91.3974,841.995,7650,69,68,7454,7442,6996,7253,7234
58136,71,273,36097,22039,5.87437e+18,212.396,2724.01,58136,152,143,55716,53632,13176,21490,18484
12233,23,122,7526,4707,5.86937e+18,61.1281,979.348,12233,66,66,9578,6919,2160,3460,2530
52078,4,297,32185,19893,5.8708e+18,136.521,2475.91,52078,94,101,12126,0,16,1323,886
12673,119,140,7836,4837,5.8703e+18,86.577,1007.61,12673,63,65,12533,12490,11776,12195,12328
68831,168,219,42515,26316,5.87015e+18,130.2,2750.89,68831,91,91,68612,68547,62238,65466,64909
55152,40,268,34505,20647,5.88667e+18,217.183,2991.38,55152,193,180,44662,35062,8409,13259,9034
46898,5,226,29034,17864,5.87064e+18,128.743,2062.51,46898,91,99,14056,0,213,2473,1405
93753,164,227,57845,35908,5.87007e+18,138.685,3151.52,93753,93,100,93520,93391,77776,85906,80125
55161,153,257,34095,21066,5.87021e+18,141.233,2632.45,55161,102,102,54780,54433,41291,37784,43652
33957,343,426,21095,12862,5.87795e+18,147.183,2843.65,33957,135,124,33531,33507,32114,32238,30632
5934,73,131,3690,2244,5.87072e+18,58.0873,638.788,5934,56,57,5803,5790,3344,3031,1508
5314,42,239,3344,1970,5.88363e+18,105.207,930.615,5314,83,81,4314,3452,1612,1670,1231
23466,147,204,14480,8986,5.87082e+18,106.39,1649.63,23466,83,82,23262,23198,21639,22052,21305
37046,94,168,22891,14155,5.87005e+18,112.616,1784.75,37046,81,88,36756,36527,23396,21791,26150
67162,89,237,41524,25638,5.87049e+18,150.004,2524.41,67162,106,114,66424,65680,29409,29402,32740
33639,86,160,20688,12951,5.87029e+18,90.7375,1751.85,33639,78,80,33398,33282,19955,18405,22893
8489,111,126,5264,3225,5.86944e+18,62.8449,792.284,8489,59,62,8363,8357,7862,8140,8293
46981,97,254,28987,17994,5.87063e+18,121.324,2237.98,46981,95,96,46574,46259,27849,29698,29793
21095,184,272,13068,8027,5.87724e+18,140.934,1760.83,21095,106,105,20788,20652,18263,18210,17749
66378,168,267,41073,25305,5.8713e+18,182.596,2643.52,66378,119,126,65955,65625,47004,44911,47461
74953,65,262,46234,28719,5.87002e+18,130.631,2827.75,74953,99,104,73881,72961,21563,28778,28903
9656,20,134,5934,3722,5.86972e+18,64.7483,870.84,9656,61,64,7363,5365,1826,2477,2311
81001,79,276,49950,31051,5.87312e+18,213.267,3161.22,81001,147,154,78567,76421,21691,31509,27674
45239,20,202,27995,17244,5.87012e+18,106.125,2177.51,45239,85,85,32380,23043,7235,9339,7286
21913,143,175,13480,8433,5.86912e+18,106.582,1353.9,21913,75,79,21738,21678,20097,20948,20933
28608,85,217,17608,11000,5.87093e+18,164.866,1643.93,28608,92,92,28098,27670,11639,12659,13838
33122,185,197,20366,12756,5.87015e+18,113.306,1811.22,33122,79,82,32925,32916,32843,32901,32921
67516,119,242,41706,25810,5.87022e+18,126.303,2583.67,67516,97,105,67163,66823,38869,37252,46418
69690,184,294,43029,26661,5.87019e+18,164.85,2767.53,69690,106,108,69389,69239,55459,60336,55255
17051,99,129,10591,6460,5.86988e+18,67.928,1111.03,17051,71,72,16922,16913,16769,16722,16603
5174,32,86,3200,1974,5.86905e+18,69.1283,573.309,5174,63,65,4366,3178,1812,1793,2395
38550,177,265,23816,14734,5.87499e+18,179.142,2228.08,38550,131,132,38129,37734,27523,27937,29463
84900,289,294,53070,31830,5.88839e+18,241.652,3860.74,84900,203,207,84606,84604,84592,84594,84528
15906,100,143,9823,6083,5.87064e+18,82.6569,1153.65,15906,68,72,15747,15695,12604,13460,12670
9647,120,127,5977,3670,5.86854e+18,66.9452,838.13,9647,62,63,9520,9520,9285,9446,9500
1105,32,70,687,418,5.85799e+18,46.724,245.882,1105,42,41,918,663,472,495,631
25474,5,258,15781,9693,5.87826e+18,195.648,1885.57,25474,132,126,7376,0,231,1589,461
60155,67,270,37624,22531,5.8862e+18,231.03,3133.55,60155,193,187,53809,47480,12653,19926,17182
51091,252,273,31699,19392,5.87426e+18,198.908,2548.11,51091,142,140,50816,50731,46111,48875,49266
83666,125,282,51590,32076,5.87328e+18,205.388,3221.21,83666,154,151,82512,81164,39060,39488,34600
45969,59,266,28268,17701,5.87133e+18,167.01,2231.87,45969,110,116,44491,43382,12120,16634,15459
36462,18,173,22546,13916,5.87025e+18,99.1295,1885.18,36462,81,83,24917,15228,5064,7487,5504
29552,80,254,18197,11355,5.87117e+18,133.025,1780.58,29552,95,104,28815,28241,9506,12770,12756
4956,41,113,3046,1910,5.86647e+18,52.9883,591.99,4956,51,52,4745,4477,1898,1827,1908
13709,147,241,8468,5241,5.87133e+18,84.2104,1258.18,13709,78,77,13468,13414,11113,11041,10682
67735,92,202,41768,25967,5.87014e+18,125.42,2593.91,67735,88,96,67310,67011,37280,35056,44223
56717,230,254,34917,21800,5.87018e+18,119.272,2423.07,56717,99,100,56463,56447,53034,54266,54706
13182,91,139,8105,5077,5.87045e+18,84.1981,1028.71,13182,67,71,13020,12965,9977,9728,9934
96591,267,285,60068,36523,5.87889e+18,234.399,3778.41,96591,190,191,96306,96203,90190,93460,95324
29302,27,255,18152,11150,5.87547e+18,169.847,1892.02,29302,117,116,24432,19786,3667,7300,3163
25459,225,304,15927,9532,5.88888e+18,211.557,2207.81,25459,146,149,25136,25030,19913,20876,18403
16748,2,254,10326,6422,5.87293e+18,148.027,1411.65,16748,91,94,1536,0,146,0,17
85207,54,270,52744,32463,5.87011e+18,211.871,3415.09,85207,128,136,81127,75122,22172,26812,26032
19229,249,250,11850,7379,5.87176e+18,140.87,1471.59,19229,93,95,18979,18979,18978,18978,18979
48896,20,400,30779,18117,5.89522e+18,233.415,3255.67,48896,187,190,28626,16446,3872,7104,860
89958,301,327,55787,34171,5.87586e+18,210.964,3845.97,89958,165,164,89631,89566,87156,88327,86047
59632,6,224,36909,22723,5.87002e+18,149.244,2333.2,59632,102,107,21389,0,2036,3529,1952
70675,92,285,44096,26579,5.88203e+18,235.968,3382.95,70675,187,183,67011,62587,25258,26645,25783
40839,212,268,25329,15510,5.87493e+18,165.877,2294.95,40839,130,133,40522,40369,33376,36986,32869
60011,32,273,37226,22785,5.87363e+18,183.948,2732.12,60011,141,139,52412,44234,8561,15845,10098
76609,170,301,47245,29364,5.87101e+18,165.012,3049.45,76609,112,121,76203,76003,64608,62714,65754
79484,95,274,49098,30386,5.87481e+18,220.711,3239.5,79484,175,167,77060,74521,31022,33597,31003
18104,121,156,11122,6982,5.86925e+18,102.404,1216.82,18104,73,77,17945,17868,16295,17154,17319
14956,209,271,9254,5702,5.87141e+18,87.6063,1420.08,14956,89,85,14685,14648,13558,14062,13115
76666,145,220,47324,29342,5.87018e+18,125.463,2900.71,76666,92,94,76431,76287,62882,65403,65034
34683,119,179,21448,13235,5.86997e+18,120.333,1709.56,34683,85,86,34478,34313,24733,24126,27507
22550,156,257,13880,8670,5.87263e+18,135.872,1620.79,22550,96,99,22220,22079,17027,16148,16869
34571,50,181,21301,13270,5.87011e+18,81.2158,1875.66,34571,78,82,33423,31563,12050,14301,14734
95698,80,242,59077,36621,5.87013e+18,157.256,3272.87,95698,97,98,94998,94675,41066,41184,45825
82441,36,214,50951,31490,5.87009e+18,125.658,2948.02,82441,90,95,74922,66427,16461,25139,22036
82039,8,232,50669,31370,5.86999e+18,145.439,3052.53,82039,97,97,34136,0,4794,5615,3524
20390,109,240,12835,7555,5.89618e+18,189.712,1825.18,20390,155,141,19015,17370,9379,8868,10860
89116,53,298,55069,34047,5.87091e+18,206.218,3234.48,89116,126,130,86152,83047,18386,29581,26123
76657,244,300,47381,29276,5.87105e+18,190.584,2989.43,76657,117,119,76357,76241,75031,75604,75635
60876,20,196,37577,23299,5.87037e+18,109.758,2511.4,60876,85,86,44753,32136,9040,10566,9017
81051,87,276,49983,31068,5.87312e+18,213.356,3160.04,81051,146,155,78930,76792,27345,33741,35481
21948,182,219,13570,8378,5.87035e+18,113.583,1420.76,21948,78,85,21729,21674,20692,21305,21436
80556,201,307,50179,30377,5.88483e+18,235.283,3760.88,80556,198,193,80013,79397,59685,63450,63412
80016,172,209,49427,30589,5.87015e+18,132.137,2902.71,80016,91,93,79807,79782,75288,77638,78422
62891,115,270,38642,24249,5.87171e+18,163.2,2570.51,62891,115,124,62245,61608,34421,32954,38195
27498,197,252,16960,10538,5.87728e+18,177.568,1885.14,27498,122,116,27212,27038,22805,24903,23355
53644,208,266,33022,20622,5.87132e+18,187.677,2399.54,53644,114,121,53347,53147,46562,50201,48051
89810,49,286,55240,34570,5.87084e+18,151.587,3158.88,89810,117,128,86445,83002,17796,26837,23020
38449,10,267,24148,14301,5.894e+18,215.316,2577.87,38449,175,173,16367,8826,1774,3557,1679
94108,78,315,58263,35845,5.87302e+18,200.954,3594.81,94108,152,160,91595,89416,28625,38961,28937
54492,94,237,33679,20813,5.87019e+18,123.361,2284.93,54492,91,100,54013,53606,26352,27315,36068
46986,22,286,29140,17846,5.87905e+18,212.926,2719.97,46986,162,154,34687,25428,5393,9037,5162
43235,7,171,26734,16501,5.86988e+18,96.9883,2044.78,43235,84,85,16018,0,1926,2700,2258
94987,205,215,58575,36412,5.87028e+18,139.327,3106.11,94987,96,103,94772,94766,93568,94350,94420
16405,149,154,10124,6281,5.87013e+18,69.0131,1228.08,16405,73,74,16251,16251,16220,16249,16228
16375,248,251,10158,6217,5.87193e+18,120.128,1395.26,16375,81,88,16124,16124,16093,16098,16114
98374,215,307,60853,37521,5.87116e+18,226.58,3443.01,98374,132,139,98006,97731,80341,89555,82222
29985,122,240,18399,11586,5.87107e+18,157.605,1738.27,29985,100,100,29618,29268,17549,16342,18985
50226,68,211,31040,19186,5.87022e+18,120.028,2370.78,50226,88,90,49662,48770,24464,25212,26563
32951,19,260,20293,12658,5.87178e+18,130.127,1902.54,32951,100,105,24872,17147,4490,6588,4268
81264,29,327,50381,30883,5.87534e+18,200.609,3625.51,81264,160,152,67169,52589,11157,19800,13070
76735,267,327,47602,29133,5.87746e+18,176.445,3645.78,76735,160,172,76408,76321,69624,71363,67057
34354,144,293,21681,12673,5.90106e+18,208.316,2482.98,34354,176,170,33209,31351,18959,18057,21562
75748,7,276,46715,29033,5.87282e+18,197.952,3078.4,75748,149,155,30531,0,4947,5661,2018
32275,254,258,19812,12463,5.87297e+18,143.875,1871.99,32275,104,101,32017,32014,31858,31917,32013
51906,262,266,31958,19948,5.87089e+18,183.009,2361.62,51906,113,119,51640,51640,51458,51594,51638
77178,93,216,47581,29597,5.87028e+18,125.867,2772.41,77178,93,100,76707,76323,41444,39369,42247
9291,182,221,5857,3434,5.89779e+18,171.422,1226.39,9291,117,109,9051,8914,8223,8483,8471
28024,148,155,17294,10730,5.87036e+18,79.6703,1590.48,28024,75,78,27869,27869,27672,27704,27848
80723,123,275,49704,31019,5.87089e+18,155.207,2903.9,80723,116,128,80111,79452,43431,43488,47770
69233,266,342,43139,26094,5.88351e+18,176.196,3753.54,69233,170,180,68891,68807,62009,62663,58533
15091,26,183,9328,5763,5.86978e+18,87.3885,1251.13,15091,74,75,11981,8419,2654,3805,2622
43777,129,197,27009,16768,5.86974e+18,114.996,2070.69,43777,87,86,43570,43453,36191,35019,38696
18690,55,166,11537,7153,5.86958e+18,84.7523,1361.82,18690,75,76,18184,17538,8350,8435,9021
87709,224,271,54230,33479,5.87019e+18,174.693,3343.66,87709,113,113,87413,87320,82315,85221,86158
79120,118,294,48762,30358,5.87033e+18,161.144,2919.51,79120,106,112,78632,78162,43811,41116,59126
38706,125,269,23905,14801,5.87465e+18,169.013,2243.11,38706,128,130,37916,37078,19511,19388,19596
22547,169,195,13898,8649,5.87005e+18,97.7939,1469.78,22547,78,81,22352,22328,21812,22076,21916
98066,72,288,60457,37609,5.87007e+18,145.327,3263.31,98066,107,110,96944,96124,31125,40542,42112
25057,4,219,15394,9663,5.87008e+18,102.5,1514.63,25057,82,88,5956,0,4,972,548
58987,86,274,36510,22477,5.87718e+18,230.829,2885.39,58987,166,160,56439,53829,19332,23411,19252
90966,220,285,56607,34359,5.87802e+18,252.677,3688.99,90966,185,187,90512,90055,72998,79825,76574
76512,214,327,48210,28302,5.89784e+18,233.486,3799.55,76512,206,199,76061,75554,57126,59506,62343
19371,124,140,11997,7374,5.86969e+18,94.5873,1230.04,19371,71,74,19231,19181,17565,18611,18439
2446,138,182,1531,915,5.87316e+18,75.7114,535.81,2446,58,50,2264,2241,1908,2080,1826
49998,148,259,30966,19032,5.86984e+18,149.601,2522.41,49998,102,103,49613,49281,37752,34603,39996
29406,11,244,18099,11307,5.87032e+18,157.267,1712.01,29406,96,94,17175,11253,3186,3514,2374
45185,53,290,27927,17258,5.87177e+18,162.805,2352.79,45185,109,116,43297,41643,11593,16042,13143
32148,2,197,19894,12254,5.86978e+18,112.048,1786.14,32148,79,82,2932,0,325,0,404
43088,167,264,26557,16531,5.87268e+18,203.931,2237.71,43088,122,124,42648,42311,29958,28857,32197
4288,93,102,2632,1656,5.87342e+18,45.1493,537.926,4288,51,51,4186,4186,4084,4113,4119
70836,40,222,43783,27053,5.86991e+18,128.609,2793.43,70836,90,90,65792,58857,16762,22821,20190
50009,310,411,31051,18958,5.87699e+18,169.157,3344.75,50009,152,145,49598,49538,46797,47123,43413
45981,337,397,28529,17452,5.88434e+18,222.628,2978.1,45981,173,170,45584,45538,38095,41192,35452
93864,254,279,57677,36187,5.87119e+18,164.933,3165.53,93864,127,131,93585,93577,87535,91026,90550
99880,164,263,61649,38231,5.87007e+18,139.586,3245.91,99880,104,111,99585,99442,79508,75545,89050
57462,211,303,35506,21956,5.87126e+18,162.585,2692.66,57462,107,115,57132,56972,47604,50876,49011
45340,116,279,28324,17016,5.88389e+18,198.932,2710.48,45340,163,168,43638,41609,22059,21576,18991
98918,28,426,61738,37180,5.88274e+18,211.944,4829.51,98918,191,202,73235,49070,13701,21412,11381
75329,42,239,46405,28924,5.87007e+18,139.641,2745.75,75329,105,111,71550,66478,13928,19975,19009
48666,241,252,29951,18715,5.86969e+18,119.5,2242.58,48666,96,97,48414,48408,47519,48110,47727
75036,48,273,46219,28817,5.87064e+18,154.756,2818.31,75036,119,122,72062,69418,15578,24586,19918
92736,17,328,57477,35259,5.87667e+18,191.106,3930.26,92736,169,179,62841,39962,9395,17100,8672
78006,33,254,48198,29808,5.87e+18,148.071,3093.11,78006,104,105,67908,51436,14306,21500,16705
2152,29,235,1340,812,5.87917e+18,68.9452,571.556,2152,59,53,1538,1144,304,507,42
25773,120,258,16006,9767,5.88137e+18,207.051,1945.49,25773,138,132,24842,23774,12809,12455,13083
93224,44,232,57561,35663,5.87007e+18,126.517,3157.08,93224,93,99,88645,82029,21962,31108,26175
29929,245,256,18436,11493,5.87176e+18,122.077,1808.02,29929,99,102,29673,29667,28976,29152,29096
48322,225,310,29906,18416,5.87418e+18,158.376,2700.4,48322,129,132,47988,47862,39972,42663,37841
80890,156,302,49873,31017,5.8707e+18,162.768,3111.29,80890,114,124,80418,80120,58361,57741,63325
92366,187,283,56785,35581,5.87143e+18,147.731,3210.17,92366,117,126,92012,91809,66219,70085,67709
93338,83,224,57600,35738,5.87009e+18,142.683,3159.94,93338,94,97,92745,92431,44001,41303,50111
21347,155,165,13162,8185,5.86915e+18,95.2321,1377.22,21347,75,76,21182,21162,21101,21161,20999
1457,58,59,909,548,5.86015e+18,43.2464,258.546,1457,39,39,1398,1392,1370,1370,1398
13386,84,277,8341,5045,5.88016e+18,98.0308,1516.81,13386,103,99,12652,11953,10092,10101,9091
43166,46,226,26552,16614,5.87025e+18,133.926,1990.62,43166,92,98,41476,39929,9259,13784,11710
24152,99,217,14867,9285,5.87057e+18,156.873,1518.74,24152,85,89,23785,23512,13085,13408,18107
19408,107,239,12156,7252,5.8892e+18,168.593,1760.5,19408,143,128,18262,16934,9287,9055,9785
17285,242,252,10746,6539,5.87902e+18,142.261,1550.41,17285,107,107,17033,17020,16386,16832,16711
73874,220,342,45644,28230,5.87051e+18,147.67,3147.12,73874,114,105,73521,73377,70005,69678,70996
11663,101,146,7195,4468,5.86819e+18,67.1568,1033.19,11663,68,70,11517,11501,10311,10383,9450
90705,219,342,56024,34681,5.87049e+18,156.852,3420.14,90705,116,111,90346,90194,83924,82770,86591
7073,152,165,4365,2708,5.87057e+18,81.1862,757.071,7073,61,59,6908,6908,6799,6850,6908
65180,176,397,40366,24814,5.8716e+18,155.593,3307.63,65180,121,110,64720,64499,59597,60305,59328
59790,104,202,36857,22933,5.87005e+18,117.162,2454.78,59790,87,94,59487,59267,37664,37779,43269
75614,158,342,46584,29030,5.87054e+18,152.191,3137.41,75614,116,113,75155,74813,47927,46528,52883
60796,64,328,37723,23073,5.87696e+18,158.999,3249.51,60796,145,150,57604,54606,20415,23677,22956
11992,237,240,7429,4563,5.87533e+18,136.574,1201.65,11992,84,89,11752,11752,11747,11747,11746
38690,149,177,23868,14822,5.8702e+18,109.082,1940.73,38690,80,81,38513,38461,35907,37443,37521
9227,24,75,5724,3503,5.86978e+18,71.1878,731.884,9227,64,66,7138,4947,1959,2718,3303
80076,131,211,49401,30675,5.87034e+18,128.979,2905.12,80076,90,93,79824,79644,61718,59905,67124
2987,64,163,1843,1144,5.87e+18,61.386,533.098,2987,54,54,2807,2734,2033,2093,2035
85083,159,302,52410,32673,5.87048e+18,158.658,3167.29,85083,117,124,84619,84328,57228,56509,63335
44611,224,269,27486,17125,5.87704e+18,181.672,2415.3,44611,141,137,44317,44167,38044,41370,41104
23558,128,189,14484,9074,5.87046e+18,103.783,1511.93,23558,78,83,23366,23275,17144,16783,15029
79761,59,293,49154,30607,5.87011e+18,162.281,2924.04,79761,107,115,78082,76455,19675,28721,29416
82685,127,289,50951,31734,5.87026e+18,143.822,3033.2,82685,100,109,82295,81986,51707,50875,64540
76011,312,315,46901,29110,5.87357e+18,199.555,3319.51,76011,149,151,75696,75696,75612,75615,75632
47601,277,309,29614,17987,5.8824e+18,213.604,2884.62,47601,169,174,47292,47264,42279,45077,42902
25825,70,154,15972,9853,5.86985e+18,69.351,1542.52,25825,75,78,25631,25371,18601,19493,18120
37946,217,273,23569,14377,5.87486e+18,169.182,2248.69,37946,129,127,37639,37499,33509,35131,33475
1963,116,132,1225,738,5.86279e+18,51.7269,424.454,1963,48,48,1831,1831,1787,1808,1757
14930,28,158,9185,5745,5.86965e+18,90.8138,1117.85,14930,68,72,12991,10529,3363,4488,3194
40949,20,173,25260,15689,5.86948e+18,96.6913,1942.52,40949,79,87,30854,22651,6042,8502,6411
93388,222,315,57602,35786,5.87268e+18,195.599,3633.05,93388,152,153,92990,92733,78473,82409,75049
67260,17,313,41709,25551,5.87875e+18,190.414,3365.13,67260,175,176,44781,28276,7213,12432,5596
67366,116,270,41682,25684,5.87078e+18,161.776,2665.89,67366,113,123,66746,66053,31588,30196,32606
16203,152,215,10032,6171,5.87064e+18,100.622,1242.38,16203,73,75,15988,15906,14355,14989,15096
1563,53,137,963,600,5.88119e+18,52.7575,367.146,1563,43,42,1385,1296,710,742,659
69756,185,293,42964,26792,5.87076e+18,159.189,2824.26,69756,118,127,69402,69209,47686,42722,41204
78859,132,317,49398,29461,5.88866e+18,212.107,3881.15,78859,193,206,76391,72948,39573,39290,31241
69768,236,269,43183,26585,5.87111e+18,161.604,2679.58,69768,116,127,69499,69439,59677,65528,64440
57734,127,327,35738,21996,5.87006e+18,162.225,2829.36,57734,105,104,57197,56817,42324,42030,43184
88182,87,282,54377,33805,5.87296e+18,208.581,3301.51,88182,156,159,86002,83813,26855,35783,26743
46712,78,175,28873,17839,5.87039e+18,109.941,2110.34,46712,82,83,46435,46349,25680,24489,25656
84429,219,426,52642,31787,5.88087e+18,189.633,4467.19,84429,180,184,83967,83803,69018,65751,58008
39190,208,272,24204,14986,5.8746e+18,175.052,2290.36,39190,129,134,38851,38646,32666,34956,30846
15004,50,210,9267,5737,5.87125e+18,97.7519,1155.63,15004,75,79,14395,14019,4324,5705,5981
26081,105,397,16196,9885,5.87533e+18,157.802,2399.35,26081,122,118,25128,24304,12681,13147,11611
97595,267,426,60753,36842,5.88008e+18,177.959,4717.97,97595,180,189,97169,97092,83891,83953,72577
90288,166,288,55649,34639,5.87013e+18,137.485,3144.68,90288,107,108,89993,89814,62871,58596,53984
96387,10,276,59430,36957,5.87298e+18,218.88,3434.77,96387,160,163,52030,35750,9514,11140,4384
10464,116,416,6570,3894,5.89448e+18,143.658,1690.4,10464,120,120,9667,8884,4575,4105,2682
19625,49,251,12155,7470,5.87277e+18,124.632,1504.58,19625,87,89,18601,17658,5414,7398,6782
55984,70,328,34713,21271,5.87536e+18,150.375,3044.82,55984,126,128,53984,52137,22327,23250,25240
22296,124,148,13769,8527,5.86939e+18,94.8385,1378.05,22296,71,75,22148,22096,20470,21506,21587
50872,38,261,31867,19005,5.88787e+18,224.022,2876.59,50872,187,179,40277,31298,7539,11821,7956
34299,115,180,21230,13069,5.86967e+18,118.131,1699.24,34299,81,88,34083,33898,24065,23419,25838
13932,17,160,8612,5320,5.86926e+18,72.5617,1143.5,13932,70,74,9558,6006,1992,1999,2313
43703,253,261,26854,16849,5.87208e+18,169.869,2163.63,43703,111,116,43442,43435,42822,43244,43236
39562,9,284,24706,14856,5.88289e+18,198.309,2582.27,39562,155,159,17748,0,2408,4060,1051
72194,9,235,44627,27567,5.87e+18,168.28,2876.82,72194,96,93,32892,0,5279,5813,3140
67555,26,252,41776,25779,5.87023e+18,146.127,2903.1,67555,101,103,53784,37952,11832,16230,14765
96971,31,316,59717,37254,5.8728e+18,207.606,3606.56,96971,145,149,84312,69702,14093,25313,15318
74973,193,342,46204,28769,5.87033e+18,149.13,3135.28,74973,118,114,74587,74398,58361,54106,64644
76488,233,260,47150,29338,5.87e+18,144.503,2802.4,76488,113,115,76228,76228,70510,72972,73121
22565,67,173,13872,8693,5.87027e+18,109.894,1371.53,22565,75,81,22139,21860,10272,10482,12526
61642,97,259,37947,23695,5.87035e+18,116.993,2585.24,61642,95,105,61193,60811,29678,31416,31801
77316,122,307,48032,29284,5.88195e+18,244.572,3606.34,77316,187,187,74999,71927,34569,34199,36055
13245,120,140,8147,5098,5.86877e+18,87.4941,1056.38,13245,67,70,13105,13070,11970,12520,12308
78420,195,260,48312,30108,5.87045e+18,145.451,2872.05,78420,103,109,78160,78049,70780,74002,74581
79744,79,263,49179,30565,5.87018e+18,132.347,2915.3,79744,98,105,78978,78475,28209,34074,36499
36036,114,249,22131,13905,5.87063e+18,135.049,1904.33,36036,87,95,35712,35423,17705,16570,16380
14364,185,261,8994,5370,5.88822e+18,171.298,1563.94,14364,126,111,14081,13931,11851,11944,12020
20062,65,312,12379,7683,5.87296e+18,75.4536,1655.81,20062,90,87,19437,18816,10488,9369,6691
6287,77,141,3909,2378,5.86779e+18,55.6641,705.554,6287,56,60,6146,6128,3846,3499,2467
37753,96,173,23324,14429,5.87007e+18,106.798,1840.73,37753,80,87,37485,37289,24113,22231,28592
30776,57,193,19038,11738,5.87057e+18,107.605,1736.65,30776,79,78,30168,29304,12422,13240,13432
44802,189,273,27785,17017,5.87451e+18,172.376,2424.02,44802,132,135,44409,44158,32811,34946,32286
25024,225,250,15462,9562,5.86895e+18,98.718,1786.46,25024,90,93,24774,24756,23942,24482,24406
79169,158,274,48837,30332,5.87325e+18,217.106,3118.38,79169,146,157,78396,77742,50711,47670,54666
34222,226,240,21136,13086,5.86998e+18,96.068,1917.6,34222,80,86,33982,33982,33972,33977,33940
19308,39,218,11881,7427,5.86986e+18,97.3975,1348.33,19308,76,85,18041,16657,3931,5957,5603
68096,125,257,42118,25978,5.87001e+18,151.561,2907.64,68096,106,105,67588,67182,41656,38310,44627
27750,47,251,17167,10583,5.87252e+18,144.987,1743.53,27750,105,103,26159,25020,5768,8661,7912
22229,166,217,13752,8477,5.87076e+18,129.05,1456.98,22229,84,92,22012,21964,17856,20015,18227
20239,179,253,12540,7699,5.87065e+18,172.673,1530,20239,90,90,19963,19863,17039,18456,18358
75217,144,276,46398,28819,5.87349e+18,204.873,3062.73,75217,145,153,74347,73738,45161,43137,49980
55607,174,259,34275,21332,5.87014e+18,130.843,2444.87,55607,94,98,55348,55235,48196,48190,52675
52200,87,226,32310,19890,5.87039e+18,133.756,2168.29,52200,96,102,51623,51081,23840,23128,24007
79041,117,315,48783,30258,5.8726e+18,169.701,3326.63,79041,139,136,78040,76917,46119,44833,49978
69842,50,273,42919,26923,5.87153e+18,159.537,2697.17,69842,118,124,67210,64847,15972,22504,18284
35012,89,197,21546,13466,5.87e+18,113.755,1867.29,35012,79,83,34722,34595,21766,20306,23051
73908,115,202,45569,28339,5.86989e+18,123.98,2715.89,73908,88,97,73617,73344,50664,49035,58416
33534,151,177,20706,12828,5.87039e+18,77.6326,1809.1,33534,78,81,33357,33354,31806,32706,31794
59812,170,286,37658,22154,5.89583e+18,230.706,3296.54,59812,196,191,58939,57579,37966,38462,41743
95498,86,294,58967,36531,5.87013e+18,171.851,3214.89,95498,117,121,94462,93517,34488,39942,47511
85653,254,294,53542,32111,5.88845e+18,244.244,3878.24,85653,203,207,85337,85161,72904,77358,76973
42939,80,411,26637,16302,5.87474e+18,163.556,3043.09,42939,133,123,41309,39832,20114,19460,19342
56802,61,226,35147,21655,5.87038e+18,134.86,2264.56,56802,97,103,55712,54982,15742,21758,25207
77568,208,277,47830,29738,5.87057e+18,154.97,2928.48,77568,119,122,77279,77145,61906,70030,57011
85121,143,298,52591,32530,5.87063e+18,192,3161.59,85121,120,124,84597,84269,55017,50010,65720
97661,236,297,60156,37505,5.87035e+18,162.2,3241.11,97661,113,120,97364,97322,91330,94814,94823
84364,203,309,52284,32080,5.87298e+18,208.476,3349.17,84364,153,159,83906,83465,56173,55595,54790
39809,158,173,24596,15213,5.86969e+18,113.28,1872.57,39809,83,90,39636,39626,38690,39267,39548
2169,64,154,1335,834,5.87433e+18,51.7059,460.487,2169,49,48,1996,1937,1399,1403,1294
97759,312,397,60515,37244,5.87161e+18,175.208,4014.44,97759,132,128,97362,97283,95311,95877,93493
2463,17,197,1540,923,5.88222e+18,81.1003,570.406,2463,60,59,1568,983,300,500,466
22617,63,267,14009,8608,5.87783e+18,193.089,1822.51,22617,126,126,20821,19319,4942,8547,5822
35489,181,224,21946,13543,5.87003e+18,126.19,1811.63,35489,88,97,35265,35241,29812,32797,31328
85057,54,303,52566,32491,5.8708e+18,151.441,3179.3,85057,115,127,82440,79399,19003,28262,22397
87024,73,276,53891,33133,5.87758e+18,229.562,3537.11,87024,187,181,82124,77719,20433,31578,25172
98887,148,287,61164,37723,5.87129e+18,180.992,3321.64,98887,136,140,98260,97761,55529,47683,52703
83823,317,411,51888,31935,5.88067e+18,250.483,4009.78,83823,190,196,83412,83306,67646,73205,53277
69418,245,269,42722,26696,5.87081e+18,154.683,2685.22,69418,114,124,69149,69143,61777,65699,65077
65509,308,313,40562,24947,5.87341e+18,188.667,3117.62,65509,139,144,65196,65192,65020,65039,65161
50244,247,381,31109,19135,5.87154e+18,172.466,2701.12,50244,119,125,49863,49753,34598,33408,33123
58186,130,210,35946,22240,5.87024e+18,112.503,2510.11,58186,88,88,57962,57845,44072,44792,44010
35671,231,295,22168,13503,5.88147e+18,131.485,2481.45,35671,146,140,35376,35335,31527,32281,30639
98713,75,301,60822,37891,5.86993e+18,156.181,3311.32,98713,109,110,97589,96806,23894,37472,39897
67667,69,254,41658,26009,5.87003e+18,154.642,2591.59,67667,115,113,66345,65310,16600,24099,22753
32895,139,296,20285,12610,5.87196e+18,110.81,2079.91,32895,95,98,32522,32342,27518,27392,27388
46826,124,257,28827,17999,5.87022e+18,120.212,2246.56,46826,93,94,46510,46303,33726,33880,37184
26220,32,255,16148,10072,5.87107e+18,140.866,1718.5,26220,95,96,23148,19712,4539,7378,5433
47717,140,268,29632,18085,5.87582e+18,181.793,2516.3,47717,150,141,46926,46318,26973,24219,28138
27619,72,204,17058,10561,5.86997e+18,106.527,1786.11,27619,84,84,27295,26987,14310,14357,14305
7700,105,121,4730,2970,5.8697e+18,58.0545,757.35,7700,59,58,7579,7579,7250,7457,7172
98314,154,246,60614,37700,5.86989e+18,141.266,3162.2,98314,101,106,98054,97876,76004,77574,87598
35376,127,257,21740,13636,5.87219e+18,190.546,1987.62,35376,111,113,34864,34368,20795,19527,22758
66316,109,222,40994,25322,5.86978e+18,158.182,2716.11,66316,90,91,65972,65767,36751,33383,35035
5535,20,112,3415,2120,5.87042e+18,55.299,654.319,5535,56,57,4133,3027,986,1522,1031
92991,228,259,57497,35494,5.8701e+18,150.471,3363.24,92991,108,107,92723,92621,86846,90147,90376
5039,47,137,3102,1937,5.8691e+18,79.0296,628.215,5039,55,57,4782,4674,1788,2082,2081
54276,231,266,33407,20869,5.8707e+18,170.544,2411.98,54276,112,119,54010,53946,45900,50669,49534
29938,88,257,18420,11518,5.87342e+18,193.897,1873.98,29938,105,108,29169,28487,11800,12458,8416
31997,34,178,19656,12341,5.86999e+18,122.769,1640.58,31997,83,90,29301,25476,6444,9390,8502
53720,168,327,33339,20381,5.87797e+18,148.119,3091.26,53720,143,147,53186,52775,42239,41658,38971
23638,119,225,14614,9024,5.86995e+18,123.127,1715.78,23638,87,88,23348,23199,18039,17527,17677
5752,4,77,3552,2200,5.87058e+18,67.4009,578.149,5752,62,62,1269,0,5,206,350
89672,116,342,55304,34368,5.87032e+18,146.097,3402.31,89672,118,116,88994,88397,49763,48058,50676
36453,219,363,22562,13891,5.87169e+18,187.823,2234.83,36453,108,117,36073,36008,23560,20265,14013
32759,51,257,20267,12492,5.86988e+18,135.546,2098.8,32759,97,96,31074,28875,10538,11983,12468
9985,182,246,6286,3699,5.8979e+18,172.078,1332.69,9985,126,111,9719,9592,7818,8051,8530
9591,29,144,5903,3688,5.86909e+18,78.4194,862.222,9591,60,65,8506,7234,2208,3228,3135
74720,121,327,46311,28409,5.87551e+18,177.678,3513.97,74720,155,150,73522,72083,44511,43338,46415
47842,204,234,29476,18366,5.86982e+18,126.078,2153.67,47842,92,98,47608,47593,42962,44910,44844
17542,75,184,10845,6697,5.8695e+18,89.6483,1370.57,17542,75,76,17319,17188,9256,8659,7786
7571,8,124,4689,2882,5.86917e+18,55.7377,762.626,7571,59,60,3372,0,499,726,834
2655,65,102,1633,1022,5.86442e+18,43.5932,414.266,2655,46,45,2553,2542,1862,1934,1937
87483,35,301,53926,33557,5.87043e+18,147.806,3203.17,87483,120,129,79338,68595,15400,22256,17238
16025,141,264,9936,6089,5.87975e+18,127.211,1557.16,16025,107,107,15609,15388,10427,9845,9004
21035,183,254,13156,7879,5.88942e+18,171.692,1854.2,21035,143,135,20702,20421,16380,17154,16057
23854,86,255,14833,9021,5.87753e+18,179.632,1800.25,23854,120,120,22677,21516,9230,9553,8331
42063,61,411,26161,15902,5.88387e+18,203.735,3125.23,42063,166,167,37483,33332,10057,13007,8771
51726,42,223,31764,19962,5.87087e+18,129.571,2160.17,51726,96,102,49343,46114,11906,16660,14482
76950,100,258,47412,29538,5.87039e+18,141.221,2842,76950,101,107,76423,75922,42533,40173,51625
5360,69,144,3309,2051,5.87023e+18,61.7034,670.722,5360,59,58,5200,5135,3683,3652,3723
50562,210,285,31470,19092,5.8787e+18,209.254,2789.5,50562,161,156,50208,49966,40102,43939,43019
49121,232,327,30415,18706,5.87038e+18,139.036,2635.64,49121,103,101,48794,48683,48100,48267,47949
66179,105,216,40781,25398,5.87007e+18,126.141,2633.39,66179,91,95,65837,65556,39608,36424,37535
39434,52,270,24569,14865,5.88491e+18,214.747,2516.87,39434,167,168,34065,30581,7309,11842,7294
38326,38,179,23704,14622,5.86966e+18,119.212,1783.87,38326,87,93,35950,33356,7635,12324,10805
83732,105,316,51934,31798,5.87922e+18,238.287,3674.46,83732,187,190,80669,77394,30150,33451,19859
37614,169,262,23164,14450,5.87134e+18,173.806,2040.97,37614,105,115,37275,37059,25468,24036,23211
60078,160,200,37062,23016,5.86996e+18,126.085,2441.38,60078,87,94,59878,59778,54784,57104,58294
33847,187,263,21014,12833,5.8808e+18,201.378,2219.08,33847,152,146,33445,32985,26042,27786,28326
98828,154,342,61366,37462,5.87973e+18,206.314,4313.13,98828,182,183,97780,96378,59288,56086,67595
12406,5,243,7691,4715,5.8704e+18,120.144,1299.19,12406,84,86,3362,0,10,563,213
50263,231,257,30952,19311,5.87035e+18,128.477,2316.3,50263,93,94,50006,49967,46706,48470,49032
48923,174,257,30198,18725,5.86995e+18,140.292,2489.54,48923,101,100,48587,48371,37946,36348,42958
51799,96,270,32097,19702,5.87034e+18,207.581,2661.53,51799,111,115,50874,50231,23080,19737,22560
89351,255,286,55621,33730,5.88349e+18,243.881,3850,89351,196,197,89046,88903,82993,86282,86477
5253,27,214,3292,1961,5.88928e+18,142.861,877.588,5253,91,82,3640,2375,626,1073,642
54165,15,214,33423,20742,5.87003e+18,122.216,2393.14,54165,90,90,35253,20805,6163,6909,5475
76207,7,278,46833,29374,5.87104e+18,153.502,2899.88,76207,119,117,30612,0,4389,6143,2131
95724,179,325,59324,36400,5.87774e+18,220.52,4025.95,95724,178,191,94902,94003,64498,61102,56533
59710,86,290,36933,22777,5.87122e+18,154.921,2666.78,59710,112,121,58780,57974,24995,31339,30589
5034,115,210,3124,1910,5.88048e+18,130.248,810.305,5034,76,73,4724,4511,2981,2969,2777
33186,101,178,20468,12718,5.87023e+18,109.403,1782.72,33186,77,81,32962,32831,23079,22680,24276
16074,112,411,10064,6010,5.88989e+18,170.8,2058.61,16074,140,135,15008,13906,6182,6616,4425
66196,264,290,40924,25272,5.87078e+18,156.028,2775.9,66196,113,122,65906,65879,57137,62345,60231
36137,91,217,22353,13784,5.86988e+18,112.511,2043.02,36137,86,87,35823,35703,24717,23046,23208
32976,122,263,20321,12655,5.87795e+18,180.965,2082.91,32976,128,128,32160,31264,16390,15724,18762
38221,140,159,23634,14587,5.87019e+18,92.4706,1869.59,38221,79,81,38062,38024,36713,36986,37682
21091,198,250,13077,8014,5.86997e+18,169.362,1704.19,21091,90,92,20841,20751,18209,19460,16606
76503,49,227,47240,29263,5.86986e+18,133.399,2866.48,76503,92,97,73831,70196,19372,27181,24656
48753,93,269,30421,18332,5.88397e+18,217.591,2753.47,48753,169,169,46011,42912,18244,18652,19240
16422,121,155,10083,6339,5.87049e+18,81.7781,1147.26,16422,70,74,16267,16229,13859,14938,13862
75973,272,302,46806,29167,5.87073e+18,164.386,3021.07,75973,114,123,75671,75624,67150,72120,71056
19767,60,166,12193,7574,5.86937e+18,80.7826,1370.37,19767,74,77,19359,18921,11293,11580,12389
23780,117,251,14714,9066,5.87233e+18,132.19,1622.77,23780,97,98,23379,23022,12063,11282,12748
21651,5,162,13312,8339,5.86956e+18,100.954,1340.63,21651,75,77,6364,0,238,962,601
13454,3,116,8265,5189,5.87086e+18,66.5891,953.259,13454,67,69,2218,0,9,150,269
94340,235,308,58061,36279,5.87315e+18,209.272,3447.35,94340,156,152,93992,93845,74981,83866,68486
78129,141,309,48415,29714,5.87339e+18,205.255,3290.31,78129,149,158,77184,76495,41916,40594,37787
27527,20,243,17392,10135,5.90081e+18,195.872,2146.51,27527,169,159,15024,7717,1961,3576,2463
21421,43,187,13209,8212,5.8702e+18,99.1723,1456.34,21421,78,82,20264,18823,6588,8136,7719
95936,295,307,59838,36098,5.88644e+18,245.516,4122.07,95936,211,201,95629,95558,94755,95109,94377
92627,42,275,57315,35312,5.87078e+18,176.925,3110.36,92627,130,134,87625,81765,15690,26125,20394
2535,78,96,1571,964,5.87105e+18,43.9329,408.407,2535,44,48,2439,2439,2092,2177,2108
87093,4,217,53707,33386,5.87023e+18,139.275,2997.14,87093,92,101,20085,0,39,2064,1374
5212,26,144,3241,1971,5.87045e+18,55.8135,683.045,5212,57,60,4277,3210,1077,1486,1175
90965,107,301,56130,34835,5.87073e+18,165.002,3282.33,90965,118,126,90150,89322,47212,45766,47072
37018,52,235,22886,14132,5.87049e+18,130.212,2133.7,37018,91,92,35402,32771,12694,13265,14236
85243,219,275,52464,32779,5.87453e+18,228.356,3260,85243,163,161,84846,84474,70125,77555,73906
54793,57,266,33733,21060,5.87438e+18,211.312,2612.24,54793,145,135,51836,49686,11050,18001,11399
98296,25,327,60958,37338,5.87568e+18,207.282,4005.77,98296,167,172,77539,56566,11759,21604,13511
64385,59,271,39563,24822,5.87158e+18,158.058,2603.17,64385,117,123,62586,61155,16455,24488,22725
92810,190,316,57247,35563,5.87284e+18,189.328,3595.3,92810,152,151,92266,91850,70001,63901,66993
35539,108,191,21905,13634,5.86985e+18,101.814,1880.18,35539,82,87,35300,35140,24684,22463,24389
18039,12,150,11095,6944,5.87035e+18,83.7081,1262.84,18039,70,69,10413,6313,2000,2091,1700
48587,23,197,30043,18544,5.86995e+18,116.02,2238.22,48587,84,88,37926,27286,7380,12266,7867
13557,217,229,8514,5043,5.88879e+18,178.269,1441.79,13557,126,117,13328,13320,12828,13134,13240
86716,107,426,54246,32470,5.88615e+18,214.232,4559.07,86716,201,206,82609,77677,30660,36297,25598
99976,76,228,61623,38353,5.87021e+18,144.341,3180.85,99976,100,106,99065,98524,40461,42314,48603
31742,17,173,19574,12168,5.86992e+18,103.568,1695.1,31742,77,82,22518,14586,4207,5530,4550
58962,50,226,36466,22496,5.87027e+18,156.263,2338.71,58962,99,106,57014,55178,11926,19217,18648
15915,101,137,9865,6050,5.87069e+18,68.6899,1155.07,15915,72,71,15778,15773,15088,14820,14424
67211,89,213,41487,25724,5.87013e+18,126.243,2684.57,67211,88,89,66831,66656,36404,33713,41896
15065,57,135,9256,5809,5.86964e+18,86.2071,1083.26,15065,66,71,14785,14582,6634,7089,7465
11527,12,181,7120,4407,5.86887e+18,82.4325,1119.21,11527,73,76,6104,3681,1337,1225,845
5808,116,138,3554,2254,5.86773e+18,70.8833,660.095,5808,59,63,5670,5651,5068,5388,5193
54488,71,262,34091,20397,5.88903e+18,230.47,3009.75,54488,190,188,48560,42497,12421,18289,16622
8251,138,212,5103,3148,5.87185e+18,101.739,911.071,8251,72,71,8039,7931,6516,7098,6662
53971,211,342,33241,20730,5.87042e+18,138.652,2639.37,53971,107,110,53627,53506,39258,34669,44478
95397,211,230,58891,36506,5.87006e+18,137.001,3176.95,95397,95,100,95167,95159,94307,94680,94875
35065,84,172,21572,13493,5.87031e+18,102.423,1804.24,35065,79,85,34757,34568,17642,16192,16644
79738,73,273,49485,30253,5.87401e+18,231.054,3168.07,79738,163,159,76782,74466,17484,29187,23036
66810,124,286,41488,25322,5.88037e+18,237.35,3249.12,66810,182,176,64929,62543,31614,30726,34717
89380,195,298,55116,34264,5.87067e+18,167.503,3253.9,89380,123,128,89009,88791,72288,71423,72717
30443,36,173,18784,11659,5.86952e+18,104.233,1661.29,30443,78,83,28055,25187,5798,9093,8028
35865,49,220,22056,13809,5.86975e+18,120.847,1803.46,35865,87,92,34703,33686,9604,13017,11963
62319,195,295,38505,23814,5.87081e+18,156.617,2710.82,62319,108,109,62017,61898,59537,60035,59699
82736,48,315,51072,31664,5.87152e+18,203.557,3286.74,82736,127,134,78842,75012,16969,25298,23586
28882,30,298,18014,10868,5.88463e+18,145.863,2309.48,28882,141,143,21783,15675,5594,7267,5732
96076,9626,10757,60512,35564,5.78936e+18,427.243,17396.7,96076,771,290,85319,85312,73595,77867,26567
99518,162,230,61348,38170,5.8701e+18,139.524,3192.08,99518,97,105,99282,99131,83260,87318,91645
53248,29,312,32913,20335,5.87039e+18,143.925,2499.41,53248,94,103,45759,36446,8600,14050,10846
24327,61,174,14969,9358,5.86906e+18,106.039,1411.35,24327,75,81,23839,23543,9562,11057,10884
83537,83,225,51595,31942,5.87006e+18,151.094,3043.75,83537,94,93,83005,82771,40066,38672,44238
77828,165,270,48115,29713,5.87013e+18,197.355,3110.39,77828,104,109,77451,77081,52959,44386,56658
65688,204,217,40458,25230,5.87013e+18,126.703,2626.16,65688,90,97,65471,65466,63946,65001,65196
77717,198,301,47828,29889,5.87084e+18,188.685,3008.81,77717,113,117,77395,77202,64557,70885,70027
12957,206,240,7994,4963,5.87241e+18,130.713,1235.55,12957,89,90,12717,12682,11400,12173,11400
22703,40,256,13990,8713,5.87305e+18,139.185,1622.13,22703,95,97,20954,19046,4854,7332,6426
2172,32,145,1345,827,5.87703e+18,73.3379,441.115,2172,49,50,1828,1590,425,701,438
43254,131,177,26581,16673,5.87026e+18,102.038,2005.67,43254,81,88,43071,42976,35734,39033,36573
37579,63,264,23265,14314,5.87293e+18,198.847,2095.63,37579,114,120,36087,34894,9182,13622,11658
10944,49,126,6726,4218,5.8688e+18,60.6277,936.126,10944,65,65,10603,10108,4820,4767,4706
69325,36,272,42830,26495,5.87533e+18,229.054,3060.83,69325,163,170,60561,52753,10381,18237,9256
60820,125,326,37620,23200,5.87192e+18,193.243,2866.39,60820,112,117,60310,59932,34983,30164,31859
90374,217,227,55782,34592,5.87012e+18,139.184,3098.26,90374,93,100,90147,90146,90142,90144,90146
77710,244,254,48011,29699,5.87025e+18,148.615,3088.6,77710,104,104,77456,77415,77426,77429,77433
63529,107,237,39250,24279,5.87018e+18,119.952,2489.14,63529,94,104,63136,62753,34606,33828,45461
8685,193,227,5385,3300,5.87722e+18,108.03,1016.24,8685,80,78,8458,8430,7643,8007,8052
49399,158,184,30411,18988,5.86995e+18,115.167,2207.18,49399,83,87,49215,49168,45824,47608,48228
49047,39,274,30358,18689,5.87726e+18,192.421,2617.75,49047,158,152,43027,37546,7626,13079,8941
83174,134,232,51318,31856,5.87006e+18,129.453,2983.12,83174,92,97,82903,82701,58773,55645,56305
39863,127,287,25022,14841,5.89372e+18,207.209,2703.25,39863,177,176,38150,35731,18218,18515,18858
92075,41,231,56773,35302,5.8702e+18,143.323,3066.68,92075,96,103,86999,79423,19143,28697,25681
96214,219,306,59425,36789,5.87075e+18,159.865,3347.83,96214,117,130,95885,95772,79171,86299,79530
69860,33,260,43049,26811,5.87045e+18,129.466,2709.68,69860,98,102,62726,51419,12829,20609,15491
80913,67,293,49853,31060,5.8702e+18,161.732,2942.78,80913,107,115,79598,78525,22319,31200,34088
85520,257,285,53374,32146,5.88308e+18,245.404,3740.76,85520,197,194,85218,85103,79726,82842,83801
19518,112,250,12035,7483,5.8717e+18,137.756,1477.62,19518,92,96,19097,18714,9450,9752,9894
71122,278,307,44262,26860,5.88428e+18,230.064,3539.41,71122,187,187,70815,70712,67797,68676,68510
60376,181,299,37180,23196,5.8706e+18,156.489,2702,60376,110,115,59992,59768,45199,42300,45001
5368,4,187,3307,2061,5.87464e+18,92.9005,742.091,5368,70,66,1307,0,25,217,9
49123,84,182,30281,18842,5.87025e+18,117.047,2207.38,49123,84,86,48791,48633,24886,22912,26223
63476,397,426,39715,23761,5.88579e+18,221.629,3986.54,63476,185,192,63050,63015,60996,62119,57612
7613,198,232,4688,2925,5.8718e+18,55.9149,921.487,7613,64,68,7381,7380,7350,7356,7337
64430,179,274,39767,24663,5.87399e+18,211.846,2868.62,64430,142,151,63879,63389,45347,42637,44945
84512,259,314,52127,32385,5.87219e+18,166.375,3414.46,84512,139,136,84194,84101,77353,80514,75928
95794,2459,4214,60358,35436,5.8627e+18,259.133,8908.66,95794,286,231,91580,91540,56014,63277,6724
46499,97,226,28615,17884,5.87017e+18,125.382,2066.85,46499,92,96,46076,45700,23800,23878,26168
37557,6,193,23134,14423,5.87023e+18,101.795,1926.92,37557,85,88,12773,0,1208,2118,1650
1029,125,169,652,377,5.90442e+18,87.9397,372.656,1029,50,46,860,816,733,730,757
92387,239,327,57268,35119,5.87654e+18,183.098,3924.57,92387,169,178,92035,91891,81885,83617,77027
77369,28,209,47789,29580,5.87015e+18,129.585,2857.96,77369,90,93,64777,48552,13090,19142,16895
30298,242,274,18737,11561,5.87522e+18,170.207,2065.65,30298,119,121,30024,29971,27596,28826,28219
25618,240,261,16013,9605,5.8858e+18,212.133,2060.13,25618,142,146,25345,25294,22404,24083,23324
43859,219,272,27076,16783,5.87408e+18,168.768,2400.3,43859,130,136,43544,43389,36598,39834,35259
84615,9,294,52131,32484,5.87038e+18,158.052,3008.71,84615,107,113,41473,0,7242,7481,3924
88442,239,279,54643,33799,5.87003e+18,146.646,3295.28,88442,108,111,88163,88051,84064,85728,85224
38437,142,258,23623,14814,5.87236e+18,191.084,2056.29,38437,109,116,37971,37696,24658,22385,24579
18097,88,261,11187,6910,5.86947e+18,121.046,1469.93,18097,76,82,17684,17426,7580,7109,6316
17039,18,146,10535,6504,5.86996e+18,71.7096,1275.33,17039,75,76,11470,6932,2276,3032,2664
99246,75,288,61163,38083,5.87033e+18,149.057,3283.95,99246,109,111,98165,97464,29325,39846,40795
63312,100,265,39754,23558,5.89087e+18,227.442,3270.44,63312,195,194,59146,54364,25480,24288,28263
25378,143,237,15652,9726,5.86988e+18,84.4629,1651.46,25378,83,80,25141,25086,24399,24361,24269
52237,30,180,32264,19973,5.86986e+18,116.792,2258.21,52237,83,85,45213,36008,9303,13504,11020
24046,59,191,14896,9150,5.87067e+18,98.2093,1526.28,24046,78,76,23559,22997,10841,10857,9029
11799,14,205,7262,4537,5.87071e+18,92.6078,1028.56,11799,72,77,8098,5020,1582,2101,1436
41450,17,302,25536,15914,5.87501e+18,167.503,2463.53,41450,134,131,29070,19431,3905,7468,3683
12768,62,138,7860,4908,5.8708e+18,82.5611,1008.11,12768,68,68,12540,12453,7024,7606,7359
98561,263,277,61235,37326,5.87662e+18,241.117,3700.39,98561,184,185,98274,98206,92885,95742,95951
6725,18,133,4137,2588,5.87039e+18,69.0394,738.224,6725,57,57,4988,3304,927,1089,755
5704,34,135,3528,2176,5.86585e+18,68.1767,713.527,5704,62,63,4910,3746,1944,2012,2285
4708,177,225,2946,1762,5.89842e+18,125.896,897.641,4708,91,81,4483,4458,3736,3685,3573
52720,165,299,32497,20223,5.8709e+18,151.234,2577.91,52720,106,112,52319,52094,39000,38299,40289
49315,38,228,30495,18820,5.87025e+18,128.567,2128,49315,90,97,46150,42597,9211,13239,13180
28459,37,159,17531,10928,5.8698e+18,79.6258,1609.75,28459,75,78,26180,23454,6783,9626,8145
7590,38,76,4713,2877,5.87009e+18,64.2516,641.867,7590,61,62,7005,6321,3520,3444,4160
25472,55,253,15790,9682,5.87161e+18,128.099,1668.88,25472,96,100,24381,23651,5936,9170,8666
78186,16,307,48682,29504,5.88497e+18,239.791,3703.81,78186,198,192,47856,28447,7290,11695,4987
13986,128,139,8602,5384,5.87119e+18,84.4187,1065.91,13986,67,71,13847,13819,13677,13672,13573
89808,127,226,55487,34321,5.87015e+18,155.972,3140.32,89808,95,97,89490,89233,62644,59831,70235
19879,61,254,12313,7566,5.87124e+18,145.308,1513.88,19879,92,94,18975,18303,4172,7075,5326
2116,40,117,1303,813,5.86247e+18,48.0435,388.762,2116,42,45,1948,1831,877,1020,981
19122,109,244,11795,7327,5.87006e+18,84.648,1452.24,19122,84,80,18873,18730,14183,13927,13943
16433,217,227,10154,6279,5.86959e+18,101.731,1233.96,16433,81,80,16206,16206,15820,16039,16125
91789,66,217,56599,35190,5.87015e+18,135.807,3076.08,91789,92,101,90765,89773,33311,36822,40015
16863,24,240,10347,6516,5.87399e+18,126.883,1339.73,16863,90,85,14022,11224,1773,4001,1106
88698,5,286,54979,33719,5.87895e+18,236.964,3650.5,88698,193,188,25338,0,848,4870,1723
2116,25,133,1300,816,5.86857e+18,54.4849,415.852,2116,46,46,1795,1510,414,585,490
40156,9,193,24787,15369,5.87021e+18,100.208,2058.34,40156,85,83,18534,0,3104,3763,2743
4312,51,82,2658,1654,5.86772e+18,61.9712,508.163,4312,59,58,4115,3822,2990,2888,3584
86529,270,300,53260,33269,5.87121e+18,202.886,3196.43,86529,123,127,86229,86144,84403,85427,84980
20820,146,147,12876,7944,5.86964e+18,98.0447,1299.21,20820,69,76,20673,20673,20673,20673,20673
89841,18,211,55488,34353,5.86997e+18,130.539,3066.46,89841,93,98,63152,39510,11450,11440,9365
25030,139,218,15402,9628,5.86966e+18,111.038,1516.73,25030,80,87,24789,24684,19257,18918,21891
15914,160,255,9882,6032,5.881e+18,184.113,1542.06,15914,115,116,15528,15253,10729,10456,10151
87059,5,215,53702,33357,5.87003e+18,136.161,2989.6,87059,93,98,24917,0,492,3341,2565
50552,44,254,31184,19368,5.8705e+18,128.893,2318.06,50552,95,97,48218,45251,11502,16504,13790
60550,137,314,37411,23139,5.87281e+18,160.653,2992.68,60550,131,128,59888,59438,43056,46328,42695
26320,47,155,16192,10128,5.86962e+18,80.8613,1545.45,26320,74,77,25314,24043,8204,10044,9335
32461,91,201,20086,12375,5.87004e+18,102.064,1918.39,32461,83,82,32206,32124,22886,21564,21118
73346,72,217,45338,28008,5.87016e+18,122.242,2772.47,73346,92,94,72702,72164,32261,34619,35608
43359,100,224,26683,16676,5.87013e+18,163.464,2010.52,43359,99,102,42856,42372,21836,22442,25750
47275,4,316,29224,18051,5.87454e+18,147.889,2711.44,47275,126,124,10774,0,10,990,970
74807,262,300,46193,28614,5.87109e+18,201.93,2999.43,74807,115,118,74507,74395,71309,73137,72753
84801,4,273,52182,32619,5.87076e+18,169.026,2958.45,84801,121,131,20221,0,3,1654,810
94634,26,307,58983,35651,5.88559e+18,236.184,4065.49,94634,211,197,68926,47011,10974,19336,9349
54213,146,212,33347,20866,5.87029e+18,129.502,2313.17,54213,90,97,54001,53869,46569,49795,49849
85921,82,374,53232,32689,5.87312e+18,219.327,3432.62,85921,147,158,83439,81190,17513,30360,12765
31603,168,170,19526,12077,5.86964e+18,98.7935,1726.9,31603,76,79,31433,31433,31431,31432,31433
55282,8,204,34170,21112,5.87036e+18,128.692,2391.85,55282,85,86,23132,0,2908,4587,3063
66229,39,426,41442,24787,5.88628e+18,218.191,4072.42,66229,185,195,52578,40492,10624,15317,7842
51304,50,411,31857,19447,5.87694e+18,168.515,3382.88,51304,153,145,46328,40709,13483,15828,13446
23284,208,246,14358,8926,5.87205e+18,175.108,1662.12,23284,109,110,23018,22874,20119,21711,21056
78755,287,302,48535,30220,5.87072e+18,160.942,3075.58,78755,114,123,78453,78439,75663,77055,76583
45692,46,219,28249,17443,5.87023e+18,160.911,2056.74,45692,95,104,43822,42303,9706,14706,14429
75264,38,301,46362,28902,5.87097e+18,163.683,2976.6,75264,116,116,69801,64079,13548,22292,17390
96317,64,346,59511,36806,5.87941e+18,226.86,3850.78,96317,196,186,89657,83553,18211,31514,1401
4090,66,79,2532,1558,5.8692e+18,69.1785,501.38,4090,58,61,3983,3862,3295,3486,3509
59988,10,224,37117,22871,5.87021e+18,127.365,2558.15,59988,87,90,29589,19823,5228,5139,1834
65296,220,342,40311,24985,5.87046e+18,145.66,2988.5,65296,115,111,64944,64798,57257,56126,59954
62002,254,279,38307,23695,5.8703e+18,153.289,2711.32,62002,96,103,61723,61688,57147,60009,53858
14971,201,212,9168,5803,5.87117e+18,103.622,1157.19,14971,75,80,14759,14757,14551,14626,14758
53193,183,279,32878,20315,5.87019e+18,138.347,2636.23,53193,104,99,52857,52647,47437,47659,50055
30003,236,307,18536,11467,5.87587e+18,188.999,2212.28,30003,122,117,29696,29591,28247,28300,28186
11213,47,156,6922,4291,5.87021e+18,72.9894,1016.09,11213,69,72,10655,10070,4501,4857,5550
7095,153,222,4474,2621,5.89448e+18,159.092,1061.93,7095,103,93,6794,6588,5165,5354,5518
53029,81,235,32780,20249,5.8701e+18,117.146,2248.49,53029,92,101,52434,52009,23300,24637,27803
90099,75,306,55588,34511,5.87059e+18,147.929,3284.05,90099,120,124,88711,87730,26342,37694,35447
21636,46,165,13327,8309,5.87039e+18,83.0251,1437.04,21636,78,78,20657,19525,8147,9125,9084
26236,5,158,16203,10033,5.87062e+18,97.8983,1550.43,26236,78,79,7380,0,115,1195,907
62719,228,285,39080,23639,5.87971e+18,235.865,3123.13,62719,180,171,62372,62121,52082,55869,56069
42132,305,397,26136,15996,5.87408e+18,164.753,2895.53,42132,130,127,41735,41644,38985,39718,36551
19922,119,128,12370,7552,5.86966e+18,66.4145,1278.95,19922,72,71,19794,19794,19180,19587,19408
16224,75,245,9984,6240,5.87056e+18,101.839,1321.63,16224,78,80,15828,15597,5641,7133,5957
30700,155,258,19304,11396,5.89354e+18,188.974,2269.98,30700,172,156,29982,29036,19966,19816,22210
73376,93,275,45193,28183,5.8749e+18,232.12,3063.31,73376,155,157,71350,69299,26705,30052,33701
38790,179,268,23882,14908,5.87369e+18,206.721,2187.41,38790,124,124,38402,38096,27864,31257,29728
56899,5,237,35157,21742,5.87016e+18,116.557,2400.47,56899,95,101,16709,0,257,2691,1494
78593,117,285,48891,29702,5.87911e+18,227.305,3424.01,78593,184,185,76434,73720,36005,35345,37860
42785,12,397,26547,16238,5.87497e+18,178.624,2908.55,42785,141,140,24241,14939,3925,5994,1922
24775,139,148,15293,9482,5.86966e+18,100.073,1436.01,24775,74,78,24627,24623,24210,24408,24533
33699,20,158,20851,12848,5.86988e+18,91.9357,1753.03,33699,78,80,24659,17626,4897,6307,4975
15640,6,282,9757,5883,5.88636e+18,127.508,1709.45,15640,115,117,4590,0,427,610,736
45362,110,411,28173,17189,5.88051e+18,203.849,3273.44,45362,159,160,43653,41862,19449,20337,16767
13885,12,126,8603,5282,5.86988e+18,62.4674,1058.61,13885,66,69,7929,4868,1383,1805,1343
99028,136,253,61142,37886,5.8702e+18,163.873,3369.18,99028,100,103,98664,98300,73640,70674,82359
57658,62,199,35510,22148,5.87004e+18,125.769,2380.35,57658,89,92,56791,56153,20577,22822,23892
68225,189,258,42171,26054,5.87045e+18,150.364,2577.83,68225,106,112,67937,67830,53040,60288,54831
68191,29,224,42164,26027,5.87001e+18,126.039,2738.25,68191,89,91,57289,42857,12683,18210,13483
95788,230,317,59211,36577,5.87263e+18,187.955,3640.72,95788,150,157,95415,95189,79139,85168,75324
69888,49,215,43077,26811,5.87008e+18,140.369,2689.31,69888,89,96,67546,64561,16422,24082,20096
78051,158,275,48031,30020,5.87407e+18,216.173,3106.69,78051,157,159,77286,76702,50481,45547,54149
42506,40,307,26462,16044,5.88487e+18,196.269,2807.53,42506,161,159,35233,28369,7205,10985,8441
36424,73,173,22500,13924,5.86956e+18,101.263,1827.56,36424,80,86,36046,35840,17369,17267,20395
53104,229,286,32987,20117,5.88086e+18,204.364,2917.58,53104,167,174,52776,52571,44786,46887,43323
36846,169,194,22765,14081,5.86976e+18,109.596,1970.46,36846,82,84,36652,36645,34991,35976,35622
14229,110,135,8758,5471,5.86905e+18,84.5309,1066.63,14229,67,71,14088,14043,12353,13288,12541
4952,22,76,3054,1898,5.86734e+18,59.7314,525.862,4952,58,57,3754,2723,1210,1504,1914
80924,99,307,50417,30507,5.8849e+18,244.389,3782.65,80924,196,194,76644,71710,29077,30865,29410
42546,5,265,26324,16222,5.87198e+18,168.394,2157.02,42546,106,114,12918,0,204,2140,987
22594,63,256,13930,8664,5.87255e+18,128.667,1615.89,22594,93,96,21765,21161,8436,10432,9981
14527,226,279,8987,5540,5.87172e+18,118.942,1450.42,14527,88,93,14248,14212,12881,13622,12599
23941,13,185,14803,9138,5.86993e+18,86.0724,1626.98,23941,79,80,13534,7815,2667,2541,2850
72990,153,214,44961,28029,5.87019e+18,132.514,2687.59,72990,96,99,72772,72651,62432,64054,66363
49081,199,274,30322,18759,5.87498e+18,219.55,2572.43,49081,139,145,48676,48349,37180,40547,36206
42132,209,272,26041,16091,5.87501e+18,220.398,2391.06,42132,136,139,41786,41542,34760,37847,35650
66968,160,314,41353,25615,5.8718e+18,200.696,3061.62,66968,129,122,66501,66234,44551,45836,44652
34061,127,173,21033,13028,5.87001e+18,101.505,1745.57,34061,80,86,33881,33816,27247,29380,28104
13415,16,211,8263,5152,5.87063e+18,95.8964,1093.94,13415,74,77,9828,7145,1906,2703,1964
23255,41,255,14313,8942,5.87139e+18,135.045,1634.83,23255,92,95,21622,19822,5275,7469,5944
20735,25,254,12859,7876,5.87151e+18,128.714,1547.36,20735,96,96,17123,13441,3407,5532,4276
37459,82,262,23632,13827,5.89762e+18,212.889,2539.58,37459,180,172,33009,27738,11768,11820,14018
65109,82,225,40223,24886,5.87029e+18,133.408,2678.38,65109,90,90,64677,64484,30753,30148,32395
91849,93,315,56634,35215,5.87296e+18,188.069,3582.17,91849,151,152,90008,88160,36041,42030,39335
10571,4035,4947,6616,3955,5.52789e+18,377.245,6288.37,10571,402,160,5624,5623,4949,4974,4748
76884,236,298,47458,29426,5.87059e+18,158.67,3012.53,76884,113,118,76578,76467,71545,74255,71178
55355,171,200,34164,21191,5.87019e+18,122.02,2348.45,55355,86,92,55155,55087,50529,53223,53840
25839,43,174,15985,9854,5.87013e+18,82.591,1612.63,25839,77,78,24468,22372,6074,8812,8718
40590,256,261,25448,15142,5.89063e+18,220.951,2599.76,40590,177,170,40329,40304,40101,40222,40267
46244,207,286,28743,17501,5.88201e+18,192.447,2750.79,46244,160,168,45851,45582,36504,37700,34450
68352,38,235,42104,26248,5.87002e+18,126.665,2575.41,68352,99,107,63820,58884,12031,19632,18589
65758,88,279,40733,25025,5.8779e+18,230.308,3090.87,65758,173,168,62794,59578,21582,25981,23175
13807,132,154,8533,5274,5.86882e+18,89.593,1071.22,13807,66,69,13653,13599,12490,13183,12491
86768,42,397,53746,33022,5.87205e+18,177.408,3842.44,86768,140,136,79600,70672,17934,26290,18976
37774,258,282,23759,14015,5.89449e+18,207.424,2615.92,37774,179,165,37492,37394,35830,36408,36636
96086,260,412,60103,35983,5.88692e+18,243.414,4398.39,96086,206,213,95655,95571,60359,58970,40402
80142,247,272,49515,30627,5.87496e+18,226.319,3267.69,80142,173,171,79843,79712,71071,75807,77049
34915,209,247,21628,13287,5.8704e+18,126.804,2118.25,34915,97,97,34667,34626,33445,34097,34475
78344,84,214,48402,29942,5.87016e+18,131.648,2875.02,78344,90,94,77860,77617,38556,37337,44328
77620,256,301,47793,29827,5.87095e+18,198.251,3046.84,77620,117,119,77319,77208,74554,76016,75286
42941,5,173,26549,16392,5.87034e+18,92.8427,2028.26,42941,82,81,11929,0,136,1713,1791
26227,184,253,16421,9806,5.88603e+18,199.027,2014.87,26227,150,143,25849,25426,20366,21967,20979
65364,306,328,40567,24797,5.87915e+18,191.028,3422.01,65364,164,171,65036,65003,62185,63608,61543
97779,97,282,60286,37493,5.87262e+18,222.256,3439.11,97779,158,161,95739,93665,38557,41473,40052
6587,65,75,4051,2536,5.86992e+18,63.6284,602.749,6587,60,62,6494,6447,5793,6134,6297
77433,228,259,47900,29533,5.86992e+18,150.751,3055.44,77433,104,101,77173,77092,75782,76591,76911
32825,294,411,20444,12381,5.88235e+18,177.852,2852.05,32825,155,149,32414,32347,28342,28494,22926
59649,268,411,36994,22655,5.88126e+18,213.132,3604.78,59649,177,179,59238,59142,43264,43515,30752
15235,101,232,9377,5858,5.86954e+18,110.082,1206.68,15235,77,81,14926,14671,8296,8226,9500
62851,189,217,38737,24114,5.87018e+18,125.786,2565.47,62851,89,94,62634,62626,59551,61311,60581
61771,261,266,38015,23756,5.87106e+18,167.67,2536.48,61771,114,120,61505,61505,60931,61341,61505
63698,191,291,39954,23744,5.89174e+18,241.585,3402.12,63698,200,196,63081,62323,44251,45215,47178
12272,15,143,7581,4691,5.87071e+18,69.9813,988.963,12272,69,72,7708,4437,1710,2149,2435
84891,199,281,52799,32092,5.88235e+18,212.092,3677.41,84891,196,192,84342,83614,65091,69748,67343
34601,93,163,21271,13330,5.87027e+18,113.736,1701.4,34601,79,85,34312,34085,22490,20640,25272
71479,60,293,44065,27414,5.87011e+18,164.07,2793.61,71479,105,112,69987,68589,16407,26472,26838
39613,125,171,24482,15131,5.8697e+18,97.9176,1961.07,39613,84,84,39434,39395,33524,34005,32236
8877,96,153,5457,3420,5.86898e+18,72.0198,862.69,8877,63,64,8724,8679,7656,8039,7755
45310,151,189,27923,17387,5.86979e+18,121.499,2017.09,45310,85,92,45115,45063,38980,42297,40370
35532,107,273,22088,13444,5.87543e+18,195.979,2207.88,35532,130,127,34559,33579,16624,15625,15459
6850,188,246,4299,2551,5.88996e+18,150.107,1096.77,6850,94,92,6596,6527,5372,5499,5102
75760,197,270,46918,28842,5.87012e+18,239.519,3285.8,75760,134,138,75231,74819,58648,57072,64854
3683,36,102,2271,1412,5.86464e+18,47.3065,491.333,3683,49,50,3404,3137,1322,1549,1365
66121,76,328,41041,25080,5.87871e+18,171.105,3437.28,66121,163,168,62875,59631,24427,27658,25931
63951,194,198,39475,24476,5.87008e+18,116.999,2576.62,63951,85,90,63753,63753,63750,63751,63490
44795,27,175,27686,17109,5.8699e+18,109.507,2067.34,44795,81,82,36699,26439,7873,11641,8887
14295,101,250,8868,5427,5.87379e+18,100.508,1305.87,14295,82,82,13907,13696,9675,9505,10005
1871,163,185,1160,711,5.87465e+18,46.8947,459.684,1871,49,50,1686,1686,1674,1675,1683
54431,116,312,33823,20608,5.88117e+18,199.613,3078.75,54431,166,171,52596,50429,24917,26276,19169
84520,201,290,52891,31629,5.88988e+18,239.668,3855.48,84520,207,208,83922,83109,58242,61855,66329
80502,228,315,49682,30820,5.87109e+18,201.627,3196.81,80502,121,130,80187,80063,78790,79195,78578
42022,47,258,25834,16188,5.87298e+18,197.097,2168.03,42022,116,116,39667,37798,7984,12945,7322
38762,134,272,23931,14831,5.87457e+18,220.873,2266.63,38762,129,132,38074,37513,21773,20035,20078
94654,111,342,58441,36213,5.87055e+18,163.235,3488.13,94654,118,116,93911,93323,54961,52022,63817
17724,87,139,10887,6837,5.87063e+18,93.4428,1176.22,17724,67,74,17533,17412,12194,11574,13289
47625,26,199,29397,18228,5.87043e+18,107.41,2181.91,47625,84,89,39465,29578,7672,12507,6432
35537,162,192,21969,13568,5.8694e+18,108.891,1933.89,35537,84,83,35345,35334,33336,34537,33499
60416,67,304,37286,23130,5.87408e+18,189.842,2960.63,60416,146,143,57960,55655,20899,29107,23649
34843,52,226,21439,13404,5.86955e+18,124.14,1796.09,34843,89,94,33770,32673,8928,12563,13313
41935,185,224,25775,16160,5.87014e+18,126.594,1954.57,41935,90,103,41711,41673,35860,39071,38445
17472,60,253,10880,6592,5.88509e+18,197.022,1633.29,17472,122,124,15552,14007,3869,6095,5290
49133,20,228,30379,18754,5.86994e+18,122.089,2128.6,49133,91,97,38036,28499,6132,9917,8613
1603,43,62,999,604,5.86127e+18,52.7074,275.676,1603,42,40,1504,1408,1009,933,1080
81726,240,301,50307,31419,5.87044e+18,157.266,3073.28,81726,120,129,81425,81341,69392,76324,64908
25787,37,178,15973,9814,5.87045e+18,76.5832,1607.4,25787,79,77,23299,20310,8494,9488,9559
87206,25,264,53780,33426,5.86994e+18,146.282,3033.06,87206,103,110,72086,54078,12139,17448,12827
70514,97,270,43341,27173,5.87186e+18,196.959,2782.46,70514,131,134,69310,68194,29471,30462,31629
85224,190,342,53155,32069,5.88453e+18,194.557,4140.63,85224,184,196,84617,84071,63097,61292,54730
67752,167,213,41721,26031,5.8701e+18,131.483,2581.54,67752,97,99,67539,67467,63661,65123,65761
63206,36,288,38997,24209,5.86984e+18,145.957,2666.24,63206,100,104,57851,51952,10726,15832,13737
70097,89,269,43140,26957,5.87122e+18,180.865,2716.85,70097,119,125,68987,67883,24017,28545,24139
77176,226,274,47709,29467,5.8757e+18,230.104,3227.39,77176,183,168,76810,76469,64617,70942,70322
79473,262,302,48994,30479,5.87069e+18,162.525,3087.36,79473,113,122,79171,79104,70960,75735,73710
25299,67,150,15579,9720,5.87022e+18,82.6985,1511.41,25299,76,79,25020,24743,11784,11555,12384
40398,113,224,24850,15548,5.87033e+18,127.727,1929.52,40398,88,100,40089,39774,21726,19919,21780
83675,268,342,51717,31958,5.87424e+18,191.995,3685.84,83675,149,145,83333,83228,81038,81197,79919
86644,38,286,53723,32921,5.87894e+18,240.939,3649.08,86644,185,194,74668,64019,14320,23673,15866
41196,35,296,25375,15821,5.87106e+18,135.597,2256.42,41196,93,97,37088,31489,7569,10437,9299
54807,364,397,33975,20832,5.87364e+18,172.178,3250.12,54807,143,139,54410,54358,52655,53670,51789
19590,14,255,12134,7456,5.87851e+18,152.276,1636.17,19590,119,109,12401,7273,1911,3271,1549
60856,103,225,37609,23247,5.87044e+18,136.085,2579.5,60856,89,90,60529,60339,34376,30793,31347
41625,146,181,25658,15967,5.86955e+18,115.865,2002.28,41625,81,84,41444,41383,39161,40291,39331
90740,179,309,56187,34553,5.87301e+18,198.412,3495.47,90740,152,159,90145,89561,60575,54312,55270
80764,164,293,49940,30824,5.87068e+18,151.306,3038.82,80764,115,126,80363,80118,51467,47319,49919
4301,62,77,2649,1652,5.86847e+18,65.9033,496.493,4301,55,56,4209,4158,3366,3076,3400
85824,131,288,52936,32888,5.87029e+18,149.45,3080.94,85824,104,107,85432,85128,54023,53326,65064
94877,186,278,58323,36554,5.87145e+18,183.78,3205.42,94877,135,140,94456,94110,68072,70849,66873
16197,135,159,9964,6233,5.86898e+18,90.1198,1144.65,16197,72,72,16038,15991,14224,15285,14383
13228,120,258,8321,4907,5.88876e+18,129.389,1536.18,13228,120,116,12619,11948,8338,8150,7282
48668,382,426,30342,18326,5.88181e+18,170.278,3501.55,48668,162,160,48242,48202,46309,47162,44166
52328,87,284,32513,19815,5.88118e+18,203.479,2895.96,52328,168,173,49427,46235,18050,22671,19548
55930,247,264,34631,21299,5.87091e+18,164.876,2424.95,55930,113,120,55666,55646,50673,53767,54183
60557,96,261,37955,22602,5.88903e+18,226.071,3157.68,60557,192,187,56471,51560,23703,22870,26414
36506,38,250,22559,13947,5.86973e+18,125.71,2142.58,36506,94,97,32960,29444,7286,10221,8609
95481,220,285,58882,36599,5.8701e+18,153.666,3225.79,95481,102,111,95196,95115,84005,90528,91996
15668,46,279,9702,5966,5.86991e+18,111.386,1502.28,15668,84,86,14661,13874,3547,5084,4061
71072,103,196,43877,27195,5.87007e+18,122.25,2715.07,71072,87,90,70766,70555,42972,41314,50745
35087,112,180,21613,13474,5.86969e+18,109.34,1842.63,35087,81,81,34879,34759,26861,27455,27597
18616,179,243,11537,7079,5.87387e+18,150.889,1443.95,18616,96,93,18338,18200,15189,16303,15888
51942,110,180,32080,19862,5.86991e+18,119.369,2247.67,51942,83,84,51704,51507,36810,36242,41314
13670,125,257,8468,5202,5.87006e+18,119.377,1359.03,13670,82,86,13334,13131,8479,7691,9262
53708,203,397,33306,20402,5.87402e+18,171.174,3199.27,53708,144,142,53231,53004,41047,40295,38756
36788,189,257,22612,14176,5.87309e+18,198.187,2046.28,36788,115,115,36448,36280,29912,32462,32500
98161,145,259,60720,37441,5.87011e+18,146.332,3437.84,98161,108,107,97727,97254,72878,68756,78723
47560,57,189,29334,18226,5.86974e+18,113.157,2078.71,47560,85,93,46673,45677,14640,18139,19338
30190,221,262,18916,11274,5.89181e+18,201.33,2249.44,30190,163,150,29916,29773,27334,27966,28617
16589,106,238,10174,6415,5.87385e+18,114.505,1297.83,16589,87,85,16250,15933,8817,8729,8876
4422,3,203,2759,1663,5.88154e+18,116.045,749.212,4422,74,66,711,0,4,108,9
43806,60,187,27088,16718,5.8699e+18,110.643,2074.39,43806,81,82,43143,42170,17048,18108,18226
66252,3825,6845,41725,24527,5.76921e+18,504.742,12551.1,66252,387,287,59407,59357,40613,43104,17644
36705,251,274,22678,14027,5.87465e+18,193.631,2235.53,36705,126,129,36431,36367,33761,35281,34765
25770,65,219,15925,9845,5.87038e+18,123.61,1543.47,25770,84,88,25186,24784,8997,10671,12140
81168,166,327,50316,30852,5.87521e+18,200.167,3626.18,81168,159,152,80591,80035,54635,59783,58937
8286,94,118,5088,3198,5.86722e+18,58.4263,791.41,8286,59,63,8168,8166,7311,7672,7180
64421,40,213,39724,24697,5.8701e+18,131.311,2530.05,64421,92,96,60753,55525,13873,19347,19149
96050,62,307,59810,36240,5.88431e+18,249.89,4073.92,96050,207,199,85985,76708,18459,30786,22508
46593,217,260,28705,17888,5.87174e+18,201.277,2298.86,46593,121,126,46294,46101,39185,43150,41707
37632,90,196,23186,14446,5.86997e+18,102.115,1955.89,37632,82,88,37322,37123,22554,21203,23152
22435,168,220,13880,8555,5.86963e+18,101.416,1425.44,22435,81,85,22215,22180,18198,20096,20181
35667,281,284,22270,13397,5.88344e+18,193.388,2462.22,35667,147,152,35383,35377,35027,35197,35254
55787,168,236,34488,21299,5.87015e+18,139.377,2556.76,55787,92,93,55544,55420,52144,53343,53376
5949,26,208,3689,2260,5.87631e+18,120.25,855.373,5949,83,75,4606,3600,806,1475,1008
3402,52,71,2096,1306,5.86885e+18,51.4491,418.89,3402,52,52,3302,3156,2801,2808,3111
84015,166,308,51790,32225,5.87339e+18,198.861,3392.5,84015,150,154,83340,82712,52845,46525,45622
79700,80,293,49123,30577,5.87014e+18,164.549,2923.65,79700,106,118,78732,78007,31179,34535,37250
50990,111,224,31350,19640,5.87063e+18,129.983,2153.7,50990,92,104,50641,50281,30178,27618,40175
87877,99,260,54141,33736,5.87029e+18,144.809,3027.59,87877,105,110,87282,86697,45810,44052,56621
63880,58,294,39436,24444,5.87037e+18,171.593,2667.34,63880,105,107,62377,60867,13441,21833,21400
82997,217,263,51203,31794,5.87001e+18,129.67,2967.36,82997,98,105,82734,82667,73042,78806,77456
52874,204,267,32724,20150,5.87165e+18,183.348,2379.57,52874,113,123,52572,52368,44890,48773,46831
64347,70,214,39763,24584,5.87007e+18,128.065,2590.91,64347,92,93,63679,63066,26187,28752,28597
74880,180,381,46314,28566,5.87107e+18,172.294,3372.67,74880,130,130,74367,74013,53709,53597,57200
95405,159,286,59322,36083,5.88209e+18,246.71,3911.9,95405,200,203,93963,92250,57754,52849,57034
86474,86,301,53232,33242,5.87081e+18,205.485,3197.93,86474,121,126,85261,84216,32578,36215,35266
12017,2,136,7401,4616,5.86891e+18,90.2821,1009.98,12017,67,67,1084,0,97,0,120
98307,83,342,61077,37230,5.88013e+18,212.932,4299.2,98307,184,182,93604,88369,29861,37783,36449
18556,77,157,11499,7057,5.8688e+18,71.5736,1239.13,18556,73,75,18394,18355,10122,9453,7967
74975,292,294,46298,28677,5.87032e+18,165.271,2852.8,74975,107,111,74681,74681,74680,74680,74681
29680,104,178,18286,11394,5.87013e+18,80.3642,1715.11,29680,78,82,29496,29397,23965,22857,22939
37066,48,268,23001,14065,5.87568e+18,164.181,2209.84,37066,130,125,34198,31780,6798,10973,6283
92205,112,281,56838,35367,5.87266e+18,198.309,3344.79,92205,156,149,90810,89138,42313,41853,37635
92557,209,275,56870,35687,5.87137e+18,168.741,3110.03,92557,128,132,92244,92031,78046,85285,81562
52960,134,291,32606,20354,5.87061e+18,171.622,2483.59,52960,114,118,52437,52008,25944,26280,25754
23720,63,256,14590,9130,5.8734e+18,134.44,1660.18,23720,99,100,22812,22106,7287,10221,9772
17791,50,270,11088,6703,5.87887e+18,127.605,1649.01,17791,108,104,16140,14651,5366,6397,5317
91034,88,245,56219,34815,5.8701e+18,161.913,3256.72,91034,100,100,90348,90016,45425,42833,50069
80457,209,308,49554,30903,5.87351e+18,211.153,3305.98,80457,152,155,80039,79636,56669,62061,52669
38177,167,176,23553,14624,5.86977e+18,82.0675,1968.08,38177,83,82,38001,37999,37281,37765,37350
18882,122,170,11628,7254,5.86931e+18,70.4518,1252.68,18882,77,78,18712,18667,18008,17975,17552
53260,148,225,32744,20516,5.87061e+18,127.469,2212.01,53260,92,104,53011,52853,38713,36373,47212
5700,57,123,3519,2181,5.86989e+18,66.1877,645.459,5700,56,54,5528,5468,3249,3228,3763
23973,48,157,14832,9141,5.86966e+18,100.871,1469.57,23973,75,77,23049,21759,7989,8954,7388
41581,161,262,25976,15605,5.885e+18,215.977,2563.34,41581,165,163,40845,40094,26588,25892,28151
17837,168,235,11271,6566,5.90267e+18,185.819,1723.25,17837,153,139,17473,17045,13718,13998,14693
20872,192,218,12848,8024,5.86954e+18,105.584,1389.46,20872,78,82,20654,20628,19735,20167,20349
11367,121,194,6986,4381,5.86983e+18,87.2614,1042.02,11367,67,71,11173,11105,10496,10657,10507
31371,153,173,19401,11970,5.86977e+18,105.788,1764.79,31371,78,81,31198,31154,29630,30315,30600
69023,9,300,42646,26377,5.87098e+18,156.373,2890.28,69023,113,122,34039,0,5758,6350,2088
39311,153,180,24211,15100,5.87004e+18,99.3422,1968.28,39311,80,83,39131,39095,36505,37924,37188
18776,193,285,11587,7189,5.87309e+18,126.333,1610.07,18776,91,89,18491,18457,17913,17865,17538
15594,54,253,9738,5856,5.88204e+18,194.212,1544.45,15594,115,117,13719,12439,3421,4925,4149
50648,107,211,31152,19496,5.86995e+18,122.498,2237.09,50648,86,92,50351,50116,33700,31165,33104
10496,49,266,6487,4009,5.8684e+18,101.003,1217.65,10496,73,77,9836,9473,2561,3592,2960
93381,138,301,57481,35900,5.87095e+18,204.115,3301.63,93381,127,129,92748,92196,57357,50339,61789
81910,61,277,51025,30885,5.87908e+18,233.178,3487.08,81910,187,182,75573,70145,16438,26952,19893
46882,113,270,29048,17834,5.87002e+18,202.948,2527.65,46882,109,110,46184,45624,22971,20023,27265
54120,206,235,33450,20670,5.87026e+18,116.175,2274.07,54120,92,101,53885,53876,49078,51816,50717
50659,72,202,31293,19366,5.87027e+18,119.762,2312.04,50659,84,85,50266,49842,23859,22074,23746
33011,158,224,20307,12704,5.86998e+18,130.969,1754.28,33011,89,91,32787,32717,23869,26752,24180
35288,95,261,21842,13446,5.88222e+18,201.941,2269.31,35288,157,143,33474,31592,13779,14210,15570
51656,91,5354,32525,19131,5.78536e+18,416.124,9962.07,51656,325,260,36107,27410,5971,12158,846
48799,30,256,30101,18698,5.87003e+18,119.78,2281.98,48799,91,94,42550,34821,8908,13186,9258
97873,61,319,60489,37384,5.87082e+18,197.917,3487.47,97873,121,134,95547,93513,26124,36428,31779
79610,45,278,49049,30561,5.87075e+18,150.792,2936.58,79610,117,126,75985,72115,15483,22372,18184
75258,223,286,46691,28567,5.8798e+18,238.703,3429.01,75258,180,187,74857,74493,60913,66535,59193
93939,92,327,58223,35716,5.87511e+18,210.373,3870.16,93939,162,164,91598,88947,36273,40224,40989
65342,96,260,40268,25074,5.8705e+18,134.015,2625.92,65342,98,101,64836,64398,33125,32468,36777
62367,76,266,38415,23952,5.87141e+18,200.736,2616.32,62367,131,127,60824,59616,15089,23805,16961
50889,11,285,31714,19175,5.88083e+18,207.341,2857.18,50889,164,166,26936,16509,3853,6256,2035
41464,168,299,25571,15893,5.87075e+18,141.872,2314.39,41464,100,101,41103,40963,34863,34455,35337
55653,242,273,34499,21154,5.87393e+18,175.211,2640.53,55653,139,137,55361,55297,48486,52330,50332
46080,136,263,28552,17528,5.8722e+18,200.31,2285.61,46080,127,124,45442,44965,25756,23170,28979
67421,53,307,42023,25398,5.88562e+18,236.564,3484.39,67421,190,182,58431,51652,11754,19139,11008
29412,89,174,18100,11312,5.87002e+18,104.696,1655.88,29412,80,79,29185,29077,19056,17859,20526
60938,54,259,37512,23426,5.87054e+18,117.072,2564.15,60938,94,105,59394,57186,16196,22525,20830
39116,98,240,24172,14944,5.87016e+18,116.196,2039.65,39116,82,91,38798,38628,26419,25103,28021
15789,240,249,9832,5957,5.88013e+18,157.566,1502.19,15789,116,114,15540,15528,15142,15371,15199
99969,241,286,61923,38046,5.87791e+18,242.753,3858.23,99969,187,195,99615,99349,84024,90897,87707
11122,11,179,6861,4261,5.87057e+18,79.0514,1050.71,11122,71,72,6233,4053,1108,1380,1087
38639,75,195,23823,14816,5.87027e+18,101.861,2020.25,38639,82,82,38317,38125,21845,22283,22691
32101,98,179,19853,12248,5.86991e+18,114.118,1635.26,32101,83,85,31829,31586,19586,18112,21150
34589,153,270,21383,13206,5.87557e+18,169.016,2159.53,34589,126,129,34063,33665,22791,21060,19609
28318,193,283,17459,10859,5.87114e+18,104.584,1889.55,28318,96,94,28032,27946,23951,25137,23362
69160,133,269,42569,26591,5.87085e+18,157.401,2680.54,69160,112,127,68624,68144,40593,39384,45722
71857,147,289,45231,26626,5.89598e+18,236.583,3613.1,71857,202,199,69943,66934,38383,35518,43118
36749,117,266,22817,13932,5.87471e+18,159.605,2165.59,36749,130,120,35989,35087,17824,16684,16412
83513,63,289,51465,32048,5.87048e+18,139.112,3029.17,83513,105,111,82091,80901,21248,32374,31250
35571,44,167,21901,13670,5.86976e+18,115.622,1728.63,35571,81,85,34197,32441,8625,12473,12004
45971,110,255,28317,17654,5.86996e+18,128.588,2165.17,45971,94,95,45614,45280,21938,22060,20696
53974,87,366,33365,20609,5.87056e+18,162.749,2799.86,53974,103,104,53188,52798,28627,26194,29410
64708,286,314,39943,24765,5.87295e+18,163.947,3066.06,64708,135,133,64394,64341,59640,62276,60233
24732,49,272,15295,9437,5.87681e+18,157.166,1879.4,24732,109,118,22750,21014,6727,8949,7055
10204,5,76,6278,3926,5.86877e+18,71.3848,764.868,10204,65,68,2825,0,78,393,697
88718,259,397,54965,33753,5.87319e+18,216.153,3700.55,88718,152,167,88305,88199,59594,59238,49842
97850,113,301,60242,37608,5.87096e+18,200.018,3365.03,97850,128,129,96991,96079,49556,45338,63687
48325,407,411,29975,18350,5.88371e+18,222.1,3118.33,48325,173,175,47914,47914,47910,47913,47547
22215,79,173,13769,8446,5.87053e+18,95.7047,1433.76,22215,74,74,22009,21952,11744,10823,7037
89165,156,275,54900,34265,5.87495e+18,234.377,3361.17,89165,168,166,88212,87341,54944,46934,55225
84818,191,285,52408,32410,5.86996e+18,167.805,3261.51,84818,106,104,84504,84375,80329,82393,83014
22817,43,258,14085,8732,5.87997e+18,174.472,1780.38,22817,125,122,20143,17740,4642,6977,5632
39514,26,217,24462,15052,5.87019e+18,128.329,2119.56,39514,87,87,31529,22329,6581,10215,6296
42762,112,224,26317,16445,5.87004e+18,165.448,2002.41,42762,96,102,42323,41895,23300,22776,29171
92490,279,289,57022,35468,5.87003e+18,144.188,3178.94,92490,108,111,92201,92197,92198,91626,92039
99606,43,229,61467,38139,5.87019e+18,153.653,3296.33,99606,96,98,94133,85926,21438,31316,28040
31983,113,221,19647,12336,5.87095e+18,119.114,1711.23,31983,85,94,31698,31463,19678,17237,20072
53341,296,300,32894,20447,5.87127e+18,130.921,2570.56,53341,104,105,53041,53041,52816,52991,53037
61606,138,266,37855,23751,5.87202e+18,169.346,2543.03,61606,117,124,61112,60681,37947,34495,44823
84819,99,316,52341,32478,5.8732e+18,185.964,3468.43,84819,146,148,83268,81801,38840,42711,43222
88467,84,294,54495,33972,5.87013e+18,161.863,3093.67,88467,108,116,87527,86728,31636,37741,41062
56237,34,261,35272,20965,5.89033e+18,229.916,3071.72,56237,186,184,42189,30051,7379,12042,8609
9388,91,144,5821,3567,5.87106e+18,64.0424,931.59,9388,66,68,9244,9224,7837,7483,7056
18679,133,146,11483,7196,5.86945e+18,90.7972,1245.25,18679,69,74,18533,18522,17905,18221,18229
5451,83,165,3352,2099,5.87305e+18,76.9987,691.373,5451,62,64,5244,5130,3470,3404,4136
55277,57,270,34471,20806,5.88128e+18,220.349,2902.95,55277,175,173,49571,45259,10723,17504,14539
14458,45,230,8866,5592,5.87269e+18,113.705,1187.34,14458,78,82,13609,12937,3255,4934,4868
58991,65,226,36293,22698,5.86995e+18,156.682,2342.3,58991,102,109,57818,57027,14383,22476,23913
41451,183,265,25634,15817,5.87637e+18,193.096,2348.69,41451,145,138,41022,40567,30408,32956,33160
82390,126,300,50727,31663,5.87102e+18,190.485,3119.13,82390,118,122,81789,81248,47256,41908,47058
49385,130,411,30667,18718,5.8829e+18,214.636,3315.58,49385,172,175,47849,45964,21292,21542,17363
34934,66,181,21482,13452,5.86996e+18,124.861,1714,34934,82,88,34318,33911,14029,14619,18729
29218,107,258,18067,11151,5.87614e+18,192.082,1986.89,29218,133,130,28204,27159,14090,14235,14325
33789,58,192,20877,12912,5.86949e+18,111.572,1816.92,33789,78,81,33193,32352,9912,12582,7936
75492,179,270,47176,28316,5.88478e+18,224.469,3478.73,75492,198,191,74673,73391,51299,52724,54492
98732,185,426,61754,36978,5.88639e+18,241.004,4614.11,98732,206,215,97726,96493,45103,43467,31021
77580,5,215,47787,29793,5.86986e+18,130.051,2775.19,77580,93,99,22433,0,590,3278,1893
95201,7,295,58739,36462,5.87022e+18,167.72,3196.68,95201,115,119,38327,0,5337,6418,4403
1520,187,188,953,567,5.88248e+18,86.2303,462.266,1520,52,53,1332,1332,1332,1332,1331
13584,114,264,8435,5149,5.88228e+18,173.742,1459.69,13584,107,110,12974,12409,6182,6322,4364
3938,23,102,2440,1498,5.86717e+18,45.132,513.031,3938,50,52,3225,2438,914,1226,993
46118,96,197,28405,17713,5.87041e+18,121.357,2126.32,46118,89,91,45806,45591,28760,26850,32811
28143,140,267,17425,10718,5.87664e+18,171.862,1985.72,28143,121,127,27553,27142,17506,16798,15560
17954,157,213,11048,6906,5.87023e+18,101.379,1268.79,17954,76,83,17741,17694,14396,15498,16109
6647,98,102,4116,2531,5.869e+18,55.1738,661.773,6647,57,58,6545,6545,6534,6542,6541
66113,193,198,40808,25305,5.86992e+18,118.171,2628.76,66113,87,90,65915,65915,65805,65913,65544
69749,184,335,43691,26058,5.88894e+18,206.791,3720.3,69749,186,197,69073,68278,46093,44299,36094
35381,97,158,21857,13524,5.87016e+18,91.2521,1809.33,35381,80,81,35179,35073,23427,21681,25586
73649,173,262,45382,28267,5.86989e+18,134.786,2775.34,73649,98,104,73382,73259,60469,59839,67649
17481,258,281,10831,6650,5.87302e+18,118.942,1566.8,17481,93,93,17200,17189,16605,16991,16690
22679,88,253,14145,8534,5.88504e+18,201.013,1865.91,22679,140,135,21054,19264,8593,9044,9351
92932,207,278,57470,35462,5.87078e+18,153.739,3156.49,92932,120,128,92616,92440,76201,83936,76424
43967,110,228,27172,16795,5.87058e+18,128.361,2032.2,43967,88,97,43638,43318,21861,20004,19919
38370,119,269,24003,14367,5.88576e+18,213.972,2491.92,38370,161,166,36805,34845,17537,16523,16375
7886,200,212,4849,3037,5.8718e+18,103.817,895.54,7886,74,73,7674,7673,7576,7587,7618
95118,285,305,59330,35788,5.8865e+18,236.291,4094.75,95118,199,208,94813,94758,84231,89914,87860
90070,151,271,55778,34292,5.87176e+18,191.585,3160.85,90070,144,144,89405,88848,53780,48286,50962
8364,125,144,5190,3174,5.87011e+18,63.7566,862.104,8364,65,67,8220,8220,7403,7859,7273
61656,259,307,38396,23260,5.88498e+18,223.06,3325.46,61656,184,176,61349,61222,55909,56611,57668
64446,55,272,39689,24757,5.87163e+18,202.292,2674.8,64446,131,132,61869,59925,13632,21318,17837
37693,162,173,23290,14403,5.86982e+18,113.708,1828.85,37693,80,89,37520,37511,36627,37165,37478
27885,26,174,17217,10668,5.86974e+18,79.9322,1671.85,27885,79,78,22819,16727,5647,6906,7470
18632,125,148,11505,7127,5.86934e+18,81.184,1258.67,18632,69,73,18484,18455,17281,18007,17856
84422,244,285,52665,31757,5.88149e+18,241.046,3648.94,84422,199,189,84101,83925,72939,77926,78799
49982,68,411,31026,18956,5.87732e+18,174.564,3350.69,49982,153,145,47054,44101,17692,19756,17868
43281,174,211,26731,16550,5.86984e+18,125.92,2212.34,43281,86,90,43070,43042,42023,42380,41901
96173,216,285,59265,36908,5.87012e+18,152.185,3235.38,96173,106,109,95888,95806,82047,89833,88278
58440,114,342,36083,22357,5.87053e+18,139.374,2847.3,58440,113,106,57827,57400,36421,35141,36467
87014,13,227,53711,33303,5.87014e+18,131.691,3045.99,87014,94,99,51852,30276,9601,8648,5621
65015,31,216,40057,24958,5.87018e+18,127.541,2613.28,65015,91,95,56776,45336,11904,12980,13926
76494,213,260,47262,29232,5.87017e+18,174.942,3115.97,76494,111,110,76201,76104,68275,72693,73781
96394,191,286,59712,36682,5.87797e+18,236.906,3801.22,96394,186,195,95705,94902,68315,66067,68465
5811,63,74,3621,2190,5.86922e+18,64.3934,564.857,5811,57,59,5716,5668,5026,5289,5409
71307,296,397,44197,27110,5.87357e+18,209.028,3392.29,71307,150,159,70910,70800,56355,61567,47547
17913,207,218,11023,6890,5.86942e+18,91.5039,1301.02,17913,77,81,17695,17690,17359,17542,17539
69930,49,314,43170,26760,5.87192e+18,191.023,3094.95,69930,127,123,66590,62971,16739,23704,23887
18388,80,121,11304,7084,5.86972e+18,64.8129,1226.41,18388,70,71,18267,18266,13845,12915,12119
72430,29,282,44587,27843,5.87444e+18,212.647,3036.69,72430,152,158,61574,50911,8675,17430,10316
59019,4,259,36490,22529,5.87001e+18,161.705,2731.73,59019,102,101,13329,0,15,2011,980
16059,93,242,9899,6160,5.87059e+18,84.1802,1349.51,16059,80,81,15783,15626,10683,10796,10418
41834,25,173,25795,16039,5.86964e+18,111.929,1923.84,41834,82,88,34808,26145,6606,8086,7189
2530,33,84,1561,969,5.86568e+18,40.5652,382.313,2530,45,43,2314,2006,1411,1402,1700
41248,147,265,25964,15284,5.89479e+18,216.123,2688.27,41248,177,172,40125,38507,25492,24165,26739
65954,68,195,40718,25236,5.86999e+18,113.318,2641.02,65954,88,89,65379,64578,29842,29332,31936
74619,197,218,45966,28653,5.87023e+18,127.616,2736.59,74619,94,101,74401,74396,71601,72908,73788
49780,59,272,30797,18983,5.87647e+18,224.505,2653.12,49780,159,153,46362,43666,11095,17382,13101
27119,45,282,17009,10110,5.89109e+18,206.643,2217.37,27119,160,146,21519,16576,4519,6393,5015
97255,291,320,59832,37423,5.87173e+18,231.89,3531.57,97255,134,144,96935,96860,96692,96820,96860
33912,148,221,20836,13076,5.87044e+18,123.412,1762.62,33912,86,95,33684,33540,25315,24790,28342
97112,291,381,60036,37076,5.87075e+18,173.288,3675.43,97112,133,136,96731,96604,80515,87699,75044
55143,224,285,34317,20826,5.87961e+18,229.873,2925.89,55143,163,165,54792,54548,45367,49469,47229
59339,39,194,36615,22724,5.87008e+18,114.695,2492.48,59339,86,88,55080,49600,12848,19394,15794
86318,57,426,54061,32257,5.88725e+18,230.859,4531.95,86318,201,213,74562,64432,16334,24157,12339
5702,113,190,3517,2185,5.87174e+18,87.9165,734.649,5702,60,62,5512,5436,4697,5070,4571
61325,76,185,37808,23517,5.87039e+18,119.653,2476.79,61325,85,89,60863,60602,28772,27329,32434
40641,46,180,25066,15575,5.87004e+18,114.077,2001.71,40641,82,83,39009,37023,11480,15440,15812
98416,120,286,61153,37263,5.8814e+18,242.305,3936.13,98416,205,197,95331,91282,44533,43892,45092
80126,199,278,49246,30880,5.87126e+18,150.9,2989.99,80126,119,124,79826,79655,61793,69971,55522
77322,167,307,47982,29340,5.88035e+18,249.935,3537.7,77322,184,194,76312,75188,49654,45939,51771
4566,171,214,2862,1704,5.8917e+18,130.948,835.54,4566,83,81,4334,4255,3687,3707,3724
88235,85,279,54502,33733,5.86995e+18,160.545,3249.29,88235,103,112,87337,86807,32634,34419,40611
55710,164,215,34377,21333,5.87002e+18,129.196,2416.01,55710,90,93,55495,55427,45799,50987,45825
20230,190,215,12443,7787,5.87073e+18,129.98,1384.43,20230,82,85,20015,19990,19600,19843,19878
7644,190,211,4713,2931,5.87203e+18,102.683,879.717,7644,72,66,7433,7430,7140,7297,7345
46357,127,190,28567,17790,5.86991e+18,110.538,2055.03,46357,85,91,46154,46013,34516,34838,37868
71887,212,328,44609,27278,5.87793e+18,180.17,3550.66,71887,164,170,71469,71207,58431,58306,53736
57185,22,208,35322,21863,5.87035e+18,118.974,2471.01,57185,86,90,43379,31180,8018,11854,7328
2356,50,85,1446,910,5.87145e+18,38.039,367.939,2356,42,45,2271,2269,1555,1556,1394
26855,32,219,16621,10234,5.87055e+18,105.965,1556.66,26855,81,86,24134,20534,5251,7941,6996
43459,60,273,26998,16461,5.87577e+18,233.664,2438.57,43459,135,140,40919,38934,9857,15208,12776
82899,132,222,51185,31714,5.87017e+18,139.396,2999.96,82899,92,95,82630,82423,62154,60558,68572
61026,273,285,38025,23001,5.87983e+18,205.173,3079.48,61026,171,174,60741,60713,57409,59196,58485
28746,120,191,17703,11043,5.87039e+18,97.3527,1666.02,28746,81,80,28555,28457,25679,25758,26785
81191,100,285,50583,30608,5.87975e+18,238.153,3521.93,81191,195,190,77927,74400,31671,32467,29350
63492,27,274,39179,24313,5.87364e+18,212.206,2827.05,63492,154,147,53048,42481,8708,14728,8103
78178,152,217,48227,29951,5.87006e+18,140.766,2832.5,78178,90,97,77949,77783,65755,69277,72442
98392,232,328,60976,37416,5.87473e+18,207.774,3885.3,98392,165,160,98063,97903,91229,92003,91509
51278,9,196,31648,19630,5.87038e+18,100.117,2324.08,51278,83,87,23703,0,3766,4252,3260
31267,91,198,19373,11894,5.87007e+18,115.733,1804.84,31267,81,81,31015,30932,18603,16178,18064
74809,123,313,46348,28461,5.878e+18,178.888,3508.47,74809,175,176,73130,71055,40624,41037,32468
81197,129,279,49974,31223,5.87383e+18,212.16,3165.8,81197,157,159,80046,78865,42626,39542,48957
80643,191,273,49621,31022,5.87082e+18,164.938,2876.08,80643,119,128,80306,80079,62158,68710,65843
13817,92,140,8518,5299,5.87049e+18,68.4722,1075.65,13817,67,66,13677,13660,10800,10295,10309
60278,131,199,37149,23129,5.87013e+18,127.263,2442.77,60278,89,92,60049,59893,47340,47829,51275
66985,206,211,41254,25731,5.8697e+18,133.024,2575.48,66985,92,97,66774,66774,66413,66721,66774
59711,83,194,36856,22855,5.86995e+18,113.89,2492.97,59711,86,88,59372,59241,31976,31911,33212
17416,94,244,10779,6637,5.87358e+18,141.055,1401.29,17416,94,90,16923,16500,7399,7353,7110
6618,36,109,4084,2534,5.8677e+18,54.4485,711.738,6618,60,60,6050,5354,2440,2647,2767
11690,141,154,7207,4483,5.86954e+18,64.0317,1032.54,11690,67,68,11536,11536,11331,11419,11208
77828,222,288,47983,29845,5.87023e+18,147.581,2923.03,77828,103,107,77540,77512,65952,71226,68994
5668,81,179,3487,2181,5.86848e+18,81.385,726.862,5668,61,60,5445,5348,3701,3874,4096
32693,251,262,20495,12198,5.8926e+18,218.451,2359.86,32693,170,166,32431,32359,32320,32373,32314
39558,84,265,24458,15100,5.87598e+18,191.496,2277.03,39558,138,137,37860,36249,13011,16240,17222
10120,32,202,6230,3890,5.86906e+18,92.58,959.535,10120,71,72,9070,8023,2075,3096,2762
52854,97,269,32952,19902,5.88203e+18,213.581,2850.9,52854,167,171,50319,47590,21729,22165,20480
11801,103,121,7329,4472,5.86967e+18,71.7888,916.112,11801,68,71,11680,11677,11649,11639,11609
2339,63,136,1446,893,5.86963e+18,95.8871,458.221,2339,54,49,2118,2004,1123,1206,1533
74610,14,298,46055,28555,5.87076e+18,164.396,3015.04,74610,116,122,47986,28660,8267,10416,5989
85150,100,327,52801,32349,5.87701e+18,185.568,3810.03,85150,168,178,82690,80065,38679,39796,36616
20018,115,138,12310,7708,5.86947e+18,70.599,1315.47,20018,71,73,19880,19872,17863,18848,17029
51601,68,202,31880,19721,5.87029e+18,118.734,2318.41,51601,85,86,51101,50392,24164,22337,24959
24985,137,151,15425,9560,5.8704e+18,78.6676,1484.83,24985,72,76,24834,24833,23809,24375,24239
31208,66,218,19207,12001,5.86948e+18,160.253,1706.42,31208,90,96,30444,29882,9740,13362,14801
78866,170,263,48640,30226,5.87031e+18,132.907,2897.43,78866,98,104,78595,78460,61400,57528,68993
94619,253,282,58333,36286,5.87275e+18,201.262,3386.02,94619,154,161,94325,94235,80380,88493,88211
2461,34,96,1501,960,5.86807e+18,41.4872,400.867,2461,46,46,2235,1902,939,975,858
4907,69,144,3027,1880,5.87309e+18,61.7057,612.057,4907,55,54,4744,4646,2682,2557,2727
76646,87,214,47276,29370,5.87007e+18,145.228,2805.34,76646,94,95,76103,75752,36255,35539,41847
37672,186,287,23678,13994,5.89475e+18,208.177,2632.45,37672,177,174,37203,36721,24960,24964,22915
71418,113,215,44085,27333,5.86998e+18,122.138,2735.08,71418,91,95,71115,70859,45542,41438,43516
33105,199,283,20793,12312,5.89185e+18,216.552,2425.44,33105,169,162,32719,32415,26999,28210,29130
69524,249,342,42840,26684,5.87028e+18,154.469,3039.06,69524,117,113,69182,69064,60880,63706,61561
81023,20,215,49997,31026,5.87018e+18,129.591,2899.22,81023,91,96,60333,43729,10825,13761,9108
27325,138,178,16839,10486,5.87046e+18,81.5338,1662.95,27325,77,80,27147,27119,22792,24650,22220
68474,204,295,42863,25611,5.89044e+18,225.785,3524.99,68474,193,197,67984,67413,48497,50347,47850
96702,75,279,59792,36910,5.87599e+18,242.288,3657.32,96702,192,183,92219,88281,22687,35186,30700
93347,50,309,57845,35502,5.87296e+18,209.298,3478.48,93347,156,161,88265,84096,16994,27766,18642
64322,123,273,39918,24404,5.87419e+18,211.824,2864.65,64322,145,148,63189,61946,32896,31894,32342
76802,111,278,47307,29495,5.87076e+18,154.02,2881.8,76802,116,125,76114,75347,37210,36870,35095
24595,109,150,15126,9469,5.86964e+18,79.8561,1477.52,24595,72,75,24438,24386,20008,20977,20525
53661,160,253,33053,20608,5.87009e+18,121.403,2360.56,53661,95,99,53408,53314,39223,35794,35721
37362,83,196,23021,14341,5.87023e+18,102.614,1949.82,37362,82,88,37011,36816,21407,21042,23051
65960,189,217,40680,25280,5.87008e+18,122.402,2623.26,65960,89,93,65743,65735,62761,64464,63722
36912,21,220,22704,14208,5.86971e+18,128.584,1833.35,36912,87,94,29309,22336,5226,7093,5408
19164,84,217,11776,7388,5.87106e+18,89.0519,1337.66,19164,77,84,18848,18628,10691,11000,11373
66835,83,203,41172,25663,5.87001e+18,128.319,2569.53,66835,91,96,66304,65960,32409,32067,38215
67680,14,260,41712,25968,5.87023e+18,128.461,2684.02,67680,97,105,43189,25484,7159,10135,5611
15997,124,135,9829,6168,5.86885e+18,86.5975,1118.5,15997,66,71,15862,15826,14969,15384,15617
26473,162,258,16433,10040,5.88057e+18,183.482,1967.42,26473,142,134,25969,25582,17688,17803,17550
77246,283,303,47714,29532,5.87117e+18,158.141,3037.72,77246,114,121,76943,76920,71967,74584,74285
49536,14,259,30554,18982,5.87008e+18,143.598,2310.59,49536,95,95,31875,19021,5420,6115,4009
50452,218,384,31261,19191,5.88315e+18,211.221,2949.4,50452,174,166,50000,49782,30691,26793,18311
63794,206,258,39314,24480,5.87024e+18,128.284,2594.78,63794,96,100,63536,63453,57942,60995,60463
40206,51,178,24800,15406,5.87039e+18,115.516,1977.49,40206,81,81,39084,37338,12272,15216,14193
27140,19,253,16821,10319,5.8712e+18,162.261,1734.21,27140,98,98,20731,14624,3335,5812,3553
71398,179,277,44469,26929,5.87823e+18,235.816,3232.59,71398,181,173,70684,69763,48687,49061,50558
90159,171,273,56017,34142,5.87534e+18,244.664,3478.61,90159,176,180,89306,88378,58860,55446,59511
34327,149,204,21245,13082,5.86989e+18,98.6276,1964.97,34327,85,84,34123,34052,32346,32704,32023
19784,129,150,12215,7569,5.87033e+18,73.1076,1387.73,19784,75,77,19634,19634,18369,19070,17950
47312,200,204,29156,18156,5.86983e+18,120.002,2086.39,47312,89,92,47108,47108,46936,47046,47057
86411,135,232,53333,33078,5.87021e+18,128.748,3040.07,86411,93,98,86141,85938,59338,55069,56318
89682,173,302,55406,34276,5.87085e+18,146.555,3239.71,89682,116,127,89291,89087,60208,53490,55830
7057,65,76,4376,2681,5.86759e+18,69.0137,632.957,7057,60,62,6955,6843,5803,6291,6574
51525,225,279,31803,19722,5.87043e+18,153.267,2496.21,51525,93,103,51246,51136,42449,47543,44134
44691,28,207,27599,17092,5.86977e+18,118.439,2170.7,44691,83,83,37220,27674,7209,12015,8369
67818,267,269,41965,25853,5.87096e+18,158.746,2649.95,67818,114,124,67549,67549,67422,67439,67549
49627,110,226,30533,19094,5.86985e+18,157.956,2144.53,49627,99,106,49167,48710,25719,25771,32439
38178,96,244,23578,14600,5.87019e+18,116.459,2027.83,38178,84,86,37848,37684,24464,22766,26838
28249,18,218,17390,10859,5.87006e+18,119.412,1606.06,28249,84,89,21020,14142,4014,5959,4356
11524,189,236,7177,4347,5.87713e+18,178.636,1255.43,11524,98,93,11275,11171,9665,10453,9784
76423,239,262,47092,29331,5.87018e+18,137.182,2831.06,76423,101,106,76161,76140,72421,73585,75496
99002,38,230,61072,37930,5.87012e+18,145.434,3265.42,99002,96,102,91395,82795,20039,26988,23510
78994,72,216,48681,30313,5.87006e+18,140.773,2838.91,78994,96,100,78192,77547,32649,33092,38326
38439,20,263,23834,14605,5.87243e+18,204.038,2125.58,38439,121,121,29813,22881,4359,8854,4382
89100,152,236,55079,34021,5.87017e+18,151.331,3162.32,89100,95,101,88834,88564,72623,76216,75303
19029,44,126,11728,7301,5.87049e+18,66.6583,1250.32,19029,71,72,18119,16793,7849,7949,6855
41228,90,274,25456,15772,5.87479e+18,174.546,2348.16,41228,128,131,39918,38583,17445,20499,18727
90221,143,285,56316,33905,5.88358e+18,247.819,3856.89,90221,200,200,88341,86187,50070,44463,55180
79559,59,218,49004,30555,5.8701e+18,127.243,2815.48,79559,94,103,78253,76747,24169,30079,31892
33794,30,179,20777,13017,5.8693e+18,115.831,1678.4,33794,81,89,29907,25268,5809,7634,8041
38145,152,259,23525,14620,5.87047e+18,116.802,2051.37,38145,88,87,37886,37777,34742,34555,36021
67564,99,307,42009,25555,5.88325e+18,230.327,3438.33,67564,180,186,64309,60608,26032,27402,28259
75973,105,327,47129,28844,5.87787e+18,184.403,3639.42,75973,168,178,73764,71400,38576,39836,37573
58854,81,266,36173,22681,5.87197e+18,195.992,2513.8,58854,124,126,57571,56508,17120,22778,23532
83069,203,279,51300,31769,5.87033e+18,152.963,3221.19,83069,109,114,82769,82605,72455,76552,77252
21462,20,184,13161,8301,5.87099e+18,118.392,1350.02,21462,79,82,16926,12715,2560,3839,3958
58104,52,211,35911,22193,5.87043e+18,116.453,2492.41,58104,88,87,56375,53201,15050,20091,17517
84628,69,277,52021,32607,5.87108e+18,157.993,2971.79,84628,119,129,82950,81744,21889,31079,29382
35359,139,258,21783,13576,5.87185e+18,174.932,1967.89,35359,104,110,34915,34585,22701,22520,26921
40516,375,397,25085,15431,5.87207e+18,155.383,2729.89,40516,115,109,40119,40104,40063,40075,39875
53487,205,266,33111,20376,5.87244e+18,194.779,2460.91,53487,131,130,53146,52889,43901,48833,45459
48795,196,272,30113,18682,5.87351e+18,178.923,2495.48,48795,138,138,48424,48180,38745,41400,38979
83162,224,230,51238,31924,5.87024e+18,141.535,2926.91,83162,96,102,82932,82932,82929,82872,82932
49271,112,202,30496,18775,5.86991e+18,103.981,2302.26,49271,85,86,49042,48975,37377,35863,33337
96491,32,278,59530,36961,5.87761e+18,244.455,3670.8,96491,190,187,81843,67846,10952,23778,12397
2988,14,76,1840,1148,5.86899e+18,61.0408,416.492,2988,49,54,1781,1011,384,497,718
97800,212,277,60627,37173,5.87414e+18,226.794,3516.43,97800,172,166,97335,96871,78494,87267,80366
40639,110,240,25078,15561,5.87017e+18,135.886,2093.35,40639,88,92,40335,40121,26236,24625,26340
98547,261,327,61055,37492,5.87427e+18,206.595,3895.73,98547,165,157,98220,98082,93490,94691,91820
28735,13,260,17789,10946,5.86969e+18,150.765,1977.21,28735,96,98,15817,9165,3044,3706,2006
2262,2,155,1389,873,5.8768e+18,49.3855,469.699,2262,47,48,193,0,18,0,39
8761,37,79,5399,3362,5.87033e+18,65.3932,713.512,8761,66,68,7950,7011,4135,3991,5272
7087,25,118,4373,2714,5.8716e+18,73.8056,718.448,7087,58,58,6127,4871,1551,2064,1987
39810,67,192,24597,15213,5.8697e+18,102.377,2049.56,39810,84,84,39369,38877,19321,20025,22215
26987,38,245,16630,10357,5.87072e+18,88.1009,1670.45,26987,85,86,24866,22690,8204,9134,10098
88561,12,397,54858,33703,5.87307e+18,219.39,3791.01,88561,154,167,52575,33009,8682,12204,2808
4360,91,152,2685,1675,5.87611e+18,96.9977,629.709,4360,65,62,4133,3993,2753,2719,2836
57666,17,273,35838,21828,5.87709e+18,231.997,2850.85,57666,163,160,40153,26815,6068,10877,3577
96443,227,286,60088,36355,5.88502e+18,210.173,4021.13,96443,205,197,96082,95770,82624,88364,87139
8971,19,223,5588,3383,5.88528e+18,142.341,1132.94,8971,105,97,5931,3673,858,1695,857
65034,179,214,40105,24929,5.87003e+18,130.233,2556.38,65034,93,97,64820,64762,60753,63124,64032
7628,62,119,4689,2939,5.87222e+18,57.1172,770.961,7628,61,59,7504,7470,4852,4599,3744
1953,19,62,1217,736,5.8611e+18,48.254,301.425,1953,43,46,1429,942,452,556,628
52048,3,257,32201,19847,5.86994e+18,135.837,2572.13,52048,100,100,8806,0,515,688,775
74421,245,281,46169,28252,5.88012e+18,203.354,3375.69,74421,184,183,74128,74003,64970,70232,70630
43334,282,285,26940,16394,5.87836e+18,221.086,2561.01,43334,152,141,43049,43041,43045,43047,43034
68424,327,342,42314,26110,5.8747e+18,192.65,3379.55,68424,145,133,68082,68062,68018,68050,67458
85974,211,285,53586,32388,5.88147e+18,239.092,3657.53,85974,196,194,85491,84923,67790,74068,70682
52872,173,304,32624,20248,5.87497e+18,204.187,2791.19,52872,144,143,52337,51896,34393,31192,30435
5377,271,280,3364,2013,5.89315e+18,115.008,1052.03,5377,93,91,5097,5097,5090,5094,5078
56317,289,296,34684,21633,5.87088e+18,140.582,2599.03,56317,101,105,56021,56006,55878,55930,55903
89327,82,270,55290,34037,5.8704e+18,204.693,3488.45,89327,128,132,87649,86594,38161,34577,39166
55829,244,279,34464,21365,5.87018e+18,158.535,2623.67,55829,98,106,55550,55487,50277,51888,50236
88671,131,270,54917,33754,5.87021e+18,246.125,3650.1,88671,154,161,87120,85251,44439,38305,53877
81268,178,245,50220,31048,5.86987e+18,159.429,3091.24,81268,100,98,81015,80865,74424,77789,78649
17829,122,242,10960,6869,5.87414e+18,146.237,1416.75,17829,90,94,17429,17108,10360,9803,12316
53643,196,291,33052,20591,5.87073e+18,152.691,2531.45,53643,110,116,53316,53135,39105,40834,37956
7266,60,124,4475,2791,5.86838e+18,60.8409,725.457,7266,55,56,7111,7043,4414,4384,4285
1443,7,77,896,547,5.86039e+18,53.763,292.134,1443,45,44,525,0,62,138,118
10479,84,128,6439,4040,5.87068e+18,68.0809,922.688,10479,65,63,10344,10331,7900,7877,7971
87322,28,277,54120,33202,5.87306e+18,206.247,3259.49,87322,158,157,74186,60434,11436,20628,11223
89018,42,228,54843,34175,5.86988e+18,142.358,3012.65,89018,98,102,84446,77842,18232,28468,25215
30046,37,173,18586,11460,5.86961e+18,98.255,1712.8,30046,81,80,27246,23863,7199,9618,9476
15254,50,243,9401,5853,5.87254e+18,134.675,1318.93,15254,87,92,14274,13574,4001,5627,5216
68251,142,317,42774,25477,5.88992e+18,201.453,3639.81,68251,190,198,66511,64156,36833,36204,29872
17510,2,165,10765,6745,5.86951e+18,107.147,1226.2,17510,73,76,1608,0,190,0,128
59562,169,286,37602,21960,5.90011e+18,217.642,3248.61,59562,196,190,58699,57303,37892,38548,43140
35971,223,264,22296,13675,5.87115e+18,166.752,2006.84,35971,100,112,35700,35625,30809,33679,32888
95856,133,239,59215,36641,5.87003e+18,165.701,3292.57,95856,100,99,95505,95178,68201,67127,76963
22179,248,308,13776,8403,5.87471e+18,93.1291,1777.97,22179,102,91,21871,21834,20971,21111,20628
6641,150,222,4103,2538,5.87408e+18,97.0426,896.834,6641,77,74,6419,6374,4883,5167,4513
92651,254,279,57336,35315,5.87695e+18,224.997,3615.48,92651,193,179,92356,92227,83457,88482,88584
33349,149,254,20653,12696,5.8699e+18,166.119,2114.16,33349,99,96,33000,32692,27830,27458,29000
47900,48,254,29540,18360,5.87059e+18,122.757,2240.33,47900,94,95,46112,44219,12446,16301,12866
23164,195,307,14390,8774,5.87485e+18,98.7403,1864.67,23164,101,92,22857,22809,21340,21346,20668
69283,161,273,42577,26706,5.87148e+18,162.883,2699.1,69283,117,125,68869,68591,47864,41658,49780
72368,136,298,44709,27659,5.87079e+18,202.083,2958.71,72368,117,120,71837,71450,43028,37787,41113
74146,154,217,45744,28402,5.86989e+18,137.836,2763.07,74146,89,95,73923,73767,62683,65625,68171
43039,189,217,26647,16392,5.87043e+18,124.557,2206.64,43039,88,87,42822,42804,42545,42484,41695
99317,234,282,61175,38142,5.87157e+18,191.052,3368.88,99317,148,150,99022,98897,84393,92850,89452
93171,39,316,57453,35718,5.8727e+18,200.089,3562.8,93171,144,144,85647,77402,16750,26437,19833
97280,78,342,60044,37236,5.87047e+18,154.117,3522.35,97280,120,117,95980,95169,36025,42459,45260
11193,191,224,7068,4125,5.90129e+18,171.551,1348.25,11193,128,114,10951,10848,9969,10290,10467
74315,332,381,45981,28334,5.87079e+18,177.777,3344.92,74315,131,130,73934,73860,66399,70898,66899
78473,178,411,48575,29898,5.87858e+18,205.21,4024.78,78473,180,180,77661,76811,45449,45472,37566
8458,33,172,5231,3227,5.86922e+18,70.1277,901.009,8458,71,69,7344,5754,2728,2996,3422
27506,216,251,16920,10586,5.87284e+18,145.052,1741.38,27506,106,106,27255,27202,23792,25737,24960
87641,253,327,54291,33350,5.87683e+18,187.905,3831.27,87641,175,179,87294,87191,75199,79007,69850
69988,204,212,43120,26868,5.8702e+18,129.337,2627.79,69988,95,100,69776,69776,68183,69297,69774
83990,173,279,51915,32075,5.87009e+18,148.501,3210.08,83990,108,109,83624,83389,71689,70216,75466
93653,176,314,57751,35902,5.87169e+18,222.297,3503.45,93653,141,139,93149,92824,64484,67128,71534
60718,95,202,37430,23288,5.87014e+18,118.362,2481.86,60718,87,94,60375,60162,35643,32786,39645
35692,45,189,22001,13691,5.86997e+18,93.9799,1832.93,35692,83,85,34131,32274,12352,14253,15716
33107,35,312,20521,12586,5.87466e+18,146.106,2296,33107,118,114,28580,23697,6263,9465,5567
88569,138,294,54598,33971,5.87046e+18,209.671,3174.76,88569,123,125,88039,87586,47898,44786,42508
2793,76,111,1726,1067,5.86691e+18,43.7522,424.904,2793,49,48,2682,2651,2463,2491,2422
50386,252,275,31067,19319,5.87585e+18,223.847,2603.12,50386,143,151,50108,50046,44381,47536,46483
57031,3,226,35278,21753,5.87012e+18,135.92,2259.88,57031,96,106,10114,0,3,390,851
38782,98,220,23988,14794,5.87058e+18,128.108,1870.86,38782,93,97,38394,38040,22138,22245,28285
28098,57,219,17377,10721,5.87043e+18,167.615,1631.97,28098,92,92,27204,26518,5966,9812,10780
83498,63,302,51439,32059,5.87056e+18,159.651,3141.23,83498,117,123,81644,80144,23686,31090,27964
33322,76,198,20563,12759,5.87023e+18,109.844,1822.47,33322,84,84,32964,32799,17047,16614,15110
49201,46,184,30282,18919,5.87007e+18,122.425,2188.52,49201,84,88,47316,45116,11963,17320,16777
63361,5,312,39159,24202,5.87411e+18,193.73,3072.85,63361,142,144,18326,0,294,3729,610
22976,13,250,14219,8757,5.87032e+18,154.879,1777.67,22976,92,92,12709,7354,2572,2630,1920
76679,236,301,47170,29509,5.87086e+18,194.151,2967.65,76679,110,117,76378,76304,76162,76096,76063
9194,100,154,5656,3538,5.86786e+18,85.2871,882.444,9194,62,69,9029,8944,6017,5751,5586
53764,175,211,33179,20585,5.87009e+18,130.846,2304.65,53764,90,94,53553,53502,52579,53159,53410
69546,248,307,43327,26219,5.88516e+18,234.546,3524.15,69546,190,187,69224,69058,60333,62187,64747
7042,42,123,4324,2718,5.86891e+18,71.1786,719.7,7042,57,61,6754,6428,2622,2789,2908
83826,72,271,51693,32133,5.87005e+18,150.398,2972.1,83826,108,110,82713,81892,27799,33203,35490
78802,159,276,48873,29929,5.87326e+18,200.426,3115.63,78802,149,152,78079,77504,53087,47655,53141
51483,254,285,32117,19366,5.8819e+18,206.125,2885.56,51483,161,172,51192,51129,45236,48016,46118
90844,253,285,56721,34123,5.8837e+18,246.899,3858.78,90844,200,199,90534,90376,83060,86986,88446
95125,148,297,58692,36433,5.87011e+18,164.83,3208.95,95125,113,117,94743,94420,58460,54049,65271
46718,8,287,29287,17431,5.89142e+18,213.349,2894.62,46718,185,177,17312,0,2024,3354,1121
82043,120,216,50575,31468,5.8701e+18,129.634,2863.64,82043,94,101,81736,81428,54766,54203,63013
89758,64,282,55492,34266,5.87104e+18,155.028,3115.62,89758,118,129,87854,86402,21333,30611,26523
3321,26,71,2044,1277,5.86891e+18,58.2565,423.413,3321,52,53,2653,1868,1141,1155,1664
64939,45,301,40070,24869,5.87117e+18,156.71,2831.46,64939,110,116,61671,58022,14711,21750,19267
27764,141,272,17179,10585,5.87623e+18,165.036,1997.17,27764,119,124,27202,26858,18544,18153,18440
94815,279,281,58749,36066,5.87303e+18,220.788,3398.7,94815,164,163,94534,94534,94475,94476,94527
44306,209,260,27446,16860,5.8707e+18,162.23,2173.6,44306,110,112,44014,43877,39101,41821,40771
65673,101,259,40471,25202,5.87031e+18,132.277,2635.39,65673,95,102,65213,64802,35966,37167,41232
96992,243,282,59788,37204,5.87257e+18,201.309,3418,96992,154,161,96681,96561,81972,90481,87733
58835,166,286,37041,21794,5.8954e+18,231.63,3272.15,58835,196,190,57873,56410,36515,36607,40303
83671,81,303,51681,31990,5.87088e+18,158.726,3149.37,83671,117,128,82455,81493,29725,36222,34336
56386,126,249,34749,21637,5.87093e+18,118.535,2402.21,56386,98,100,56095,55847,36756,34178,36417
14232,82,238,8853,5379,5.88162e+18,156.745,1434.59,14232,114,108,13164,12127,5415,5656,5537
28195,141,282,17687,10508,5.89156e+18,201.178,2275.14,28195,161,155,27297,26179,15171,14392,16703
91611,60,278,56513,35098,5.8779e+18,222.974,3568.29,91611,191,181,85669,80844,17954,30295,22209
16267,69,249,10038,6229,5.87345e+18,123.194,1395.27,16267,91,92,15601,15062,6458,8523,7701
58349,48,264,36531,21818,5.88764e+18,224.605,3085.21,58349,190,184,49017,40082,9986,15398,11160
69800,91,411,43314,26486,5.87837e+18,184.435,3900.11,69800,168,168,67058,64014,31209,33164,29338
26294,2,156,16305,9989,5.87031e+18,71.9122,1571.34,26294,76,78,2359,0,211,0,168
84190,176,342,52244,31946,5.87932e+18,201.831,3985.71,84190,173,168,83636,83112,60390,64453,58566
38124,77,197,23476,14648,5.87039e+18,112.896,1940.49,38124,86,87,37752,37563,20610,19875,21452
46484,88,198,28643,17841,5.87032e+18,116.582,2152.7,46484,88,87,46126,45924,27892,25808,29113
13550,210,238,8349,5201,5.87403e+18,86.1063,1252.79,13550,81,81,13312,13290,12148,12743,11849
13519,88,243,8338,5181,5.87338e+18,135.756,1257.72,13519,85,90,12998,12615,6627,7293,8102
62718,218,342,38789,23929,5.87478e+18,153.574,3263.39,62718,139,130,62376,62296,58990,58885,57081
98211,298,307,61198,37013,5.88524e+18,245.952,4145.43,98211,205,206,97904,97860,96961,97243,96369
15020,2,142,9309,5711,5.87014e+18,69.1904,1172.99,15020,73,74,1357,0,124,0,138
1904,16,71,1171,733,5.86593e+18,52.2006,317.846,1904,47,46,1218,726,310,446,462
71716,122,276,44827,26889,5.88836e+18,226.58,3455.69,71716,194,195,68841,64803,32992,31977,38208
42899,51,309,26706,16193,5.88316e+18,195.647,2805.69,42899,160,167,37516,33476,10172,13862,9247
27778,23,175,17076,10702,5.87027e+18,105.286,1517.32,27778,77,85,22720,17362,4355,5610,5752
20414,146,198,12628,7786,5.86998e+18,103.497,1546.27,20414,81,85,20216,20137,18884,18930,18948
52314,107,314,32342,19972,5.87303e+18,143.555,2813.66,52314,129,126,51351,50479,31526,32646,31016
86445,73,286,53761,32684,5.88213e+18,246.197,3739.3,86445,197,196,79989,73757,18900,30013,26045
45225,254,340,28175,17050,5.88194e+18,135.234,3046.15,45225,152,149,44885,44837,41014,40750,38011
23843,140,162,14753,9090,5.86942e+18,108.178,1402.24,23843,76,81,23681,23620,21698,22676,22853
55870,99,200,34565,21305,5.87003e+18,116.734,2419.53,55870,86,85,55587,55487,36391,35526,41671
66365,28,220,40998,25367,5.86981e+18,155.258,2717.55,66365,91,94,54882,40246,10516,17419,9148
15806,37,243,9744,6062,5.87154e+18,150.392,1353.38,15806,95,92,14146,12730,2914,4467,3200
74006,223,342,45682,28324,5.87277e+18,184.604,3353.32,74006,130,127,73664,73559,70764,71199,70155
48732,115,229,29943,18789,5.87054e+18,129.998,2116.77,48732,92,99,48398,48070,28387,25833,37062
93315,63,243,57479,35836,5.8704e+18,140.967,3089.53,93315,100,107,91929,90734,26427,34271,39065
19837,271,279,12281,7556,5.86961e+18,121.445,1691.14,19837,91,92,19558,19543,19554,19557,18916
6039,76,126,3705,2334,5.869e+18,64.9462,674.02,6039,56,57,5899,5863,3793,3611,3811
18034,23,255,11122,6912,5.87305e+18,135.964,1482.34,18034,87,91,14392,11010,2321,4340,2708
56600,109,257,34896,21704,5.87053e+18,140.673,2460.16,56600,95,98,56212,55882,33911,31477,34377
65080,72,225,40225,24855,5.87012e+18,158.568,2687.83,65080,92,92,64489,63933,24016,24886,25705
78425,14,200,48381,30044,5.87023e+18,124.866,2838.22,78425,89,93,48635,28208,8489,8744,6654
22717,231,246,14019,8698,5.87314e+18,174.602,1664.12,22717,114,108,22471,22446,21471,22046,22389
49436,82,217,30445,18991,5.86989e+18,120.314,2291.22,49436,88,91,48992,48724,24736,25163,27966
92430,219,426,57588,34842,5.88045e+18,183.822,4628.12,92430,180,188,91964,91800,76552,73182,65322
37028,124,179,22880,14148,5.87038e+18,83.7067,1954.22,37028,83,84,36849,36794,29778,31091,29900
37766,187,259,23397,14369,5.87021e+18,148.408,2237.55,37766,98,102,37470,37313,31662,29851,35921
65715,57,238,40641,25074,5.87e+18,145.69,2774.39,65715,94,95,64000,61204,22443,24162,27386
45255,36,197,27926,17329,5.87015e+18,113.49,2113.56,45255,86,88,41430,37089,9350,14076,11692
8920,55,235,5565,3355,5.88551e+18,134.996,1165.68,8920,99,99,7753,6970,3160,3948,3010
71331,280,397,44213,27118,5.87367e+18,206.802,3572.95,71331,152,157,70934,70822,58149,62126,51613
7863,44,145,4847,3016,5.8698e+18,84.8684,790.126,7863,62,60,7515,7248,1860,2782,1777
51330,182,260,32150,19180,5.89075e+18,214.606,2926.91,51330,188,176,50744,49929,38002,39139,40943
79709,150,262,49295,30414,5.86994e+18,164.218,3154.43,79709,108,108,79294,78865,60708,56720,67306
67658,215,234,41683,25975,5.86976e+18,146.446,2555.36,67658,102,111,67421,67360,65509,66738,66522
78152,90,262,48225,29927,5.87003e+18,125.862,2905.43,78152,99,104,77593,77139,36721,39823,41866
47696,83,211,29356,18340,5.87039e+18,128.274,2182.17,47696,87,93,47237,46942,23979,22756,25509
94000,168,303,58046,35954,5.87085e+18,167.29,3315.04,94000,120,131,93556,93267,69591,65812,72820
8705,49,76,5400,3305,5.86982e+18,71.6657,708.213,8705,62,66,8358,7812,5289,4838,6371
79015,198,278,48584,30431,5.87141e+18,151.417,2954.43,79015,114,123,78710,78542,60578,68327,54525
47934,63,271,30150,17784,5.89576e+18,212.559,2901.77,47934,184,180,40432,32871,9892,13904,13833
87217,266,285,54233,32984,5.87746e+18,223.975,3562.78,87217,185,180,86929,86843,79005,83603,84034
20095,65,204,12428,7667,5.87038e+18,99.6094,1539.29,20095,83,82,19677,19120,10750,11101,10612
64341,132,288,39634,24707,5.87077e+18,157.719,2735.95,64341,117,121,63815,63384,35453,35817,33177
61360,295,298,37851,23509,5.8709e+18,154.889,2767.14,61360,113,117,61062,61061,61004,61005,61043
70609,226,285,44021,26588,5.88047e+18,240.671,3343.39,70609,182,188,70237,69926,57471,63363,56246
54126,160,275,33349,20777,5.87541e+18,218.361,2671.74,54126,147,151,53495,52983,33936,28306,30694
46615,61,195,28743,17872,5.87013e+18,116.347,2200.23,46615,82,84,45893,45047,17960,19413,19482
57444,65,300,35441,22003,5.87106e+18,140.339,2648.88,57444,103,108,56193,55134,19732,23077,25147
14451,56,152,8882,5569,5.87046e+18,83.4025,1084.8,14451,70,74,14117,13798,6448,6649,7307
69279,119,411,42940,26339,5.87947e+18,205.112,3864.65,69279,178,179,67285,64859,31340,33040,26509
52594,124,266,32326,20268,5.87166e+18,190.166,2383.68,52594,117,122,51961,51403,28375,25934,26072
40574,33,270,25146,15428,5.87022e+18,198.363,2370.53,40574,104,109,34521,25313,7216,10472,6731
88267,41,273,54791,33476,5.87543e+18,242.331,3432.06,88267,172,173,79874,71418,14263,24165,13822
31935,97,159,19744,12191,5.87054e+18,93.3174,1711.9,31935,77,79,31750,31709,24240,23656,24650
78391,124,274,48366,30025,5.87359e+18,228.533,3141.28,78391,157,162,77061,75635,38324,38582,42352
17803,53,216,11055,6748,5.87044e+18,72.4445,1237.21,17803,73,77,17215,16277,7564,7760,5681
46962,26,212,29034,17928,5.87032e+18,116.495,2290.3,46962,90,86,37534,26581,8507,12423,11059
97884,198,289,61200,36684,5.88588e+18,209.564,4072.72,97884,207,199,97289,96452,72931,77942,78749
31361,234,260,19443,11918,5.87271e+18,204.553,1942.67,31361,107,115,31095,31029,29014,30137,30168
49573,82,175,30655,18918,5.87009e+18,107.525,2171.01,49573,83,83,49304,49233,28921,27379,29490
25127,56,279,15559,9568,5.86961e+18,119.6,1785.77,25127,85,94,24241,23561,5606,8374,4993
61968,96,275,38167,23801,5.87489e+18,214.976,2830.99,61968,148,155,60328,58810,25947,28750,28980
11627,123,253,7222,4405,5.86946e+18,180.365,1367.72,11627,108,109,10985,10228,6611,5596,7041
67852,132,285,42232,25620,5.87922e+18,215.601,3210.41,67852,173,176,66365,64530,34594,33480,38012
13911,124,236,8568,5343,5.87607e+18,128.626,1273.09,13911,95,89,13558,13250,9254,9354,9216
5763,151,196,3568,2195,5.87331e+18,94.659,798.676,5763,71,66,5567,5558,4664,5066,4389
17389,62,297,10782,6607,5.88024e+18,178.848,1755.86,17389,118,118,15837,14559,4946,6707,5111
85362,173,316,52516,32846,5.87205e+18,223.656,3317.25,85362,134,136,84896,84630,60859,64227,63714
94869,212,281,58800,36069,5.87288e+18,200.59,3391.64,94869,153,161,94459,94086,75575,83483,75828
88233,139,298,54517,33716,5.87068e+18,202.186,3220.59,88233,125,126,87654,87180,54399,48195,53338
92661,111,307,57802,34859,5.88628e+18,244.28,4058.51,92661,202,205,88566,83405,36800,37783,37357
48634,165,300,30029,18605,5.87086e+18,136.045,2473.1,48634,99,102,48280,48160,43392,43273,44351
27686,14,174,16998,10688,5.87007e+18,117.533,1514.46,27686,79,82,18392,11029,2782,3728,2787
4283,164,204,2653,1630,5.86915e+18,71.4102,727.871,4283,63,64,4079,4047,3802,3863,3634
31550,118,260,19521,12029,5.87165e+18,137.069,1868.02,31550,101,103,31097,30730,19495,19379,21925
16484,46,255,10163,6321,5.87112e+18,132.362,1422.34,16484,83,89,15420,14494,4609,5955,5189
68069,195,266,41812,26257,5.87135e+18,184.952,2675.75,68069,121,131,67727,67470,55041,58980,58465
50699,215,234,31268,19431,5.87001e+18,123.274,2236.47,50699,90,96,50465,50457,48739,49644,49205
25001,209,294,15504,9497,5.87625e+18,109.986,1970.01,25001,116,109,24702,24647,21258,21945,20411
33675,260,282,21159,12516,5.89393e+18,214.978,2490.97,33675,170,163,33393,33309,31354,32351,32088
33105,176,299,20432,12673,5.87646e+18,177.066,2263.38,33105,133,131,32675,32366,22234,20478,19486
55643,6,264,34173,21470,5.87143e+18,165.352,2422.87,55643,116,121,19803,0,2304,4233,1601
11580,110,121,7134,4446,5.86958e+18,64.5604,907.091,11580,67,65,11459,11459,10772,11081,11071
52665,80,260,32967,19698,5.88987e+18,232.468,2966.82,52665,186,179,47750,42436,14944,18686,19898
99384,182,285,62131,37253,5.88522e+18,245.888,4088.06,99384,206,203,98459,97127,67545,69305,75446
63139,54,214,39011,24128,5.86996e+18,129.381,2570.54,63139,92,93,61659,59207,16356,22713,20663
20439,38,187,12625,7814,5.86954e+18,81.1532,1518,20439,80,81,18400,16321,6377,7159,7523
69267,119,368,42859,26408,5.87087e+18,173.592,2952.71,69267,115,128,68523,67764,25948,26830,26087
11279,56,279,6984,4295,5.87001e+18,113.455,1323.05,11279,83,82,10567,10031,3769,4283,4391
66527,222,241,40992,25535,5.86989e+18,118.825,2596.91,66527,97,103,66286,66286,65254,65730,65266
60164,193,198,37143,23021,5.86986e+18,119.479,2498.56,60164,84,89,59966,59966,59894,59964,59788
40215,184,270,25057,15158,5.88404e+18,219.097,2541.23,40215,161,171,39701,39120,28406,28836,28103
82027,151,327,50859,31168,5.87744e+18,190.163,3750.5,82027,168,178,81015,79969,53646,56829,53355
31492,373,381,19499,11993,5.8717e+18,152.329,2311.19,31492,115,112,31111,31106,31103,31104,30778
57602,174,252,35445,22157,5.86999e+18,116.831,2424.49,57602,99,99,57350,57283,44447,47372,41930
79887,119,273,49604,30283,5.87498e+18,217.41,3242.53,79887,167,168,78274,76358,37576,36152,39545
41756,83,274,25784,15972,5.87412e+18,174.726,2352.18,41756,128,133,40275,38925,14377,18549,17398
26318,35,253,16456,9862,5.88534e+18,196.632,1999.29,26318,153,137,21005,16649,3805,6328,4041
8970,36,154,5520,3450,5.86935e+18,84.2676,883.744,8970,65,69,8244,7581,2215,3033,2813
62661,109,187,38574,24087,5.87017e+18,118.944,2477.54,62661,86,91,62399,62173,43813,41038,48739
16114,21,253,10018,6096,5.87153e+18,126.381,1405.57,16114,89,89,12386,9445,2252,3881,2037
32039,395,397,19812,12227,5.87054e+18,163.227,2322.97,32039,102,102,31642,31642,31641,31642,31636
29874,81,160,18467,11407,5.86987e+18,94.7533,1652.06,29874,75,79,29671,29634,18127,17364,17878
4072,61,194,2580,1492,5.90421e+18,150.169,778.309,4072,90,87,3191,2367,1257,1195,1416
26772,33,273,16621,10151,5.87556e+18,142.5,1929.35,26772,116,112,23037,18925,4734,7632,5584
13220,179,182,8129,5091,5.86967e+18,85.5779,1140.31,13220,71,74,13038,13038,13038,13038,13038
54078,111,262,33827,20251,5.88904e+18,230.738,2995.93,54078,188,188,51278,47869,22964,22658,26053
1190,44,164,746,444,5.87639e+18,63.1261,370.327,1190,47,42,935,750,283,404,339
59498,109,260,36613,22885,5.86997e+18,128.953,2502.04,59498,99,101,59101,58763,35463,36839,38391
98525,222,232,60840,37685,5.87017e+18,143.168,3248.72,98525,95,100,98293,98277,98030,97882,98014
40876,159,426,25459,15417,5.88077e+18,152.147,3192.09,40876,147,144,40269,39692,30153,30220,27355
44479,86,215,27436,17043,5.86997e+18,127.013,2168.11,44479,87,89,44075,43817,21531,20353,22832
69185,74,196,42725,26460,5.86966e+18,130.239,2640.62,69185,88,95,68606,68191,30418,30453,34997
76920,31,217,47450,29470,5.87021e+18,144.035,2812.66,76920,90,97,67369,54173,12655,19972,14972
41515,244,267,25643,15872,5.87472e+18,214.911,2333.18,41515,135,133,41248,41213,38786,40111,40457
36762,4,180,22649,14113,5.87012e+18,102.417,1912.42,36762,80,83,8418,0,7,852,1082
67505,260,306,42529,24976,5.89705e+18,235.961,3536.82,67505,203,194,67194,67114,63529,65230,65346
97156,372,381,60067,37089,5.87081e+18,173.267,3676.39,97156,133,136,96775,96770,96766,96768,94817
33807,111,269,20889,12918,5.87523e+18,176.324,2130.19,33807,128,126,32896,31923,15343,15291,12579
86884,83,293,53683,33201,5.87049e+18,189.835,3075.15,86884,115,120,85808,84887,31353,35435,33070
59005,24,232,36467,22538,5.86997e+18,133.289,2352.58,59005,95,103,48771,36951,7453,12154,8870
89033,101,278,54718,34315,5.87167e+18,189.774,3121.57,89033,139,142,87754,86505,37749,37824,32650
67881,191,342,41971,25910,5.87039e+18,152.592,3045.28,67881,110,105,67493,67301,62989,62888,63521
84387,188,279,52126,32261,5.87019e+18,150.336,3233.45,84387,108,111,84051,83837,71039,70901,75677
62497,26,314,38593,23904,5.87277e+18,161.04,3025.83,62497,134,132,51001,38634,8988,15874,7920
17673,71,174,10920,6753,5.86987e+18,84.3518,1330.74,17673,71,72,17431,17341,8246,8045,8275
93690,178,281,57584,36106,5.87132e+18,150.276,3189.34,93690,120,128,93319,93077,67030,62606,71400
60652,6,366,37509,23143,5.87056e+18,154.262,2957.71,60652,105,105,19480,0,1521,3149,2557
9688,6,123,5989,3699,5.86875e+18,74.7161,844.551,9688,63,64,3476,0,329,521,390
99202,194,279,61389,37813,5.87122e+18,180.65,3283.72,99202,134,144,98795,98450,72193,84041,80554
60221,247,314,37184,23037,5.87209e+18,148.63,2922.33,60221,119,116,59907,59813,57407,58255,56092
24526,7,154,15104,9422,5.86976e+18,79.5421,1478.99,24526,73,75,9419,0,1367,1338,1314
68963,56,324,42780,26183,5.87901e+18,192.452,3477.68,68963,166,173,63309,58583,17261,23831,17281
93967,151,282,57937,36030,5.87262e+18,205.064,3377.39,93967,154,161,93103,92349,57802,52558,62116
29485,136,290,18449,11036,5.88677e+18,127.8,2339.52,29485,143,140,28757,27866,21254,21283,18769
15876,57,121,9766,6110,5.86979e+18,64.2649,1134.64,15876,69,69,15639,15249,8903,9124,8611
94977,62,276,58797,36180,5.87755e+18,223.44,3697.13,94977,191,181,88546,83042,19285,31798,22764
88552,321,342,54678,33874,5.87034e+18,157.086,3393.8,88552,120,116,88210,88197,88103,87714,87833
24775,80,186,15309,9466,5.87003e+18,88.222,1667.77,24775,80,82,24556,24457,15658,15064,14386
18557,245,270,11498,7059,5.87732e+18,128.684,1674.85,18557,106,106,18287,18264,17030,17723,17438
32791,28,261,20543,12248,5.88743e+18,206.618,2303.12,32791,164,157,23753,16631,3831,6831,4128
36448,41,262,22740,13708,5.88028e+18,199.885,2297.01,36448,153,145,31287,26570,5970,9619,6178
69510,104,381,43023,26487,5.87107e+18,172.562,3172.2,69510,126,134,68479,67557,22725,28232,28877
74759,130,277,46544,28215,5.87795e+18,231.697,3280.44,74759,182,175,73069,70967,36726,34321,37151
46039,258,279,28455,17584,5.87001e+18,143.288,2454.43,46039,104,106,45760,45725,43945,45206,43576
14879,57,242,9161,5718,5.87332e+18,127.275,1303.25,14879,86,87,14069,13551,4206,5945,5379
96645,61,231,59742,36903,5.86998e+18,147.983,3233.75,96645,97,101,95147,93341,24720,34954,34378
15669,43,125,9648,6021,5.86979e+18,64.1968,1129.26,15669,70,69,14903,13701,5981,6403,5206
75818,131,282,46775,29043,5.87334e+18,213.138,3088.31,75818,151,154,74737,73627,38477,38099,34643
39488,201,274,24395,15093,5.87511e+18,174.595,2301.43,39488,128,131,39136,38909,31009,33439,29321
89582,161,278,55405,34177,5.8707e+18,155.733,3108.44,89582,120,128,89154,88858,60291,53600,66374
10403,178,246,6423,3980,5.87663e+18,136.912,1169.88,10403,85,89,10149,10066,8263,9018,7894
62453,263,272,38468,23985,5.87172e+18,201.321,2640.34,62453,131,131,62181,62181,61952,62124,61978
18993,16,242,11705,7288,5.87346e+18,152.331,1476.32,18993,99,100,13585,9832,2176,3812,1854
58428,173,300,36092,22336,5.87138e+18,157.397,2665.96,58428,111,119,58032,57813,42324,39422,41421
48614,193,268,30194,18420,5.87617e+18,180.218,2539.56,48614,151,142,48230,47884,37082,41264,39691
53317,2,196,32919,20398,5.86988e+18,115.774,2359.96,53317,84,85,4813,0,450,0,219
79861,259,397,49481,30380,5.87337e+18,208.223,3719.79,79861,153,162,79455,79345,59506,59931,53028
70828,71,217,43719,27109,5.87009e+18,133.155,2702.85,70828,89,95,70142,69682,28206,29369,32457
37405,123,326,23150,14255,5.87347e+18,104.46,2432.58,37405,101,99,36942,36631,30338,32034,30618
96618,212,306,59595,37023,5.87034e+18,143.034,3413.92,96618,120,125,96298,96139,73056,83828,68261
64521,180,198,39813,24708,5.8702e+18,125.586,2570.19,64521,87,89,64323,64314,63634,64072,64073
44683,3,195,27569,17114,5.86968e+18,116.832,2087.43,44683,86,87,7687,0,346,271,1029
43294,46,221,26765,16529,5.87052e+18,159.303,2009.67,43294,94,103,41520,40025,8580,13531,5486
75838,36,225,46846,28992,5.87013e+18,147.009,2911.95,75838,94,92,68385,59830,16239,22842,18702
75009,119,215,46221,28788,5.87005e+18,135.202,2774.21,75009,92,96,74707,74437,52684,51635,57942
21622,80,381,13390,8232,5.87297e+18,156.482,1981.33,21622,108,107,20699,20039,6750,8673,7540
92486,286,303,57552,34934,5.88322e+18,231.446,3933.93,92486,202,193,92183,92162,92177,92180,92174
34451,53,196,21306,13145,5.8702e+18,109.111,1840.81,34451,82,84,33530,32136,11744,13625,11443
69718,117,286,43338,26380,5.88161e+18,237.198,3346.02,69718,184,178,67414,64565,31537,30816,34558
94396,110,426,59068,35328,5.88664e+18,224.197,4720.93,94396,202,214,90053,84728,32775,38727,26923
32797,230,288,20221,12576,5.87171e+18,169.458,2060.5,32797,108,111,32509,32456,27411,30187,25838
47486,31,261,29393,18093,5.88274e+18,206.439,2662.98,47486,171,157,38147,30510,5487,10592,5888
37438,92,224,23017,14421,5.87034e+18,126.336,1859.14,37438,89,101,37012,36629,18237,17372,19906
39522,154,261,24784,14738,5.88981e+18,206.856,2558.15,39522,177,164,38649,37489,25249,25004,26669
47943,135,217,29522,18421,5.87034e+18,127.756,2232.03,47943,86,91,47711,47570,33040,31845,30434
10473,105,134,6487,3986,5.87049e+18,84.356,907.779,10473,63,69,10336,10298,8953,9652,9435
87636,263,342,54097,33539,5.87027e+18,159.051,3373.81,87636,119,116,87294,87186,80423,83093,80867
89286,119,302,55176,34110,5.87085e+18,147.121,3259.27,89286,116,128,88645,87996,44564,43879,40876
37954,259,285,23609,14345,5.87812e+18,210.299,2420.16,37954,143,133,37669,37592,36743,37148,36910
43032,159,266,26454,16578,5.87166e+18,166.368,2165.45,43032,109,115,42637,42383,30120,27317,30354
71411,77,203,44027,27384,5.87019e+18,121.431,2685.42,71411,90,94,70845,70576,32652,32787,35884
75167,272,302,46474,28693,5.87082e+18,159.648,2973.6,75167,113,123,74865,74827,64690,70632,69906
46431,60,224,28550,17881,5.86996e+18,136.947,2051.64,46431,94,101,45431,44672,12689,17731,20178
54679,259,285,34081,20598,5.88032e+18,216.361,2944.98,54679,165,167,54392,54324,49086,51914,51280
4544,64,121,2800,1744,5.86672e+18,59.2188,584.762,4544,55,55,4408,4356,2960,2925,2739
98253,148,286,60839,37414,5.87733e+18,253.732,3810.56,98253,194,189,96785,95310,54051,49764,56934
13102,77,151,8071,5031,5.86956e+18,72.2271,1001.16,13102,74,75,12946,12917,12591,12689,12739
83300,223,426,51861,31439,5.87956e+18,177.042,4392.41,83300,173,173,82858,82719,71114,68870,62006
11832,29,237,7324,4508,5.87407e+18,114.464,1166.99,11832,89,85,10101,8734,2027,3405,1318
85447,255,381,52846,32601,5.87076e+18,177.235,3436.18,85447,127,135,85063,84935,59964,59617,60001
75975,239,272,46875,29100,5.87327e+18,229.708,3103.04,75975,158,160,75663,75460,66635,71561,72718
90226,96,397,55899,34327,5.87314e+18,207.184,3906.01,90226,155,164,88152,86249,29583,36496,27022
47808,144,291,29440,18368,5.87057e+18,178.464,2373.61,47808,111,116,47348,47032,24618,23978,24520
48710,180,397,30184,18526,5.87301e+18,160.47,3057.69,48710,129,122,48208,47937,40039,40563,39322
48509,187,260,29975,18534,5.8698e+18,159.856,2496.72,48509,97,103,48213,48080,38804,38338,45328
42435,39,220,26098,16337,5.87e+18,134.559,1955.84,42435,92,97,39896,36952,7545,11451,9148
17524,12,243,10764,6760,5.87381e+18,151.739,1414.93,17524,96,99,10843,6896,1583,2912,1392
76442,109,257,47248,29194,5.87019e+18,174.677,3047.18,76442,107,105,75800,75385,39389,34580,42606
66116,88,270,41173,24943,5.88419e+18,223.183,3227.71,66116,189,182,61868,56923,21955,25431,23640
2936,83,103,1804,1132,5.86295e+18,44.6185,436.486,2936,47,49,2833,2832,2744,2777,2754
24254,249,256,15120,9134,5.8814e+18,183.743,1874.16,24254,136,126,23998,23996,23844,23957,23951
90008,8,282,55685,34323,5.87078e+18,146.977,3171.32,90008,121,124,40557,0,5796,8605,3543
7860,124,246,4940,2920,5.89526e+18,134.593,1206.53,7860,106,100,7395,7005,4863,4509,4135
50218,62,266,30918,19300,5.87124e+18,173.611,2312.06,50218,111,114,48719,47596,13719,18875,19674
47065,185,196,29093,17972,5.87033e+18,102.353,2230.26,47065,84,85,46869,46864,45801,46532,46529
3060,7,172,1903,1157,5.86766e+18,60.1993,538.331,3060,49,51,1250,0,201,201,192
88413,23,279,54669,33744,5.86989e+18,144.028,3271.37,88413,108,108,68302,48849,13972,20874,15063
99616,57,316,61393,38223,5.87308e+18,199.546,3684.33,99616,152,156,95528,91970,24325,34834,29169
11617,196,233,7306,4311,5.89502e+18,173.632,1375.6,11617,127,114,11369,11276,9817,9851,10249
12382,144,149,7629,4753,5.86989e+18,74.6261,1031.79,12382,72,73,12233,12225,12085,12188,12197
43911,152,190,27116,16795,5.87006e+18,115.786,1977.75,43911,86,94,43721,43700,38441,41466,42426
23052,79,152,14222,8830,5.86942e+18,88.3949,1424.28,23052,72,76,22821,22743,13825,13792,15251
41670,185,235,25752,15918,5.86981e+18,125.951,2259.05,41670,91,92,41435,41325,39921,40778,41018
75573,358,381,46771,28802,5.87097e+18,173.545,3285.35,75573,127,134,75192,75170,70730,73657,71520
34677,150,163,21404,13273,5.87043e+18,92.6115,1801.83,34677,77,82,34514,34512,33729,34209,34107
9123,68,146,5640,3483,5.87059e+18,70.855,945.064,9123,70,75,8929,8699,6096,6260,6327
95180,77,285,59243,35937,5.87839e+18,237.181,3783.37,95180,187,195,90159,85261,24188,35281,31222
33607,171,217,20783,12824,5.86991e+18,110.141,1976,33607,85,85,33390,33343,32003,32772,31513
7925,77,222,4997,2928,5.89895e+18,175.566,1125.28,7925,108,101,6896,5818,2919,2797,3260
71786,259,300,44371,27415,5.87108e+18,159.66,2917.48,71786,116,126,71486,71427,61778,67555,63908
79713,85,288,49160,30553,5.87028e+18,133.214,2978.96,79713,105,106,79014,78468,37756,40702,40755
27561,49,256,17080,10481,5.87134e+18,156.732,1758.7,27561,100,99,26142,25042,6330,9041,7588
77574,198,217,47864,29710,5.87018e+18,140.431,2822.34,77574,90,97,77357,77346,76472,76983,76913
37269,158,314,23038,14231,5.87229e+18,113.786,2335.14,37269,100,99,36926,36853,35464,35377,34682
6579,194,259,4073,2506,5.875e+18,124.996,959.467,6579,75,72,6320,6267,6106,6124,6040
70812,40,300,43735,27077,5.87102e+18,160.288,2920.8,70812,113,123,66129,60260,13486,21740,16802
23322,97,173,14419,8903,5.86997e+18,103.432,1491.46,23322,77,78,23122,23071,14352,13431,10825
91200,12,279,56355,34845,5.87024e+18,158.716,3337.47,91200,111,115,51336,31463,8616,10919,6494
93013,97,285,57806,35207,5.87821e+18,226.619,3682.52,93013,190,185,89716,86127,33704,36697,38152
11650,156,182,7189,4461,5.87018e+18,85.9442,1076.21,11650,71,71,11468,11441,10259,10951,10205
65959,100,273,40973,24986,5.87705e+18,230.984,3015.97,65959,163,168,63769,61604,27081,27316,26243
18771,41,217,11614,7157,5.87057e+18,111.861,1326.86,18771,76,83,17728,16460,4505,6642,6757
71081,27,313,44011,27070,5.87347e+18,196.36,3210.71,71081,146,150,58606,45302,10200,17697,8902
26469,94,211,16371,10098,5.86993e+18,127.378,1766.71,26469,85,83,26162,26066,14627,13221,13174
90608,138,270,56079,34529,5.87018e+18,202.989,3513.03,90608,128,132,89784,88814,58748,52244,64458
94751,254,294,58370,36381,5.87017e+18,165.346,3186.33,94751,110,120,94457,94445,89927,92574,93515
28425,47,216,17581,10844,5.87004e+18,162.804,1633.37,28425,93,92,27188,26297,6431,9424,9543
84358,73,316,51895,32463,5.87192e+18,210.771,3285.7,84358,131,136,82666,81277,23921,30933,27701
19116,32,159,11746,7370,5.87006e+18,100.029,1249.99,19116,73,77,17220,14611,3964,5688,6054
24526,15,165,15088,9438,5.8702e+18,97.0733,1417.65,24526,74,81,16442,9695,3250,3632,3048
55220,124,273,34254,20966,5.87498e+18,216.251,2675.91,55220,149,151,54139,52877,27717,26408,28919
78232,122,272,48172,30060,5.87126e+18,195.773,2920.69,78232,136,136,77342,76402,38753,39243,42311
40320,14,282,25342,14978,5.89426e+18,218.627,2705.63,40320,181,171,20311,9206,2496,4754,2069
80322,27,279,49807,30515,5.87902e+18,228.621,3457.16,80322,187,179,63668,48388,10069,17698,7507
66872,252,302,41239,25633,5.87086e+18,162.462,2867.93,66872,109,117,66570,66486,60164,63767,61897
93920,70,302,57989,35931,5.87072e+18,201.163,3344.61,93920,121,131,92161,90888,26158,37590,36902
7493,43,76,4612,2881,5.87137e+18,68.911,653.472,7493,62,63,7057,6451,3841,3540,4454
59675,29,298,36819,22856,5.87101e+18,152.323,2727.32,59675,106,116,51113,40839,9513,15577,9190
33191,67,220,20421,12770,5.86987e+18,126.587,1740.66,33191,87,92,32539,32126,10632,14089,15255
53918,201,286,33424,20494,5.87868e+18,216.293,2879.65,53918,170,155,53513,53157,42259,45426,42909
17860,116,162,11043,6817,5.86995e+18,105.116,1233.28,17860,72,78,17690,17594,13480,14282,13066
39517,142,264,24466,15051,5.87319e+18,204.227,2151.28,39517,114,127,38965,38648,24039,21431,27807
6762,2,81,4180,2582,5.86812e+18,71.6164,639.609,6762,63,67,607,0,83,0,109
30124,10,184,18646,11478,5.86959e+18,81.1107,1783.4,30124,79,80,14620,9727,2304,2975,3072
92066,3,238,56835,35231,5.87021e+18,156.709,3227,92066,96,95,15554,0,966,1020,788
22919,83,192,14164,8755,5.86985e+18,95.0041,1480.15,22919,76,76,22690,22629,14536,13552,12320
47138,252,272,29281,17857,5.87767e+18,192.02,2564.84,47138,154,147,46866,46857,44521,45853,46176
29276,24,255,18014,11262,5.87565e+18,165.846,1859.66,29276,114,114,24003,19007,3073,6894,2649
29828,152,173,18394,11434,5.86949e+18,105.92,1643.66,29828,76,82,29655,29645,28056,28785,28945
52550,172,273,32679,19871,5.87653e+18,184.683,2690.97,52550,153,151,51986,51365,35562,35041,36801
62658,106,266,38580,24078,5.87042e+18,177.365,2563.37,62658,117,122,61858,61100,29602,29472,33077
33475,208,305,20937,12538,5.89036e+18,181.94,2575.31,33475,156,159,33132,33000,25721,25814,23041
5829,92,110,3593,2236,5.86674e+18,53.7313,616.496,5829,57,57,5719,5719,5209,5435,5317
56963,199,202,35203,21760,5.87034e+18,115.988,2458.48,56963,85,86,56761,56761,56759,56761,56550
13223,48,243,8155,5068,5.87312e+18,140.5,1249.3,13223,86,88,12255,11505,3206,4708,4160
53720,128,285,33478,20242,5.88062e+18,228.938,2919.55,53720,168,163,52358,50714,25968,24153,27111
77989,167,426,48630,29359,5.88163e+18,193.524,4323.2,77989,177,182,77156,76190,53302,54520,48248
7262,111,153,4464,2798,5.86953e+18,78.3875,747.229,7262,63,63,7109,7047,5893,6409,6115
77960,235,273,48365,29595,5.87389e+18,227.495,3131.8,77960,162,159,77636,77399,66357,72378,71745
95368,26,318,58930,36438,5.87087e+18,204.569,3439.98,95368,125,133,79571,61391,11920,22440,10665
38643,231,260,23935,14708,5.87033e+18,133.257,2234.53,38643,100,98,38383,38324,37866,38228,38276
46477,238,265,28765,17712,5.87141e+18,191.403,2263.15,46477,114,116,46210,46148,41317,44234,43994
47441,35,223,29305,18136,5.86989e+18,147.859,2356.16,47441,91,91,41908,34129,9269,13355,10628
4373,13,86,2694,1679,5.87154e+18,69.8468,529.407,4373,62,62,2418,1376,557,554,842
53319,44,273,33169,20150,5.87762e+18,187.209,2735.28,53319,160,152,47784,42620,9144,14150,8851
71447,75,220,44137,27310,5.87017e+18,146.584,2827.79,71447,93,94,70897,70486,33219,33158,36299
73918,55,313,45620,28298,5.87359e+18,196.312,3265.34,73918,148,148,70206,67017,19180,26215,17934
6311,82,242,3951,2360,5.88563e+18,116.78,1009.1,6311,85,85,5741,5256,3539,3606,3156
39075,149,262,24402,14673,5.8875e+18,210.507,2516.21,39075,172,164,38147,36955,23795,22610,25643
47531,149,297,29283,18248,5.87127e+18,155.942,2462.8,47531,110,115,47093,46866,32922,32947,33357
72848,83,381,45087,27761,5.87114e+18,173.11,3164.53,72848,126,133,71394,70186,18505,27445,24057
57900,23,195,35757,22143,5.86999e+18,114.93,2457.15,57900,86,87,45133,32413,8820,11624,10402
53935,151,285,33607,20328,5.88048e+18,206.72,2925.47,53935,165,164,53038,52043,32788,33056,35763
50025,204,266,31063,18962,5.88072e+18,201.598,2730.56,50025,170,162,49653,49265,41289,44802,41227
34016,70,272,21024,12992,5.87507e+18,170.947,2163.21,34016,124,128,32331,31058,10748,14616,12146
26079,271,287,16190,9889,5.8754e+18,103.797,1969.06,26079,110,104,25792,25784,25534,25665,25402
5066,128,161,3127,1939,5.87385e+18,90.1244,685.271,5066,63,61,4893,4804,4270,4580,4523
66654,140,200,41130,25524,5.86994e+18,122.268,2622.65,66654,87,89,66439,66308,55113,55617,59845
68720,75,303,42419,26301,5.87099e+18,170.375,2915.99,68720,110,119,67499,66658,24092,28034,27619
58840,117,264,36437,22403,5.87093e+18,169.685,2490.12,58840,113,122,58197,57581,31720,31965,37282
97659,260,272,60286,37373,5.87414e+18,236.971,3568.7,97659,174,183,97375,97301,91409,94141,96298
69975,44,342,43175,26800,5.87022e+18,145.369,3066.36,69975,115,111,65777,60577,17285,22665,19422
7207,21,120,4429,2778,5.86833e+18,75.1575,725.616,7207,57,59,5909,4641,1343,1744,1902
46803,128,261,29276,17527,5.88621e+18,220.264,2721.35,46803,176,172,45220,43104,23265,21461,26152
16936,133,144,10448,6488,5.87023e+18,69.0659,1187.89,16936,75,75,16792,16792,16646,16733,16703
57916,4662,5354,36485,21431,5.7986e+18,392.378,10158.5,57916,330,260,52562,52562,45382,46564,17695
83295,239,294,51324,31971,5.87008e+18,159.243,2985.55,83295,107,112,83001,82975,80144,81803,81970
1306,67,202,812,494,5.8799e+18,43.6217,434.955,1306,53,45,1098,1018,849,850,778
71026,75,213,43759,27267,5.87014e+18,133.089,2654.72,71026,95,101,70272,69863,30472,30961,35566
6878,216,274,4304,2574,5.8864e+18,97.5632,1133.26,6878,96,87,6604,6593,5979,6052,5787
56999,77,273,35461,21538,5.87657e+18,230.229,2823.76,56999,163,159,54240,51709,14309,21219,19483
64913,83,327,40259,24654,5.87645e+18,157.807,3327.81,64913,151,146,62725,60474,28086,29139,28820
65260,264,285,40642,24618,5.87934e+18,204.13,3160.96,65260,172,175,64975,64929,57514,61854,60923
63638,255,275,39241,24397,5.87791e+18,226.744,2951.84,63638,165,167,63353,63240,58904,61344,61811
86901,103,285,54078,32823,5.87896e+18,236.191,3641.76,86901,184,187,83955,80788,36668,38195,38877
2689,58,144,1677,1012,5.87487e+18,71.1268,474.147,2689,50,52,2479,2365,1437,1478,1851
19543,27,246,12040,7503,5.87138e+18,150.202,1476.75,19543,91,98,16616,13677,2711,4995,3503
56156,67,342,34614,21542,5.87022e+18,140.723,2769.55,56156,111,109,54832,53754,20071,23916,23838
3421,23,180,2168,1253,5.90454e+18,134.94,696.293,3421,88,75,1759,654,249,380,274
31689,125,242,19460,12229,5.87167e+18,162.705,1760.7,31689,93,97,31324,31052,18826,17423,20933
31976,2760,4646,20131,11845,5.7675e+18,365.198,7844.08,31976,272,216,27330,27306,17858,18641,6811
21805,158,236,13509,8296,5.87052e+18,123.544,1646.97,21805,82,82,21569,21482,16329,16718,11584
23494,145,246,14474,9020,5.87326e+18,175.053,1664.06,23494,110,110,23070,22818,15170,13608,14817
63856,122,286,39646,24210,5.88058e+18,248.658,3185.25,63856,175,178,61999,59705,28595,28648,25163
44321,172,225,27205,17116,5.87046e+18,162.432,2031.03,44321,98,102,44049,43920,35860,39743,37136
88579,274,282,54624,33955,5.873e+18,209.27,3289.84,88579,152,159,88297,88297,87925,88181,88085
9413,40,126,5833,3580,5.86808e+18,66.5707,844.852,9413,58,65,8902,8154,2849,3641,4091
55934,178,306,34689,21245,5.87472e+18,212.97,2838.31,55934,147,149,55387,54914,35663,32138,30957
49281,216,228,30494,18787,5.87037e+18,128.57,2127.34,49281,92,99,49053,49042,47608,48378,48608
67441,175,257,41572,25869,5.87052e+18,130.652,2659.19,67441,99,103,67184,67066,53060,53115,60737
32496,61,265,20094,12402,5.87515e+18,176.06,2073.94,32496,128,129,30440,28785,7863,12379,8710
89221,21,308,54980,34241,5.87327e+18,200.397,3461.45,89221,154,155,69214,52705,9941,19392,9497
86482,228,279,53149,33333,5.87118e+18,150.535,3078.12,86482,119,127,86199,86133,71835,80120,74359
41433,229,342,25540,15893,5.87011e+18,153.044,2455.5,41433,109,107,41091,40950,34208,33973,36429
14169,196,323,8719,5450,5.86995e+18,104.039,1338.59,14169,78,79,13846,13804,9181,8153,5009
22423,117,162,13792,8631,5.8699e+18,106.892,1366.32,22423,75,80,22250,22137,18628,18600,20104
68372,205,312,42233,26139,5.87373e+18,188.138,3164.17,68372,144,144,67943,67624,52109,51460,50610
88760,207,270,54924,33836,5.87009e+18,187.205,3431.87,88760,121,127,88413,88211,78449,83369,85113
7790,37,130,4823,2967,5.87015e+18,66.8768,777.066,7790,58,62,7196,6507,2478,2891,2774
17345,95,156,10731,6614,5.87013e+18,89.0193,1186.24,17345,70,71,17157,17034,12925,12407,14096
83122,311,317,52053,31069,5.88784e+18,204.985,3959.94,83122,193,206,82805,82803,81906,82481,82642
52682,75,342,32659,20023,5.8769e+18,140.966,3132.38,52682,139,136,50457,48119,21745,22562,24434
96329,47,302,59407,36922,5.87052e+18,167.264,3356.87,96329,120,128,92308,88512,19288,30336,27411
95396,236,247,58929,36467,5.87015e+18,162.133,3323.73,95396,100,100,95149,95149,95133,95143,95141
99775,30,277,62021,37754,5.8772e+18,242.925,3764.75,99775,188,188,82805,68307,12627,23942,11210
48531,39,302,29960,18571,5.87433e+18,153.426,2650.53,48531,134,131,43760,38919,10534,14793,11389
3586,52,107,2200,1386,5.86838e+18,56.2967,497.91,3586,49,48,3451,3404,2177,2181,2169
33768,73,216,20883,12885,5.87002e+18,156.248,1774.96,33768,95,95,33077,32628,11366,13168,13088
97041,31,285,60367,36674,5.87807e+18,239.582,3794.29,97041,187,194,80668,65974,12557,23547,11618
20835,45,128,12930,7905,5.8691e+18,67.2066,1311.29,20835,72,73,19885,18611,8190,8687,7491
20441,6,213,12650,7791,5.87054e+18,97.5711,1355.44,20441,76,84,7391,0,693,1447,596
50083,259,264,31008,19075,5.87123e+18,173.846,2309.45,50083,114,120,49819,49819,49295,49678,49812
99277,156,284,61208,38069,5.87036e+18,162.312,3311.57,99277,126,129,98781,98431,62693,57788,66590
98465,99,294,60652,37813,5.87027e+18,158.895,3250.92,98465,111,117,97744,97003,43332,45377,50208
29213,152,307,18118,11095,5.88027e+18,169.993,2275.6,29213,137,127,28745,28330,19566,21532,21598
99630,272,309,61689,37941,5.87266e+18,195.528,3639.86,99630,154,161,99321,99284,84579,93259,89416
1040,13,157,647,393,5.87294e+18,37.3173,332.066,1040,41,42,538,291,143,162,238
6778,118,271,4201,2577,5.87854e+18,100.913,1015.45,6778,75,76,6461,6270,3302,3204,2260
39514,120,340,24534,14980,5.87834e+18,119.004,2757.77,39514,132,124,38695,37787,28809,30428,27015
57607,123,217,35650,21957,5.87033e+18,127.858,2518.27,57607,88,88,57356,57205,45693,45519,50910
87994,275,301,54306,33688,5.87101e+18,159.355,3215.4,87994,116,127,87693,87658,78632,83960,84310
49742,37,196,30752,18990,5.87021e+18,103.943,2295.39,49742,84,86,45445,40280,11062,15195,11923
95449,31,294,59990,35459,5.89434e+18,241.584,4167.51,95449,213,211,66310,44172,11567,18360,11104
68043,168,249,41903,26140,5.86978e+18,150,2553.86,68043,106,113,67744,67582,47757,50745,54433
43711,47,211,26995,16716,5.87017e+18,102.525,2163.15,43711,89,88,41941,39946,10516,14927,13922
40329,166,269,24912,15417,5.87503e+18,176.656,2281.85,40329,131,132,39847,39435,27882,25753,29859
9678,55,134,5957,3721,5.87005e+18,75.3999,880.642,9678,61,61,9456,9249,5255,4811,4760
39632,70,196,24493,15139,5.87022e+18,117.507,1979.36,39632,82,85,39172,38850,17931,17813,19231
67973,50,279,41991,25982,5.87013e+18,154.05,2894.86,67973,105,112,65330,61983,15830,22924,19416
73545,237,318,45649,27896,5.87975e+18,235.188,3542.46,73545,183,186,73175,72962,58318,63256,55611
35213,152,172,21668,13545,5.87012e+18,101.5,1798.75,35213,78,86,35041,35030,32801,33844,33705
33140,200,328,20378,12762,5.8705e+18,138.109,1983.55,33140,94,100,32812,32739,22040,18567,15826
40568,142,271,25270,15298,5.88429e+18,218.859,2556.41,40568,164,166,39523,38447,23015,20947,21061
95063,118,294,58705,36358,5.87034e+18,177.33,3222.89,95063,116,120,94461,93852,49367,44416,42782
90553,52,285,55791,34762,5.8702e+18,155.171,3155.32,90553,105,112,87972,84426,21920,31791,29702
81125,196,273,50338,30787,5.87495e+18,214.591,3272.15,81125,166,167,80601,80082,59345,65712,59609
73933,5570,13505,46682,27251,5.71745e+18,568.308,19716.5,73933,846,309,60428,60005,33977,36423,5335
97294,267,352,59985,37309,5.87011e+18,170.438,3527.47,97294,120,120,96942,96804,82230,89543,84408
33273,81,176,20506,12767,5.8699e+18,104.649,1803.44,33273,79,81,33007,32917,19307,17717,18701
75062,169,302,46282,28780,5.87071e+18,159.579,3002.22,75062,112,120,74634,74387,57737,56196,60778
68678,199,300,42390,26288,5.87078e+18,151.148,2864.61,68678,108,112,68336,68197,61486,61483,62502
27770,288,397,17231,10539,5.87463e+18,165.011,2457.13,27770,122,117,27373,27310,25672,25847,23829
94160,67,307,58258,35902,5.87122e+18,230.451,3383.04,94160,133,136,92050,90322,21607,34350,29972
76443,145,316,47194,29249,5.87313e+18,191.137,3330.95,76443,141,146,75669,75143,53140,52810,52488
69169,78,214,42618,26551,5.8701e+18,131.264,2629.54,69169,94,99,68520,68142,31023,30406,35617
26106,23,256,16230,9876,5.88271e+18,192.846,1969.35,26106,141,137,19120,13933,2851,5477,2329
16062,67,228,10055,6007,5.88981e+18,173.603,1562.73,16062,132,125,14098,12178,4250,5602,5349
46061,75,240,28259,17802,5.87126e+18,162.789,2110.71,46061,106,109,45157,44528,13820,17108,16344
82173,166,275,50615,31558,5.87503e+18,235.014,3247.47,82173,162,163,81390,80623,54369,48369,54781
13985,209,257,8683,5302,5.88089e+18,131.231,1474.19,13985,106,104,13728,13676,11995,12719,11912
98834,191,411,61167,37667,5.87904e+18,240.02,4445.09,98834,191,199,97999,97162,54532,53880,46308
14109,62,82,8703,5406,5.87022e+18,68.5577,903.365,14109,69,71,13930,13729,11763,12518,12439
6934,21,111,4300,2634,5.86908e+18,55.0361,688.176,6934,58,59,5385,4045,1745,2139,2413
57155,137,243,35299,21856,5.86999e+18,118.497,2436.23,57155,94,99,56894,56727,35526,30599,30830
8739,84,228,5386,3353,5.87273e+18,104.431,1021.4,8739,81,77,8323,8054,4795,5074,5380
72083,242,257,44538,27545,5.87022e+18,126.563,2983.84,72083,104,104,71826,71763,70503,71329,70507
86054,175,216,53041,33013,5.86992e+18,129.498,2927.12,86054,95,103,85838,85758,78891,82917,83602
44096,258,381,27307,16789,5.87101e+18,164.56,2722.14,44096,118,113,43715,43620,39354,40293,38951
62065,178,285,38671,23394,5.87971e+18,234.13,3109.99,62065,177,172,61420,60637,41483,42265,43531
89933,17,285,55918,34015,5.87754e+18,223.76,3616.32,89933,186,180,62488,41540,8914,16662,5869
46355,165,173,28640,17715,5.86979e+18,104.782,2059.32,46355,84,89,46182,46182,45477,45959,45751
44102,259,290,27273,16829,5.8714e+18,162.113,2339.97,44102,109,115,43812,43787,38723,41808,40304
10303,189,321,6394,3909,5.87107e+18,133.41,1324.44,10303,84,84,9982,9910,9643,9593,9618
26306,15,327,16279,10027,5.87087e+18,151.071,2034.35,26306,98,96,16047,9282,3272,3677,2703
60230,166,264,37291,22939,5.87092e+18,169.566,2514.3,60230,114,122,59834,59558,43713,40428,47830
5260,42,242,3301,1959,5.8886e+18,110.179,917.641,5260,80,81,4264,3400,1414,1460,1128
88082,107,294,55329,32753,5.89358e+18,236.644,3978.61,88082,214,205,82549,75686,34221,33552,38823
21492,68,252,13236,8256,5.87146e+18,135.818,1560.23,21492,97,98,20692,20024,5907,8439,7449
2043,37,60,1247,796,5.86265e+18,44.5423,306.362,2043,45,44,1898,1730,1350,1289,1612
99118,101,317,61170,37948,5.87187e+18,236.557,3641.21,99118,149,144,97687,96271,41222,44705,50469
20272,123,217,12469,7803,5.86968e+18,106.452,1365.9,20272,77,82,20047,19908,15848,16933,17176
54128,150,275,33330,20798,5.87512e+18,190.864,2620.73,54128,138,138,53482,52985,33575,31547,37131
82861,129,282,51240,31621,5.87087e+18,156.461,2980.21,82861,114,127,82271,81690,43997,42415,51370
65765,156,279,40625,25140,5.87028e+18,157.141,2854.86,65765,103,112,65373,65067,42923,37643,49701
54976,239,305,34450,20526,5.89179e+18,224.536,3233.41,54976,181,192,54631,54480,44165,45596,40911
4957,51,76,3057,1900,5.8702e+18,67.5893,539.777,4957,61,63,4744,4403,3186,3054,3712
43144,69,197,26593,16551,5.86962e+18,112.826,2074.48,43144,84,85,42660,42258,20254,21101,22813
30161,103,220,18560,11601,5.87055e+18,163.621,1687.57,30161,91,96,29751,29389,15969,16122,18683
85817,220,285,53414,32403,5.87861e+18,244.184,3607.52,85817,178,188,85389,84950,70969,75715,72490
75424,115,238,46608,28816,5.87034e+18,154.805,2933.14,75424,95,95,75058,74826,46787,42612,45688
77888,254,411,48208,29680,5.87853e+18,205.963,4010.9,77888,180,180,77461,77361,56957,54673,41810
77194,260,411,47867,29327,5.87804e+18,194.831,4059.63,77194,174,178,76782,76687,62598,62485,52419
92553,161,294,58153,34400,5.89452e+18,245.17,4110.38,92553,212,211,90913,88555,54070,51665,59244
61016,43,225,37702,23314,5.87008e+18,137.264,2579.65,61016,88,90,57510,52311,12455,18767,14539
76791,120,262,47323,29468,5.87004e+18,136.851,2836.95,76791,101,106,76417,76052,48851,50214,58136
26862,164,242,16946,9916,5.90042e+18,195.743,2110.29,26862,165,159,26318,25596,19090,19386,20705
5523,16,105,3410,2113,5.86934e+18,57.0831,624.428,5523,60,58,3697,2372,882,1117,1178
55898,145,182,34522,21376,5.87005e+18,120.559,2332.98,55898,84,89,55706,55641,50096,52959,51446
12331,72,251,7657,4674,5.88202e+18,138.376,1358.27,12331,107,104,11335,10491,4250,5190,4039
9745,28,229,6144,3601,5.89447e+18,174.313,1267.65,9745,122,112,6228,3524,1113,1691,1196
8070,71,127,4973,3097,5.86825e+18,66.0805,796.078,8070,62,61,7928,7918,5427,5200,4977
70019,56,227,43247,26772,5.86982e+18,140.199,2726.35,70019,92,96,68565,66488,16222,24503,22718
45356,115,286,28141,17215,5.8794e+18,215.14,2682.68,45356,161,154,43927,42411,20932,21016,25479
49816,202,270,31089,18727,5.8821e+18,209.474,2765.6,49816,168,170,49400,48968,39633,42459,38183
8677,57,123,5328,3349,5.86907e+18,70.0115,789.998,8677,59,61,8482,8379,4406,4359,5446
29102,191,197,18023,11079,5.87012e+18,115.192,1704.16,29102,78,79,28905,28901,28819,28888,28878
67876,128,290,41974,25902,5.87079e+18,153.603,2805.92,67876,115,125,67320,66776,38504,37581,36464
37160,72,173,22932,14228,5.86962e+18,108.21,1824.46,37160,81,85,36739,36538,17284,17464,20279
77126,84,274,47701,29425,5.87618e+18,229.669,3253.11,77126,183,168,73876,70650,22493,30320,25311
77509,151,272,47792,29717,5.87294e+18,218.069,3094.84,77509,154,157,76671,75982,47623,44710,54916
93873,129,279,58105,35768,5.87105e+18,184.503,3190.73,93873,139,136,93062,92185,45642,43011,42839
96962,136,217,59761,37201,5.87005e+18,138.57,3158.59,96962,96,103,96685,96486,72087,69581,85361
30793,120,201,19058,11735,5.86969e+18,102.982,1873.78,30793,83,83,30582,30518,25075,25456,24110
63819,145,215,39346,24473,5.86987e+18,130.942,2582.96,63819,88,93,63589,63451,52109,50774,53857
24308,62,250,14976,9332,5.87122e+18,150.566,1631.92,24308,101,102,23247,22453,6473,9443,9681
14833,137,154,9114,5719,5.87015e+18,102.6,1110.82,14833,68,72,14679,14628,13699,14287,14406
41757,117,316,25828,15929,5.87462e+18,154.624,2565.42,41757,121,121,40974,40285,27344,29647,26569
75242,390,411,46694,28548,5.87741e+18,194.94,4000.87,75242,168,169,74831,74801,74265,74610,72167
44808,224,272,27654,17154,5.87433e+18,202.726,2420.16,44808,139,138,44508,44348,40305,42028,41932
35726,158,224,21978,13748,5.86953e+18,125.11,1812.37,35726,89,93,35502,35431,26686,29572,27168
28091,235,257,17290,10801,5.87158e+18,184.07,1790.28,28091,100,103,27834,27783,27297,27593,27605
4840,103,115,2971,1869,5.87005e+18,63.3409,599.144,4840,52,53,4725,4715,4328,4569,4446
9512,69,116,5848,3664,5.87018e+18,57.5137,859.042,9512,61,62,9394,9370,7423,7299,7007
74682,289,294,46106,28576,5.87027e+18,162.843,2849.25,74682,108,109,74388,74388,74154,74304,74388
12820,86,229,8077,4743,5.89311e+18,178.543,1406.57,12820,127,119,11587,10181,5095,4846,5847
53279,193,216,32824,20455,5.86994e+18,131.189,2370.21,53279,88,94,53063,53054,50809,52093,51655
7947,18,199,4928,3019,5.86762e+18,115.474,984.383,7947,71,76,5131,3044,1108,1318,809
43155,85,260,26727,16428,5.87017e+18,153.626,2380.34,43155,104,104,42382,41953,23462,21839,23900
36442,59,159,22501,13941,5.86981e+18,91.3441,1828.68,36442,79,84,35859,35131,14279,15528,17012
40696,176,266,25241,15455,5.8741e+18,212.189,2284.65,40696,129,128,40280,39905,28823,31448,29493
59438,198,315,36726,22712,5.87172e+18,158.038,2825.55,59438,114,111,59123,59026,57694,57663,57283
13616,11,272,8420,5196,5.87128e+18,90.979,1372.03,13616,87,84,7398,4769,1246,1866,1104
36896,53,249,22735,14161,5.8702e+18,105.821,1967.95,36896,88,93,35772,34299,14193,15849,16947
89732,50,279,55445,34287,5.87012e+18,149.339,3291.78,89732,110,114,86242,81382,21509,30104,23286
54527,106,250,33680,20847,5.86991e+18,149.558,2630.46,54527,104,101,53995,53622,32272,28922,30661
39543,167,262,24692,14851,5.88271e+18,203.969,2450.65,39543,163,154,38935,38220,26817,27177,27512
46882,77,309,29162,17720,5.8826e+18,217.678,2820.3,46882,170,172,43371,39890,10452,17101,6380
98619,154,290,61108,37511,5.87286e+18,200.521,3470.09,98619,156,156,97829,97121,55696,47450,51899
27845,133,154,17215,10630,5.86969e+18,70.8835,1608.15,27845,77,78,27691,27691,25862,26889,25214
58013,122,259,35754,22259,5.87034e+18,136.255,2491.16,58013,97,103,57678,57399,37156,38428,42957
13773,110,160,8512,5261,5.87012e+18,72.7931,1142.25,13773,70,75,13613,13559,10967,10809,10980
87140,253,281,54371,32769,5.88226e+18,209.125,3731.17,87140,199,190,86851,86758,80508,84308,84028
66520,145,285,41451,25069,5.87933e+18,229.667,3196.98,66520,178,174,65309,64099,36788,33073,36147
86936,217,227,53672,33264,5.86998e+18,152.785,3070.26,86936,95,100,86709,86693,86679,86701,86688
69104,128,426,42851,26253,5.87451e+18,156.796,3755.9,69104,141,130,68225,67279,48386,47521,47290
34814,11561,13719,22139,12675,5.45719e+18,973.363,17714.7,34814,842,307,21095,21053,19424,19505,18554
52882,21,285,32957,19925,5.88015e+18,218.613,2891.3,52882,167,164,38358,27995,5322,10845,4864
47610,11,184,29411,18199,5.87013e+18,111.166,2161.88,47610,82,84,25305,16014,4129,6275,3941
44245,128,188,27337,16908,5.87014e+18,110.938,1985.01,44245,84,91,44047,43911,33197,33218,38172
33072,333,411,20547,12525,5.87621e+18,152.127,2748.85,33072,130,121,32661,32622,31260,31275,29957
7958,82,133,4930,3028,5.8695e+18,72.2317,791.95,7958,60,64,7816,7779,6110,6375,5791
66927,207,272,41298,25629,5.87373e+18,238.222,2941.45,66927,154,155,66502,66116,53686,59375,54915
67011,151,279,41403,25608,5.87021e+18,147.653,2808.96,67011,96,104,66647,66421,38706,33032,44446
79552,279,285,49482,30070,5.87792e+18,218.742,3421,79552,179,177,79267,79245,76773,78486,77715
33254,193,261,20439,12815,5.8712e+18,136.04,1911.68,33254,102,106,32957,32841,27342,29576,27603
79202,149,215,48809,30393,5.8702e+18,135.952,2842.24,79202,93,98,78974,78815,66681,67951,74008
35969,124,236,22260,13709,5.87039e+18,126.777,2092.62,35969,90,90,35668,35506,27794,27321,27984
91041,125,274,56178,34863,5.87351e+18,231.756,3377.48,91041,166,163,89527,87779,43249,42943,44147
3783,56,123,2341,1442,5.86926e+18,51.0204,564.077,3783,52,54,3629,3543,2284,2206,2494
79576,151,217,49082,30494,5.87032e+18,130.145,2866.52,79576,91,97,79345,79191,65163,67135,68943
83418,199,342,51506,31912,5.87033e+18,154.127,3300.23,83418,116,109,83036,82864,75873,73883,77967
48797,228,266,29996,18801,5.87203e+18,187.728,2307.86,48797,111,121,48519,48441,43186,46188,45219
11906,128,207,7313,4593,5.87251e+18,93.8754,1049.76,11906,70,75,11699,11631,8250,8190,7420
44982,101,228,27808,17174,5.87006e+18,150.394,2293.17,44982,90,89,44611,44467,25852,23002,24730
60575,14,199,37334,23241,5.87013e+18,126.951,2440.14,60575,92,94,38604,22689,7054,6223,5861
51424,19,226,31652,19772,5.87004e+18,124.691,2182.13,51424,93,97,38888,26510,7240,8645,6309
5162,38,71,3174,1988,5.86732e+18,57.8264,521.795,5162,56,57,4771,4308,2878,2776,3710
35219,72,257,21707,13512,5.87164e+18,151.525,2018.12,35219,113,115,34045,33194,9373,13270,11609
18940,221,246,11678,7262,5.87144e+18,141.152,1448.82,18940,90,96,18694,18659,16824,17902,17753
49054,109,220,30174,18880,5.86969e+18,155.861,2127.13,49054,96,105,48613,48195,25319,24296,25944
72537,55,294,44800,27737,5.87031e+18,168.011,2813.18,72537,107,111,70676,68550,16421,24222,23126
52350,291,330,32787,19563,5.88833e+18,179.538,3265.83,52350,173,176,52020,51979,47038,48411,46693
12113,223,230,7580,4533,5.88999e+18,175.156,1361.04,12113,120,114,11883,11879,11819,11854,11874
94291,11,301,58146,36145,5.87088e+18,170.251,3317.71,94291,121,127,53476,34733,9443,10770,4613
21701,3,246,13366,8335,5.87573e+18,164.048,1606.82,21701,105,104,3685,0,44,401,200
45140,165,264,27829,17311,5.87242e+18,203.707,2301.43,45140,125,125,44690,44332,31301,29782,32621
22528,107,163,13839,8689,5.8712e+18,98.4353,1364.31,22528,76,80,22338,22225,16392,15489,14717
49104,179,226,30388,18716,5.87013e+18,124.885,2092.11,49104,91,99,48878,48810,41247,45134,44512
16287,93,242,10108,6179,5.87417e+18,152.643,1382.3,16287,96,98,15698,15202,7877,7651,8276
57915,282,381,35836,22079,5.87112e+18,180.913,3015.47,57915,128,129,57534,57421,48860,52185,46746
7054,11,146,4329,2725,5.8703e+18,61.9039,757.423,7054,60,61,3936,2518,681,931,1066
41635,166,264,25608,16027,5.87293e+18,202.834,2197.09,41635,117,123,41210,40919,28136,26160,26096
78334,78,270,48501,29833,5.87002e+18,200.798,3228.61,78334,121,126,76854,75980,30302,27626,32044
96724,169,285,60344,36380,5.8821e+18,243.582,3927.1,96724,208,195,95589,94023,62391,60203,61610
50244,64,181,30894,19350,5.8704e+18,106.348,2187.4,50244,85,93,49556,48975,20199,20769,22965
86025,197,300,53126,32899,5.87097e+18,192.753,3175.11,86025,121,123,85661,85443,69615,74047,77490
99775,110,272,61587,38188,5.87401e+18,234.842,3596.41,99775,174,183,97568,95112,43816,45892,45532
81937,85,289,50499,31438,5.87036e+18,144.934,3020.99,81937,102,107,81205,80670,34279,36978,40845
54687,304,376,33804,20883,5.87112e+18,168.586,2947.39,54687,114,108,54311,54250,53330,53651,52786
88049,370,426,55160,32889,5.8882e+18,241.947,4449.86,88049,204,214,87623,87545,74446,79733,71095
70261,2398,2683,44328,25933,5.87371e+18,221.284,6168.96,70261,247,208,67578,67578,56042,59237,17575
73062,244,260,45151,27911,5.87047e+18,143.741,2705.03,73062,108,112,72802,72802,71529,72215,71848
32960,190,265,20478,12482,5.87621e+18,174.683,2087.35,32960,130,126,32624,32391,25022,27880,24511
75537,114,279,46648,28889,5.8701e+18,167.699,2974.18,75537,97,104,75025,74607,36536,31289,36666
39018,41,195,24062,14956,5.86991e+18,103.587,2031.38,39018,83,82,36583,33026,10467,13342,11961
81338,179,277,50313,31025,5.87085e+18,150.305,2989.48,81338,120,124,80995,80787,55221,54588,52141
29337,95,283,18213,11124,5.87578e+18,211.329,2060.63,29337,124,115,28429,27528,11741,12006,8394
88337,172,277,54939,33398,5.87881e+18,229.072,3583.45,88337,189,184,87456,86307,58581,55530,57645
64358,138,252,39814,24544,5.8705e+18,152.156,2504.37,64358,109,112,63977,63585,38217,34168,38242
28356,73,257,17459,10897,5.87151e+18,140.39,1776.08,28356,96,99,27556,27028,11142,13679,13838
34060,113,194,21043,13017,5.86977e+18,112.654,1843.22,34060,79,81,33844,33744,21727,19335,20910
88758,10,315,54747,34011,5.87301e+18,199.37,3558.3,88758,152,153,46378,31518,7473,9843,4222
23075,44,282,14457,8618,5.88866e+18,205.29,2026.22,23075,148,142,18593,14735,3946,5669,4513
7999,190,197,4955,3044,5.87071e+18,91.2339,984.174,7999,69,74,7802,7797,7797,7799,7795
13087,116,135,8076,5011,5.87111e+18,76.5019,1045.73,13087,66,70,12952,12934,12284,12673,12830
63071,193,228,39007,24064,5.87056e+18,151.616,2424.47,63071,103,110,62819,62728,52909,58680,57140
98346,181,288,60609,37737,5.8703e+18,136.162,3264.25,98346,109,110,98058,97938,73646,76227,66591
15649,149,215,9695,5954,5.87046e+18,99.4345,1224.01,15649,72,78,15434,15373,14805,14895,15016
28759,135,260,17812,10947,5.86997e+18,194.343,2018.63,28759,101,104,28275,27873,17738,14244,15093
42645,109,177,26351,16294,5.86988e+18,96.1691,1996.49,42645,82,89,42430,42288,29429,28155,28942
43663,115,212,27011,16652,5.87011e+18,125.594,2223.55,43663,88,87,43405,43312,29813,27453,28212
62393,238,271,38632,23761,5.87101e+18,162.1,2569.9,62393,118,122,62122,62108,53171,58403,55602
79338,258,259,49013,30325,5.87007e+18,146.022,3138.43,79338,105,106,79079,79079,79079,79079,79079
68798,249,279,42494,26304,5.87026e+18,153.361,2911.11,68798,106,112,68519,68467,64459,65140,64386
89872,73,309,55279,34593,5.87174e+18,225.455,3301.04,89872,121,135,88197,86969,23127,35280,33794
2226,67,204,1407,819,5.89533e+18,119.133,593.056,2226,75,62,1767,1362,706,714,885
3296,10,71,2026,1270,5.87148e+18,57.4848,420.98,3296,53,53,1585,1030,356,449,585
48492,17,270,30171,18321,5.88264e+18,217.666,2741.11,48492,172,173,31661,19908,4525,8706,3182
73789,34,342,45989,27800,5.88316e+18,170.1,3842.62,73789,173,180,59058,43775,11889,18509,11153
82869,122,216,51086,31783,5.86987e+18,137.992,2899.22,82869,96,100,82565,82265,57918,56760,68148
72601,172,285,45208,27393,5.87866e+18,225.052,3309.93,72601,181,175,71807,70892,47004,46430,50258
65879,329,342,40608,25271,5.87041e+18,158.415,2972.61,65879,117,112,65537,65537,65530,65531,65534
39398,139,224,24234,15164,5.86997e+18,123.011,1899.66,39398,89,98,39159,39009,27982,26242,26497
32609,227,397,20247,12362,5.87571e+18,179.472,2637.22,32609,139,135,32196,32073,25027,23919,21115
33679,240,259,20873,12806,5.87033e+18,152.334,2120.98,33679,96,100,33420,33390,33306,33200,33371
24572,59,276,15407,9165,5.88894e+18,213.256,2083.72,24572,147,148,21220,18332,5116,7819,4327
21819,125,146,13517,8302,5.86992e+18,72.1147,1423.96,21819,76,76,21673,21673,20479,21150,19828
46220,102,316,28542,17678,5.87319e+18,131.439,2631.12,46220,118,113,45422,44724,28948,28079,28766
79571,121,381,49208,30363,5.87072e+18,164.812,3451.82,79571,126,122,78781,78095,46524,46222,47527
8132,15,211,5009,3123,5.87038e+18,100.924,901.489,8132,71,72,5719,3747,883,1551,973
1453,14,118,891,562,5.85883e+18,44.914,324.19,1453,37,37,1023,681,174,292,77
56738,122,397,35158,21580,5.87332e+18,181.303,3252.82,56738,148,144,55637,54474,28195,28852,26976
39561,83,173,24459,15102,5.87032e+18,92.1536,1947.03,39561,80,80,39345,39279,28025,27174,27618
50580,152,263,31140,19440,5.87063e+18,174.112,2333.41,50580,114,117,50180,49883,30039,26728,27841
5263,1,76,3262,2001,5.86877e+18,64.8261,549.093,5263,56,59,0,0,0,0,0
25880,27,167,15939,9941,5.86989e+18,111.646,1502.2,25880,77,80,22075,17253,4210,4588,5213
88505,311,381,54764,33741,5.87045e+18,151.032,3584.3,88505,126,121,88124,88027,83408,85991,82609
33067,101,187,20429,12638,5.8696e+18,96.0169,1772.16,33067,83,84,32831,32683,23186,22445,22974
71369,134,258,43982,27387,5.87006e+18,134.074,2736.87,71369,97,102,71048,70846,48240,48040,57700
93984,381,426,58559,35425,5.88057e+18,191.498,4660.37,93984,186,189,93558,93503,88582,90825,85589
91613,177,279,56603,35010,5.87e+18,177.604,3321.95,91613,104,112,91265,91059,62417,53112,76814
56717,57,261,35565,21152,5.88962e+18,230.739,3069.95,56717,188,184,48444,41855,10631,16726,14565
25738,98,258,15831,9907,5.87241e+18,188.441,1705.82,25738,97,104,25212,24808,12359,11788,14517
76531,249,342,47280,29251,5.87391e+18,185.262,3506.23,76531,142,137,76189,76088,74119,73745,72800
39321,93,183,24213,15108,5.86976e+18,116.317,1836.24,39321,83,88,38991,38694,22694,21210,24320
25549,120,149,15785,9764,5.8696e+18,81.3961,1514.21,25549,73,78,25400,25367,21880,23335,22073
16729,179,243,10316,6413,5.87176e+18,146.651,1374.71,16729,88,95,16458,16344,13171,14626,14109
64849,265,286,40274,24575,5.88084e+18,232.188,3205.6,64849,176,175,64563,64524,62452,63590,63322
99250,37,257,61373,37877,5.87014e+18,144.86,3461.38,99250,110,108,89879,79018,22917,30370,23157
9511,62,119,5895,3616,5.86946e+18,58.7793,871.306,9511,61,65,9378,9338,6330,6413,5523
52765,364,426,33068,19697,5.88853e+18,193.849,3664.25,52765,178,186,52339,52271,46689,47794,42972
10196,25,145,6296,3900,5.86847e+18,85.4619,887.832,10196,65,65,8739,6931,1774,2629,2438
52381,12,254,32265,20116,5.86998e+18,122.844,2339.91,52381,98,100,30891,19148,5715,5431,3884
47976,66,183,29556,18420,5.87003e+18,96.3598,2191.72,47976,81,84,47491,46883,22657,22872,23375
13778,25,211,8474,5304,5.87106e+18,95.2976,1129.75,13778,77,76,11727,9354,2231,3166,2735
75901,223,272,46808,29093,5.87303e+18,220.122,3070.6,75901,154,157,75550,75265,65247,70271,67638
2364,105,172,1459,905,5.87024e+18,56.2479,500.908,2364,51,59,2192,2188,1899,1896,1680
66592,41,203,41032,25560,5.87028e+18,121.772,2576.53,66592,91,96,63026,57532,14972,22528,17658
5159,39,238,3233,1926,5.89282e+18,108.732,971.358,5159,91,82,3843,2720,1468,1464,1458
85022,255,286,52631,32391,5.87695e+18,213.708,3521.96,85022,180,180,84717,84609,74494,79802,78188
83583,67,220,51601,31982,5.87007e+18,149.897,3038.69,83583,93,96,82685,81519,33785,33792,37734
91947,181,285,57198,34749,5.87842e+18,240.069,3723.48,91947,185,187,91157,90259,62623,60302,67430
20738,19,128,12872,7866,5.86975e+18,67.3975,1308.09,20738,72,73,14753,9680,3156,4935,2564
97275,367,397,60239,37036,5.87205e+18,191.369,4055.36,97275,148,142,96878,96835,94900,95999,94002
77533,267,303,47798,29735,5.8703e+18,157.377,2997.88,77533,119,123,77230,77211,65590,72312,69383
77081,67,198,47590,29491,5.86995e+18,126.189,2806.13,77081,90,97,76293,75465,29280,31968,34979
72920,198,215,44952,27968,5.87004e+18,137.193,2742.17,72920,91,96,72705,72697,72096,72089,72122
40858,31,195,25207,15651,5.86999e+18,102.8,2076.52,40858,83,83,35391,27675,8480,11682,10285
81753,107,231,50400,31353,5.87018e+18,143.168,2903.19,81753,95,100,81330,80919,45956,42265,48195
72401,129,286,44877,27524,5.87865e+18,226.835,3306.5,72401,179,176,70708,68677,35294,34955,40416
29930,33,167,18410,11520,5.87036e+18,104.926,1615.99,29930,76,84,26943,22121,6334,9046,8274
38684,42,267,23894,14790,5.87373e+18,203.324,2241.61,38684,125,127,35296,31976,6412,10800,6539
92480,15,279,57133,35347,5.87007e+18,161.788,3344.81,92480,108,115,59141,34540,10610,13003,9529
78784,269,307,49122,29662,5.88606e+18,237.153,3756.76,78784,190,196,78476,78346,71002,73328,71891
68428,115,215,42175,26253,5.87027e+18,134.273,2661.49,68428,89,96,68118,67863,46239,45204,51067
17932,104,266,11096,6836,5.86979e+18,201.841,1657.77,17932,107,119,17024,16221,8085,6663,6606
77736,24,268,47837,29899,5.87077e+18,185.018,2852.23,77736,125,130,64588,50170,10318,16757,7853
88956,81,381,55043,33913,5.87084e+18,178.074,3554.65,88956,133,136,87299,86025,26318,33177,27212
16188,49,179,10004,6184,5.87033e+18,83.872,1298.34,16188,75,75,15411,14330,6239,6023,6534
35303,216,273,21921,13382,5.87555e+18,189.349,2165.68,35303,128,119,35010,34884,30624,32419,32603
26250,251,411,16339,9911,5.88544e+18,187.048,2512.24,26250,151,147,25839,25763,17314,16795,10525
97208,6990,10613,61215,35993,5.79227e+18,419.964,17273.8,97208,770,288,86595,86579,70921,67167,18152
79666,114,232,49130,30536,5.87008e+18,129.833,2920.33,79666,92,97,79330,79033,49398,44100,49176
85477,219,232,52742,32735,5.87037e+18,131.238,3029.76,85477,93,99,85245,85244,84098,84871,84967
81086,44,227,50059,31027,5.86984e+18,136.903,2941.62,81086,92,98,77205,71586,15702,25806,18017
60209,161,240,37254,22955,5.87003e+18,139.199,2668.39,60209,94,95,59938,59675,55169,55458,56941
57348,247,342,35352,21996,5.87018e+18,148.051,2795.45,57348,114,111,57006,56861,49328,52175,50002
80056,40,285,49364,30692,5.87027e+18,141.327,2992.73,80056,99,106,75103,68207,16549,24397,18632
26045,163,177,16094,9951,5.87026e+18,80.7184,1631.98,26045,78,78,25868,25858,25832,25845,25761
2930,15,217,1821,1109,5.87033e+18,80.2765,635.081,2930,59,60,1667,939,326,417,72
23030,51,256,14197,8833,5.87275e+18,143.14,1634.37,23030,92,96,21856,20988,6211,8772,8092
84761,62,274,52385,32376,5.87544e+18,225.001,3370.02,84761,186,169,79901,75948,17516,29896,20484
46802,188,189,28862,17940,5.86971e+18,112.471,2053.94,46802,84,92,46613,46613,46613,46612,46604
33533,109,298,20869,12664,5.88248e+18,135.306,2435.93,33533,141,143,32310,30974,21602,21759,17681
39162,91,197,24208,14954,5.86984e+18,112.988,1961.77,39162,80,83,38863,38693,24576,22743,24472
68070,63,313,42206,25864,5.87867e+18,184.439,3383.27,68070,175,176,63209,58648,20855,28734,20597
14704,62,167,9018,5686,5.8707e+18,86.7369,1085.76,14704,71,71,14376,14183,5943,5986,5793
65125,15,340,40665,24460,5.88498e+18,180.263,3642.87,65125,174,179,37000,19029,5513,7680,3550
77159,96,263,47671,29488,5.87056e+18,143.627,2821.98,77159,108,115,76448,75785,31231,32346,29566
2331,59,194,1469,862,5.90251e+18,119.781,580.618,2331,74,62,1816,1417,684,716,933
52396,93,199,32316,20080,5.86978e+18,122.02,2287.93,52396,89,89,52030,51791,30735,28427,32374
75998,194,260,46945,29053,5.87e+18,176.067,3107.01,75998,110,111,75675,75470,64883,69689,72080
15338,125,139,9432,5906,5.86925e+18,69.2548,1139.97,15338,67,68,15199,15199,14775,14960,14885
19535,88,159,12090,7445,5.86934e+18,94.5795,1264.44,19535,74,77,19311,19170,13113,12488,12772
99836,289,397,61813,38023,5.8719e+18,183.694,4083.37,99836,139,136,99439,99339,96226,96947,92899
44039,101,228,27202,16837,5.87008e+18,121.724,2131.05,44039,84,91,43721,43541,28258,25344,27682
60658,141,266,37986,22672,5.8901e+18,228.913,3190.35,60658,189,189,58904,56698,33544,31028,33737
26318,151,166,16210,10108,5.86969e+18,80.8086,1571.42,26318,78,79,26152,26151,25721,25986,25684
33370,101,171,20633,12737,5.8699e+18,97.6889,1801.02,33370,81,83,33170,33125,24917,23335,21287
50766,178,180,31353,19413,5.87011e+18,113.188,2228.14,50766,83,85,50586,50583,50357,50382,50586
55467,273,301,34189,21278,5.8711e+18,149.419,2624.93,55467,100,106,55166,55127,54096,54682,54693
57558,13,296,35422,22136,5.87086e+18,168.657,2591.55,57558,99,109,35227,20739,6155,6541,3578
88975,114,302,54820,34155,5.87065e+18,160.432,3235.65,88975,121,129,88246,87488,46760,50762,48652
79713,225,321,50235,29478,5.89749e+18,232.885,3859.95,79713,205,201,79325,78934,63387,66023,68152
96430,243,274,59568,36862,5.87484e+18,241.711,3567.4,96430,180,177,96110,95908,82401,90219,89255
86295,147,320,53076,33219,5.87149e+18,238.065,3275.31,86295,125,137,85714,85339,49652,42165,46234
81550,264,316,50599,30951,5.87942e+18,238.551,3701.07,81550,185,193,81229,81115,68474,74993,67900
87560,99,294,53935,33625,5.8703e+18,162.873,3080.05,87560,108,116,86871,86183,38464,39766,44054
21755,89,198,13463,8292,5.86961e+18,99.9563,1588.53,21755,80,84,21499,21412,15821,14812,14936
74051,261,272,45592,28459,5.87139e+18,193.43,2844.1,74051,135,134,73779,73779,72422,72958,73381
14152,36,179,8729,5423,5.86962e+18,84.2616,1170.64,14152,73,73,12867,11586,4075,4829,4573
81335,57,307,50679,30656,5.88514e+18,235.828,3790.83,81335,199,191,71573,63468,15398,24538,18761
82903,88,249,51225,31678,5.87032e+18,160.604,3131.51,82903,100,101,82235,81891,42288,39949,43881
15346,93,211,9520,5826,5.87013e+18,95.8602,1193.91,15346,69,77,15097,14969,10451,9780,11733
87190,199,309,54023,33167,5.87314e+18,203.998,3410.91,87190,153,159,86712,86249,58680,54700,56564
13309,28,239,8376,4933,5.89769e+18,190.884,1481.75,13309,128,125,8848,5364,1565,2479,1860
53660,245,279,33150,20510,5.87014e+18,136.636,2644.46,53660,104,99,53381,53294,52691,52812,52421
33547,112,262,20861,12686,5.88225e+18,206.72,2245.9,33547,151,151,32135,30482,15375,15178,16337
78958,271,283,48682,30276,5.87012e+18,174.381,2931.81,78958,109,119,78675,78675,78533,78650,78558
72523,147,219,44793,27730,5.86996e+18,127.923,2821.07,72523,92,91,72289,72149,59270,62550,60955
64771,52,376,40057,24714,5.87071e+18,155.551,3149.84,64771,115,109,61825,57604,20058,23056,23091
13061,28,149,8039,5022,5.86918e+18,81.3873,1001.82,13061,63,68,11443,9394,2623,3964,3478
99636,192,282,61300,38336,5.87359e+18,201.318,3474.4,99636,156,165,99121,98621,69835,71530,72366
72882,94,227,45013,27869,5.8699e+18,142.617,2790.53,72882,92,98,72421,72092,34999,32866,34167
38083,147,426,23909,14174,5.89038e+18,195.022,3179.62,38083,169,170,37047,35717,19518,18449,14624
82938,28,288,51140,31798,5.87015e+18,143.278,3027.61,82938,106,108,70776,55416,12179,19425,11790
10353,51,81,6408,3945,5.8696e+18,71.8922,781.334,10353,67,69,9979,9280,6215,5684,7648
57644,62,208,35605,22039,5.87013e+18,115.807,2497.9,57644,88,88,56810,55841,22987,24853,24134
84355,300,307,52456,31899,5.88321e+18,246.281,3794.39,84355,196,191,84048,84027,84033,84037,83923
43975,78,212,27056,16919,5.86975e+18,118.484,2099.36,43975,84,90,43544,43320,22244,21539,24728
58088,48,271,36263,21825,5.8871e+18,232.094,3095.85,58088,193,184,48826,39905,9657,15404,9875
27894,176,308,17261,10633,5.87512e+18,108.135,2100.43,27894,111,102,27546,27412,24534,24270,23164
4900,61,74,3027,1873,5.86886e+18,68.1388,536.191,4900,60,63,4779,4675,3716,3654,4365
33746,48,180,20751,12995,5.87009e+18,111.442,1805.02,33746,80,83,32503,30984,9488,12416,11787
53145,132,307,33150,19995,5.88683e+18,213.104,3143.33,53145,174,177,51645,49634,26476,25737,28686
45572,76,270,28242,17330,5.87023e+18,201.391,2496.06,45572,107,110,44537,43943,15644,14491,18022
57339,163,279,35425,21914,5.86988e+18,162.329,2729.08,57339,105,101,56952,56641,48538,48649,49676
18094,68,296,11139,6955,5.86817e+18,122.333,1465.99,18094,82,86,17550,17174,8047,8616,9894
18141,143,155,11203,6938,5.8696e+18,104.221,1216.22,18141,69,74,17986,17948,17494,17613,17792
99159,152,411,61438,37721,5.87604e+18,183.294,4437.53,99159,170,171,98124,96936,70685,70643,70146
52881,46,323,32867,20014,5.88038e+18,174.985,3125.74,52881,156,164,46759,40770,12467,16662,12438
18354,38,173,11400,6954,5.8706e+18,85.4065,1237.75,18354,72,75,16799,15136,3931,5916,4123
94632,125,285,58873,35759,5.87887e+18,234.813,3747.7,94632,190,188,92362,89456,43693,41281,45772
72349,208,216,44604,27745,5.87025e+18,130.211,2696.25,72349,91,98,72133,72133,71662,71763,71969
37723,141,257,23281,14442,5.86993e+18,119.365,2202.18,37723,97,97,37347,37062,26632,23330,29029
83266,115,268,51182,32084,5.87167e+18,187.089,3003.54,83266,134,135,82369,81314,39907,36692,34675
2306,58,71,1423,883,5.86047e+18,54.1977,351.549,2306,48,48,2232,2173,1894,2054,2013
31689,299,426,19955,11734,5.89574e+18,200.965,2829.76,31689,171,173,31263,31208,23537,24192,15530
63108,224,270,38792,24316,5.87241e+18,204.895,2665.16,63108,131,135,62807,62659,53158,58438,56571
69106,87,297,42577,26529,5.87084e+18,156.289,2887.37,69106,117,122,68129,67285,27653,34824,29206
29591,237,299,18605,10986,5.89595e+18,182.222,2395.66,29591,160,162,29292,29242,24084,24527,22917
78668,5306,7375,49556,29112,5.78525e+18,465.483,13478.4,78668,446,287,71293,71283,60411,63884,19696
9157,6,234,5647,3510,5.87456e+18,131.095,1062.43,9157,82,81,3258,0,387,670,327
2128,42,74,1319,809,5.87541e+18,61.0103,354.644,2128,48,50,1941,1715,1070,1081,1407
96306,60,264,59446,36860,5.87005e+18,142.938,3194,96306,103,111,94637,92906,25556,35205,35595
38153,203,217,23480,14673,5.86989e+18,168.59,1897.9,38153,96,99,37922,37846,34490,36456,36730
66700,121,272,41076,25624,5.87153e+18,200.646,2712.73,66700,132,134,65833,64929,33127,33646,36661
78905,51,270,48867,30038,5.87022e+18,231.131,3348.58,78905,133,137,74138,68053,18189,22981,22300
13803,11,189,8514,5289,5.86965e+18,72.703,1092.35,13803,79,78,7126,4507,1108,1593,1910
34977,184,217,21516,13461,5.87013e+18,155.288,1804.31,34977,94,94,34732,34637,29319,32506,31923
94728,267,277,58714,36014,5.87325e+18,216.521,3407.25,94728,165,166,94451,94401,90150,93142,94078
10899,35,121,6685,4214,5.87001e+18,65.094,870.225,10899,65,65,9866,8429,2503,3638,1936
59875,65,270,37050,22825,5.86983e+18,164.219,2777.76,59875,109,107,58507,56861,20086,21016,24098
1172,43,112,719,453,5.86483e+18,40.529,292.218,1172,39,35,1022,916,461,510,405
33233,215,257,20459,12774,5.87526e+18,163.335,2014.04,33233,120,117,32961,32863,28512,31044,29291
42889,179,226,26384,16505,5.86972e+18,128.824,1978.84,42889,91,96,42663,42608,36143,39822,37941
2116,64,74,1305,811,5.86906e+18,58.0813,353.468,2116,46,49,2034,2004,1886,1953,1993
16443,80,246,10359,6084,5.89345e+18,185.961,1645.31,16443,136,138,14582,12602,6084,5884,5290
51747,153,269,32356,19391,5.88521e+18,219.069,2869.24,51747,182,173,50708,49469,31839,30009,33333
32105,253,266,19823,12282,5.87058e+18,121.636,1947.17,32105,84,92,31839,31819,30423,31280,29354
70238,269,397,43493,26745,5.87263e+18,165.548,3562.83,70238,146,144,69841,69743,61502,62982,57178
48662,251,274,30044,18618,5.87391e+18,192.23,2496.58,48662,132,138,48388,48309,44253,46644,46291
30678,181,191,18879,11799,5.86963e+18,107.737,1738.68,30678,83,87,30487,30481,29619,30176,29954
52914,58,271,33229,19685,5.89487e+18,212.658,3039.01,52914,194,186,43830,35851,10294,15284,13275
28473,165,174,17484,10989,5.87087e+18,116.847,1534.68,28473,79,84,28299,28280,27366,27981,28205
32750,85,168,20241,12509,5.86987e+18,102.659,1687.49,32750,79,85,32449,32257,19376,18135,20412
80663,234,300,49784,30879,5.87063e+18,160.32,3067,80663,114,118,80352,80229,75437,77806,75489
91052,218,277,56064,34988,5.87065e+18,168.108,3110.63,91052,123,131,90753,90653,77117,84806,81326
25833,116,180,15869,9964,5.8708e+18,110.093,1479.6,25833,78,85,25636,25514,18954,19462,20762
28841,202,256,18017,10824,5.88388e+18,192.074,2094.33,28841,155,139,28520,28293,23975,25870,25250
43417,18,250,26827,16590,5.87005e+18,146.992,2330.23,43417,98,101,29166,17490,6091,6218,4574
70913,262,317,43856,27057,5.87323e+18,191.96,3238.65,70913,136,145,70595,70501,62709,66496,61216
20454,22,141,12687,7767,5.86966e+18,66.9121,1299.09,20454,73,72,15486,11085,4252,5702,5964
68171,133,273,42214,25957,5.87083e+18,160.225,2666.89,68171,118,125,67622,67158,38685,36758,46220
70242,224,286,44271,25971,5.89747e+18,227.161,3570.82,70242,201,197,69901,69611,60346,62646,64884
42536,220,268,26379,16157,5.87472e+18,166.087,2339.67,42536,131,133,42235,42111,35307,39082,36050
89358,29,259,55038,34320,5.87003e+18,144.708,3046.7,89358,104,110,77455,62395,12964,21035,16960
32194,36,155,19911,12283,5.8698e+18,91.8774,1702.73,32194,74,81,29529,26357,6756,10423,9144
28201,119,249,17413,10788,5.87387e+18,174.522,1866.22,28201,121,116,27521,26756,14331,14021,13930
84853,276,291,53312,31541,5.89382e+18,233.112,3927.34,84853,208,202,84562,84517,82930,83696,83819
42968,87,221,26373,16595,5.8709e+18,131.714,1962.83,42968,95,98,42460,41961,20666,20548,23476
76087,88,342,46961,29126,5.87068e+18,146.989,3173.47,76087,118,113,75105,74375,33955,36994,38157
30884,37,239,19077,11807,5.87038e+18,138.891,1969.07,30884,90,91,27517,23813,6229,8768,7161
21070,191,226,13081,7989,5.87028e+18,79.4238,1460.96,21070,76,79,20844,20836,20773,20802,20734
53486,152,259,32979,20507,5.87013e+18,142.242,2390.29,53486,95,95,53202,53073,44307,45169,47173
93112,241,259,57541,35571,5.87012e+18,144.855,3350.06,93112,105,106,92853,92787,90996,92232,91316
83182,76,397,51526,31656,5.87171e+18,159.576,3724.04,83182,133,124,81466,80206,36956,37600,39590
19033,133,218,11708,7325,5.86962e+18,102.995,1335.94,19033,76,81,18801,18703,15341,15092,17054
48420,194,226,29954,18466,5.87014e+18,127.61,2095.41,48420,90,97,48194,48161,41200,45387,44024
18707,67,163,11495,7212,5.87059e+18,105.366,1254.44,18707,72,74,18358,18186,7811,8036,7584
45770,150,184,28178,17592,5.87021e+18,118.678,2116.38,45770,81,85,45586,45526,42908,44094,44110
12897,103,250,7984,4913,5.87146e+18,120.087,1338.04,12897,85,87,12502,12250,7851,7113,7655
67713,80,234,41726,25987,5.87002e+18,146.951,2569.48,67713,102,111,66846,66184,25065,27153,31265
67687,38,316,41983,25704,5.87882e+18,214.951,3384.4,67687,175,177,58137,49690,11335,18181,8769
68392,280,381,42397,25995,5.87395e+18,231.526,3186.55,68392,147,159,68011,67942,50729,58198,42025
16326,136,165,10023,6303,5.87024e+18,88.6843,1152.74,16326,71,76,16161,16154,14110,15231,14908
23281,152,258,14424,8857,5.8779e+18,192.539,1803.61,23281,118,125,22778,22407,15200,13870,13737
46760,50,190,28738,18022,5.87034e+18,120.318,2053.04,46760,85,97,45429,43952,10946,16302,17220
48297,174,215,29792,18505,5.86992e+18,121.972,2279.53,48297,87,92,48082,48060,43970,46168,43610
81866,21,298,50609,31257,5.87074e+18,152.56,3074.52,81866,117,125,64052,48855,10269,17290,9962
98569,172,224,60878,37691,5.86988e+18,140.835,3258.64,98569,94,100,98345,98294,90133,94428,95961
27592,170,249,16988,10604,5.86981e+18,128.33,1709.66,27592,88,89,27343,27264,19397,19890,19351
47268,263,264,29130,18138,5.87209e+18,198.113,2313.02,47268,124,121,47004,47004,46998,46999,47004
37571,60,256,23192,14379,5.87036e+18,122.235,2024.43,37571,89,91,36749,35889,12651,15319,13108
85349,105,282,52511,32838,5.87397e+18,213.108,3249.79,85349,157,166,83713,82048,37681,38509,38152
7564,107,137,4663,2901,5.86948e+18,65.6795,830.928,7564,66,66,7427,7426,6957,6840,6358
80002,240,260,49286,30716,5.87039e+18,147.692,2895.18,80002,104,107,79742,79725,76629,77073,79222
88272,366,411,54711,33561,5.87421e+18,194.571,4132.6,88272,156,149,87861,87808,86224,87014,85078
40920,111,267,25251,15669,5.87355e+18,209.283,2283.77,40920,132,132,39958,38971,19104,19024,17890
35843,183,272,22150,13693,5.87544e+18,174.07,2208.96,35843,124,130,35436,35144,26996,27005,26173
58372,124,301,35974,22398,5.87111e+18,147.226,2676.8,58372,104,106,57909,57493,42723,43161,47409
50620,228,272,31261,19359,5.87415e+18,208.792,2595.94,50620,140,146,50314,50156,42650,46881,41789
98528,60,286,61032,37496,5.87775e+18,244.982,3837.59,98528,185,197,91464,85537,20086,33114,24206
50453,290,302,31189,19264,5.87348e+18,148.823,2681.82,50453,133,130,50151,50141,49204,49768,49835
90122,65,280,55703,34419,5.87013e+18,201.823,3406.79,90122,111,116,88382,86486,20049,29094,26766
44142,165,273,27379,16763,5.87472e+18,175.865,2398.28,44142,132,134,43657,43269,32931,30603,31551
80552,59,300,49600,30952,5.87121e+18,190.084,3085.19,80552,116,123,78531,76654,19759,29882,32237
94190,308,352,58058,36132,5.87034e+18,171.365,3483.29,94190,118,120,93838,93790,86980,88840,91996
99900,226,276,61621,38279,5.87332e+18,221.983,3523.32,99900,168,164,99526,99169,83204,91919,88992
28196,91,241,17451,10745,5.87017e+18,108.195,1750.2,28196,80,83,27902,27792,18377,17486,19816
40036,252,274,24733,15303,5.87432e+18,202.929,2320.37,40036,126,135,39762,39689,36567,38398,37905
20426,81,138,12554,7872,5.86897e+18,72.3847,1317.27,20426,72,74,20276,20265,12996,12488,13330
74951,275,285,46192,28759,5.87009e+18,150.061,2880.2,74951,105,105,74666,74660,73561,74357,74408
71294,142,274,43992,27302,5.87365e+18,220.681,2994.12,71294,145,154,70372,69695,39869,38928,42041
50705,187,295,31843,18862,5.89469e+18,227.867,3063.74,50705,185,190,50141,49518,32251,32541,29826
90221,219,259,55564,34657,5.87018e+18,144.682,3058.11,90221,104,110,89962,89888,82558,86884,88362
85379,147,302,52763,32616,5.87077e+18,150.272,3173.87,85379,116,127,84909,84599,47568,43986,46303
38899,239,285,24433,14466,5.89301e+18,219.18,2667,38899,180,171,38608,38460,33004,33678,34839
82148,177,285,50770,31378,5.87021e+18,171.151,2977.65,82148,108,119,81821,81606,65696,72112,66812
95722,200,279,59112,36610,5.87012e+18,166.054,3444.84,95722,111,107,95406,95269,91608,93143,93994
77259,195,274,47792,29467,5.87106e+18,165.379,2824.58,77259,120,129,76925,76707,59564,67148,62376
95647,53,281,59271,36376,5.87307e+18,222.88,3409.41,95647,163,164,90786,87271,18957,30171,23639
18995,124,204,11715,7280,5.86947e+18,89.5051,1440.01,18995,82,78,18791,18759,16649,15720,15142
10278,17,150,6349,3929,5.86891e+18,78.9035,900.484,10278,63,66,7651,5272,1293,2093,1728
98672,232,279,60994,37678,5.87016e+18,172.711,3417.68,98672,102,111,98393,98270,81327,91236,88842
40209,228,248,24747,15462,5.87002e+18,113.102,2049.11,40209,93,93,39961,39947,37852,38494,39265
8327,44,125,5136,3191,5.86771e+18,58.8399,792.541,8327,63,62,7942,7424,3054,3460,2774
84280,158,217,51978,32302,5.87017e+18,141.106,2942.3,84280,91,100,84055,83894,72645,76749,80079
71346,57,285,44512,26834,5.88232e+18,235.768,3398.31,71346,189,183,64086,58379,13697,21869,15047
9243,28,224,5758,3485,5.87645e+18,79.7187,1052.39,9243,76,74,7529,5796,2793,3196,3590
28325,185,254,17436,10889,5.87109e+18,144.456,1756.82,28325,101,104,28036,27903,22930,24924,24402
6918,56,207,4386,2532,5.90642e+18,162.953,1034.04,6918,112,100,5214,3747,1550,1773,2181
71823,93,307,44815,27008,5.88708e+18,231.528,3617.82,71823,185,195,67317,61723,23308,27070,25195
82922,368,411,51403,31519,5.87802e+18,189.274,4168.27,82922,176,178,82511,82440,76643,79789,75428
29184,53,292,17999,11185,5.87204e+18,111.419,1941.08,29184,91,89,28044,26536,10124,11099,8752
71048,132,269,43747,27301,5.8712e+18,199.578,2805.17,71048,132,141,70253,69526,38160,37039,41421
64599,240,312,39951,24648,5.87343e+18,157.975,3039.05,64599,135,136,64268,64177,55487,59035,52678
65483,137,224,40498,24985,5.87005e+18,156.569,2688.34,65483,90,93,65216,65023,46350,45031,45736
14639,155,177,9020,5619,5.86942e+18,74.8473,1177.75,14639,74,76,14462,14443,14017,14261,13764
78972,216,269,48834,30138,5.87093e+18,147.284,2932.96,78972,118,115,78702,78619,65482,73167,66511
63832,334,342,39328,24504,5.8703e+18,148.27,2911.78,63832,112,112,63490,63490,63483,63489,63490
46315,277,309,28652,17663,5.87467e+18,157.695,2653.1,46315,132,130,46006,45959,41595,44124,42642
10025,345,407,6282,3743,5.88713e+18,150.421,1659.95,10025,113,108,9618,9589,8814,8719,8037
8907,21,233,5558,3349,5.88464e+18,137.59,1166.95,8907,102,97,6026,4060,1221,1991,1303
42069,180,261,26332,15737,5.88584e+18,226.661,2602.19,42069,175,169,41504,40725,29909,31397,33295
97118,74,294,59823,37295,5.87011e+18,174.927,3251.19,97118,117,125,95709,94735,29768,38484,41762
17986,212,242,11102,6884,5.86871e+18,91.8653,1431.74,17986,80,87,17744,17723,16301,16804,17142
3479,75,160,2142,1337,5.86641e+18,65.3464,560.329,3479,54,54,3287,3234,2362,2415,2264
39161,157,192,24164,14997,5.86997e+18,99.9742,1958.93,39161,83,87,38969,38931,34624,37140,34255
92553,145,294,57148,35405,5.87036e+18,173.354,3165.78,92553,117,119,92104,91752,57481,52767,58248
4240,103,146,2610,1630,5.86952e+18,59.2948,577.626,4240,53,52,4094,4081,3645,3880,3806
28133,179,253,17561,10572,5.88649e+18,198.841,2092.68,28133,152,149,27715,27213,21381,22319,22518
76115,197,274,46785,29330,5.87124e+18,156.553,2804.2,76115,117,125,75786,75595,59701,65350,61996
12464,192,250,7741,4723,5.88237e+18,136,1397.32,12464,109,107,12205,12126,10229,10727,9837
52670,208,211,32398,20272,5.87012e+18,127.021,2281.24,52670,88,95,52459,52459,52392,52396,52459
93791,225,289,57831,35960,5.87041e+18,136.6,3198.36,93791,107,112,93502,93476,81234,86859,87018
84182,205,209,52001,32181,5.87008e+18,129.03,2970.52,84182,92,94,83973,83973,83971,83970,83973
17466,69,150,10799,6667,5.8701e+18,69.5786,1268.1,17466,73,76,17269,17030,12618,13397,12308
10989,44,76,6742,4247,5.87045e+18,64.9504,776.179,10989,63,65,10514,9845,6608,6184,7724
53275,287,312,33105,20170,5.88115e+18,187.627,3062.61,53275,165,167,52963,52941,49412,51491,50730
76994,36,285,47913,29081,5.87769e+18,218.875,3405.61,76994,173,178,66327,56884,11710,20081,12513
71435,166,239,44013,27422,5.86988e+18,128.723,2650.59,71435,101,108,71174,71059,56811,62465,65058
28644,156,164,17598,11046,5.87048e+18,104.04,1534.27,28644,77,85,28480,28475,27786,28268,28400
93915,180,215,57906,36009,5.87023e+18,139.664,3089.49,93915,95,102,93700,93625,85790,90257,91527
32195,101,199,19804,12391,5.86944e+18,108.739,1803.81,32195,79,88,31925,31755,18345,16703,16311
62727,232,426,38980,23747,5.87654e+18,174.024,3738.99,62727,150,143,62301,62226,56910,55931,52053
80311,185,298,49475,30836,5.87066e+18,162.444,3072.84,80311,119,125,79929,79707,60998,56508,59670
6211,62,119,3830,2381,5.86845e+18,55.8686,671.733,6211,58,61,6090,6059,3443,3481,2907
64152,187,270,40046,24106,5.88272e+18,222.278,3152.86,64152,188,179,63541,62739,45906,48809,49346
44472,64,180,27392,17080,5.86996e+18,97.1791,2099.79,44472,80,84,43964,43406,19931,20619,20756
39564,50,296,24418,15146,5.87139e+18,134.593,2268.51,39564,101,102,37783,35820,10629,14282,11761
6996,68,217,4371,2625,5.88466e+18,149.57,999.439,6996,94,88,6202,5506,2206,2601,2314
26751,80,256,16647,10104,5.88316e+18,193.897,2002.5,26751,145,137,24763,22815,8457,10282,9936
88297,50,273,54338,33959,5.87077e+18,173.037,3016.06,88297,125,134,85024,82124,16861,26894,18878
81507,43,215,50350,31157,5.86998e+18,130.845,2926.52,81507,91,97,77382,71096,17693,26576,25522
43183,203,342,26622,16561,5.87021e+18,142.378,2477.72,43183,108,107,42816,42707,33951,31201,36439
48782,13,209,30069,18713,5.86987e+18,131.136,2206.69,48782,87,89,29885,17608,5377,5409,3919
84538,303,316,52167,32371,5.87261e+18,166.147,3410.29,84538,141,142,84222,84201,81951,83556,82259
80876,151,397,50133,30743,5.87328e+18,211.989,3757.44,80876,152,164,79921,79057,47400,46717,41996
36328,7,200,22488,13840,5.8704e+18,116.518,1998.36,36328,83,83,13420,0,1422,2331,1573
52856,7,321,32825,20031,5.88094e+18,179.404,3094.95,52856,164,165,19250,0,2443,3878,1089
51421,14,285,32043,19378,5.88084e+18,227.148,2864.1,51421,167,157,31124,17746,4653,8167,2337
33775,51,160,20776,12999,5.87032e+18,91.3329,1760.96,33775,78,80,32853,31413,10461,12718,14317
99791,107,411,61724,38067,5.87905e+18,233.966,4417.47,99791,193,199,96539,92987,30211,39562,25924
44425,80,274,27430,16995,5.87381e+18,173.289,2406.82,44425,128,134,42844,41441,15569,19995,18842
26897,6,162,16645,10252,5.86964e+18,112.273,1489.53,26897,75,83,9526,0,875,1471,1530
75580,52,240,46533,29047,5.87024e+18,134.918,2755.15,75580,98,104,73574,71048,16390,24864,22388
36721,172,264,22595,14126,5.87366e+18,205.025,2088.31,36721,116,122,36328,36078,25477,25962,24211
55648,332,411,34520,21128,5.88169e+18,220.023,3478.9,55648,174,178,55237,55144,46489,49324,40589
7244,102,148,4466,2778,5.87043e+18,68.1778,845.392,7244,65,68,7096,7092,5746,5551,4824
67703,195,290,41882,25821,5.87099e+18,153.743,2801.52,67703,115,125,67364,67183,48540,46456,45798
27408,117,260,17143,10265,5.88852e+18,218.333,2140.8,27408,155,148,26057,24443,13089,12673,14432
10792,63,209,6840,3952,5.90566e+18,176.098,1289.67,10792,133,119,8599,6338,2815,2941,3742
95912,245,277,59059,36853,5.87083e+18,174.389,3190.03,95912,132,134,95635,95584,83821,90629,91174
34677,104,286,21496,13181,5.87842e+18,208.963,2337.61,34677,144,126,33542,32327,15255,14672,11393
64407,23,214,39734,24673,5.87037e+18,130.228,2589.97,64407,90,91,50861,37179,9368,16067,8754
15536,119,143,9609,5927,5.86996e+18,69.6344,1208.39,15536,73,73,15393,15393,14298,14900,13562
14693,110,246,9279,5414,5.90127e+18,182.452,1596.04,14693,141,131,13566,12164,6613,6183,8048
75664,114,228,46595,29069,5.86988e+18,135.36,2750.67,75664,98,102,75315,74935,46670,43892,50229
68915,4,285,42890,26025,5.87886e+18,203.258,3239.34,68915,172,175,15798,0,8,1949,743
37348,157,199,23057,14291,5.86977e+18,100.25,2043.49,37348,86,86,37149,37078,34986,35990,35035
99760,33,316,61810,37950,5.8778e+18,227.457,4006.44,99760,194,194,83617,67304,14777,25425,10804
16526,211,259,10235,6291,5.86887e+18,127.112,1488.84,16526,87,92,16267,16233,14888,15601,15795
27345,248,261,17143,10202,5.89013e+18,219.582,2146.26,27345,150,149,27084,27014,26833,26993,26963
52649,27,297,32463,20186,5.87134e+18,157.879,2581.13,52649,113,115,44084,33988,7835,13244,7344
4606,117,120,2834,1772,5.87192e+18,56.7455,602.94,4606,54,57,4486,4486,4454,4474,4477
36162,29,215,22368,13794,5.87013e+18,112.647,2021.36,36162,84,82,30105,22107,7802,10174,3663
65852,77,273,40805,25047,5.87415e+18,209.406,2882.68,65852,151,151,63491,61381,17031,24614,23055
15013,174,276,9370,5643,5.88562e+18,121.944,1665.01,15013,114,115,14703,14570,12001,11886,10786
54725,195,259,33737,20988,5.87015e+18,122.615,2417.34,54725,98,101,54466,54427,44997,49644,43187
23355,2050,7096,14627,8728,5.56761e+18,857.044,10179.3,23355,513,249,16259,15884,6707,6634,675
95771,306,307,59229,36542,5.87116e+18,225.04,3404.64,95771,130,141,95464,95464,95463,95463,95464
8259,104,155,5072,3187,5.86928e+18,83.4883,843.653,8259,65,64,8100,8040,5640,5660,5242
7732,97,219,4764,2968,5.87144e+18,110.728,919.095,7732,74,75,7430,7226,4338,4168,4359
4476,63,115,2749,1727,5.86835e+18,64.6537,576.344,4476,51,52,4338,4284,2467,2567,2414
44920,207,238,27771,17149,5.87043e+18,123.89,2172.25,44920,86,92,44682,44653,44605,44635,44614
44978,110,299,27811,17167,5.87431e+18,148.842,2564.84,44978,133,131,44016,43012,26527,27355,24014
27193,157,226,16809,10384,5.86963e+18,116.981,1828.28,27193,87,89,26955,26781,24490,24736,25060
79032,294,381,48892,30140,5.87084e+18,171.313,3270.05,79032,125,133,78651,78538,63590,71401,59198
27152,292,342,16750,10402,5.87023e+18,129.3,2024.63,27152,101,99,26810,26751,24300,25721,25413
83302,347,411,51596,31706,5.87266e+18,189.721,3905.96,83302,140,131,82891,82842,81716,81680,80627
74819,229,294,46211,28608,5.8701e+18,165.39,2848.22,74819,107,111,74525,74475,72073,73412,72250
48157,38,211,29779,18378,5.8697e+18,119.616,2273.99,48157,86,84,44276,39980,9784,14475,10640
97337,163,307,60169,37168,5.87131e+18,232.98,3453.76,97337,135,144,96776,96390,60659,52264,57332
81055,43,275,49971,31084,5.87658e+18,245.719,3312.27,81055,165,173,73831,66814,13494,21226,15243
49560,205,288,30534,19026,5.87103e+18,169.534,2445.82,49560,113,120,49255,49092,36293,41985,33122
68282,91,285,42022,26260,5.87037e+18,148.762,2753.97,68282,104,111,67664,67118,26577,29648,31156
42286,134,286,26241,16045,5.87923e+18,187.47,2591.6,42286,151,148,41371,40386,24227,24097,27063
73126,11,271,45212,27914,5.87008e+18,201.151,3126.05,73126,114,116,37217,23305,6706,6717,3747
68522,191,289,42151,26371,5.87056e+18,143.71,2753.45,68522,98,108,68233,68174,53197,58314,49347
43549,17,257,26950,16599,5.86991e+18,120.956,2233.58,43549,86,90,29517,18329,5216,6821,5405
93391,228,231,57684,35707,5.87005e+18,135.445,3143.97,93391,94,97,93160,93160,93158,93160,93160
96377,105,232,59476,36901,5.8701e+18,140.568,3189.71,96377,94,101,95936,95570,55329,52536,65657
28495,8,180,17656,10839,5.87059e+18,77.27,1693.03,28495,79,78,11826,0,1374,2200,2060
16058,118,282,9922,6136,5.87222e+18,126.422,1513.48,16058,95,95,15659,15356,9201,9492,8953
32084,181,258,20245,11839,5.89829e+18,205.006,2357.56,32084,173,167,31641,31104,22779,23491,23142
8475,111,266,5236,3239,5.87085e+18,94.6938,1117.71,8475,71,76,8148,8011,4452,4275,4353
51652,200,284,32227,19425,5.88145e+18,203.483,2882.03,51652,167,171,51209,50815,38433,40123,38336
40010,255,287,25117,14893,5.89334e+18,206.103,2707.37,40010,178,177,39723,39670,34659,36538,35502
63174,186,234,39043,24131,5.87054e+18,122.254,2467.24,63174,97,105,62940,62885,53365,58961,59004
3285,30,112,2014,1271,5.86659e+18,47.3394,490.587,3285,49,53,2905,2477,870,1035,1036
97022,114,279,59970,37052,5.8701e+18,171.861,3386.01,97022,102,110,96431,95947,47819,41368,54948
82965,173,288,51150,31815,5.87029e+18,148.392,3035.81,82965,105,108,82670,82496,60755,58205,66426
34822,265,381,21556,13266,5.87146e+18,156.462,2492.4,34822,114,112,34441,34352,31537,31856,30346
92807,78,285,57956,34851,5.88356e+18,245.466,3895.17,92807,202,202,86230,79128,21886,31778,29965
52893,124,200,32679,20214,5.87042e+18,115.677,2324.93,52893,86,86,52675,52569,44168,44800,49398
90161,193,282,55897,34264,5.87305e+18,208.659,3312.53,90161,151,160,89655,89176,64572,69340,69604
56050,262,274,34779,21271,5.87991e+18,192.211,2901.93,56050,173,164,55776,55776,55416,55568,55577
16697,166,236,10318,6379,5.86993e+18,111.285,1268.55,16697,83,82,16461,16404,13566,14642,15193
68328,215,342,42607,25721,5.884e+18,169.763,3738.33,68328,173,180,67944,67799,54388,54609,48552
67900,238,268,42048,25852,5.87226e+18,207.185,2780.65,67900,140,140,67624,67525,60402,64561,64401
84374,58,257,52140,32234,5.87043e+18,169.417,3209.99,84374,108,108,82206,79115,21402,28596,26416
38071,231,274,24044,14027,5.90052e+18,209.748,2571.87,38071,181,173,37792,37640,33595,34505,35045
25326,95,154,15580,9746,5.87012e+18,90.5441,1493.7,25326,71,76,25130,25045,17889,16813,18958
57721,61,232,35669,22052,5.87015e+18,129.006,2316.9,57721,93,102,56666,55903,15205,21390,22750
47336,45,279,29537,17799,5.88303e+18,214.862,2761.13,47336,166,170,40583,34337,8047,12615,7075
35067,166,257,21601,13466,5.87135e+18,198.759,2001.14,35067,109,109,34687,34486,24940,24708,26144
72614,62,273,44981,27633,5.87082e+18,158.739,2750.07,72614,120,124,70852,69630,17145,26672,20867
90944,31,411,56284,34660,5.87738e+18,196.649,4293.99,90944,180,181,74284,57240,13765,22317,11288
5132,2,126,3164,1968,5.8694e+18,67.8118,629.411,5132,54,58,477,0,49,0,26
96956,88,342,60489,36467,5.88412e+18,203.838,4376.47,96956,191,203,91290,84349,30715,35950,32497
27982,176,342,17249,10733,5.87076e+18,121.083,2031.04,27982,99,99,27605,27463,19959,17956,22567
7359,76,212,4605,2754,5.88172e+18,136.63,988.805,7359,91,82,6735,6211,2870,3011,2988
90101,223,226,55664,34437,5.87014e+18,156.4,3146.66,90101,95,98,89875,89875,89873,89875,89875
11684,70,77,7193,4491,5.86995e+18,70.356,819.795,11684,66,71,11587,11431,10700,11102,11443
81517,158,300,50363,31154,5.87102e+18,194.736,3105.21,81517,120,120,81060,80795,54634,58827,57886
83959,40,271,51938,32021,5.87e+18,201.567,3333.2,83959,119,119,76476,67676,17650,23723,15676
30137,119,155,18603,11534,5.8704e+18,92.7269,1640.19,30137,74,80,29976,29899,25058,26405,26757
69512,226,273,43127,26385,5.87389e+18,222.377,2963.67,69512,150,153,69170,68922,59443,64257,61856
73389,94,426,46018,27371,5.88915e+18,222.904,4196.6,73389,197,205,68202,62081,19771,25844,16210
87454,100,315,53958,33496,5.87238e+18,206.666,3473.85,87454,144,143,86021,84602,36275,37235,40878
41844,188,197,25771,16073,5.86978e+18,116.239,2031.83,41844,88,87,41647,41631,40855,41422,41408
87316,169,278,53773,33543,5.8714e+18,196.432,3136.86,87316,146,141,86763,86219,58078,52212,59107
62726,160,300,38732,23994,5.87105e+18,150.764,2763.26,62726,111,119,62295,62047,43319,41759,44379
36433,8,175,22544,13889,5.86976e+18,93.8591,1878.83,36433,82,81,15130,0,2178,2031,2149
5435,112,136,3358,2077,5.87154e+18,68.6421,637.219,5435,56,59,5299,5279,4761,4953,4801
65669,76,270,41013,24656,5.88688e+18,229.553,3281.99,65669,190,191,59649,53284,16320,23180,22046
8305,77,143,5110,3195,5.86943e+18,65.4521,884.06,8305,68,68,8159,8126,5835,5503,5290
86885,17,257,53729,33156,5.8703e+18,165.344,3237.28,86885,109,108,57546,34756,10776,13915,8092
57781,174,184,35599,22182,5.87019e+18,118.03,2376.11,57781,84,88,57597,57589,55960,57113,57334
75378,155,269,46455,28923,5.87026e+18,152.379,2824.12,75378,104,109,75078,74903,60214,63037,63871
51039,105,266,31621,19418,5.87216e+18,189.028,2398.5,51039,128,123,50170,49328,22372,21593,22214
20624,220,245,12719,7905,5.87033e+18,89.0458,1500.18,20624,83,85,20379,20373,19274,19914,20143
18426,194,253,11652,6774,5.90112e+18,187.779,1750.27,18426,155,145,18149,17955,14740,14946,17077
3074,17,77,1894,1180,5.86588e+18,57.0982,420.347,3074,54,53,2016,1188,541,710,836
32529,77,261,20139,12390,5.87165e+18,137.664,1890.73,32529,100,103,31736,31181,11370,14205,14546
11910,218,250,7397,4513,5.87359e+18,87.9479,1178.52,11910,73,76,11660,11653,11542,11595,11594
11760,130,249,7336,4424,5.88251e+18,142.768,1338.47,11760,101,105,11296,10883,7355,7070,6826
8202,124,206,5080,3122,5.86989e+18,123.569,1013.52,8202,72,75,7954,7808,6241,6113,6206
50701,128,286,31870,18831,5.89388e+18,226.737,3030.68,50701,192,181,48542,45484,23209,21659,24284
29653,16,173,18279,11374,5.87067e+18,104.647,1673,29653,75,77,19835,12611,3259,5262,3515
57292,30,265,36003,21289,5.89288e+18,214.18,3136.67,57292,197,186,40339,27991,6898,11551,7436
49865,94,197,30824,19041,5.8699e+18,99.6709,2286.13,49865,83,86,49607,49476,32848,32189,32604
78884,221,268,48840,30044,5.87181e+18,198.156,2956.77,78884,137,144,78581,78410,65753,72962,70680
86387,4573,5991,54428,31959,5.81324e+18,409.565,12061.4,86387,363,279,80396,80390,68147,72596,19824
83364,214,288,51390,31974,5.87017e+18,132.652,3034.01,83364,105,106,83076,83040,71071,77206,73266
21397,42,159,13248,8149,5.87074e+18,100.758,1318.17,21397,74,78,20422,19119,5066,7697,7548
21372,174,411,13364,8008,5.88693e+18,181.87,2349.34,21372,144,144,20835,20462,11910,12016,9097
86868,280,301,53500,33368,5.87105e+18,191.868,3188.5,86868,121,123,86567,86504,83841,85410,85348
85969,304,397,53237,32732,5.87225e+18,177.644,3854.96,85969,149,147,85572,85467,79488,81746,74548
50541,30,199,31163,19378,5.87002e+18,94.2714,2256.31,50541,86,91,43792,35071,11139,13353,13500
53202,2,286,32978,20224,5.8788e+18,228.18,2863.03,53202,163,160,4628,0,438,0,209
20321,116,171,12475,7846,5.87016e+18,117.613,1300.49,20321,74,81,20126,19991,15399,14566,16892
79196,162,342,48993,30203,5.87531e+18,188.3,3678.42,79196,151,148,78684,78271,55048,59671,61900
10345,58,85,6384,3961,5.86944e+18,68.552,805.771,10345,68,69,10107,9713,7684,7300,8945
74001,136,200,45664,28337,5.87017e+18,124.077,2760.4,74001,87,91,73773,73641,59313,60310,64844
77981,29,397,48273,29708,5.87258e+18,165.381,3695.94,77981,149,146,64499,49455,13142,20710,13111
81057,146,294,50049,31008,5.8701e+18,162.799,2948.08,81057,109,112,80679,80400,53624,49123,65840
5968,46,111,3664,2304,5.8678e+18,56.069,654.053,5968,56,56,5777,5614,2675,2832,3235
45847,23,183,28298,17549,5.87013e+18,118.06,2115.12,45847,81,83,36417,26706,7004,11922,7810
64826,28,232,39817,25009,5.87088e+18,133.081,2472.51,64826,100,107,56148,45232,8566,14068,12143
43621,190,196,26944,16677,5.86979e+18,105.259,2136.3,43621,83,84,43425,43423,43329,43424,43181
18858,18,123,11706,7152,5.86983e+18,65.8283,1236.71,18858,70,71,13145,8195,2709,4415,2727
67664,126,274,41602,26062,5.87125e+18,161.834,2670.91,67664,116,123,67077,66501,36146,33695,41995
24439,85,178,15061,9378,5.87024e+18,82.6961,1571.69,24439,75,78,24222,24134,13609,12472,13374
81922,157,307,51069,30853,5.88591e+18,235.801,3821.56,81922,193,197,80654,78944,46591,43778,51112
31398,152,167,19350,12048,5.86965e+18,103.107,1640.07,31398,79,82,31231,31222,30050,30427,30642
34448,57,221,21283,13165,5.87023e+18,158.867,1793.16,34448,97,98,33416,32651,8650,12535,14548
67201,285,300,41345,25856,5.87075e+18,178.621,2764.91,67201,102,114,66901,66887,66881,66899,66868
48500,35,286,30534,17966,5.89565e+18,212.345,2965.11,48500,190,181,34395,22687,6289,9301,6971
77102,161,397,47775,29327,5.87347e+18,226.701,3460.15,77102,150,164,76240,75554,36096,35335,33041
56606,171,358,35031,21575,5.8714e+18,170.077,2597.08,56606,110,122,56150,55936,26702,25415,13411
33946,10722,12000,21365,12581,5.53578e+18,936.906,16085.2,33946,772,295,21946,21927,21451,21630,20119
40739,76,257,25153,15586,5.87031e+18,138.273,2274.43,40739,94,95,40027,39682,15781,16983,19066
18702,104,134,11542,7160,5.86998e+18,69.6717,1221.55,18702,71,74,18568,18568,15954,17119,15197
95233,169,279,58843,36390,5.87026e+18,141.901,3411.95,95233,108,112,94859,94591,78599,75311,83488
35128,126,220,21613,13515,5.86965e+18,124.705,1787.45,35128,87,92,34853,34650,23050,21286,27255
97675,397,411,60490,37185,5.8745e+18,193.756,4328.49,97675,164,154,97264,97241,97164,97178,96093
8915,53,131,5485,3430,5.87113e+18,71.5906,840.954,8915,62,62,8676,8410,4189,4083,5243
51709,145,236,31812,19897,5.8701e+18,154.585,2194.26,51709,102,107,51388,51128,35308,30974,40079
72395,99,301,44620,27775,5.87107e+18,149.81,2926.01,72395,114,112,71651,70995,39486,38180,48403
47582,214,226,29448,18134,5.8704e+18,127.817,2067.42,47582,92,101,47356,47342,45223,46571,46706
96487,144,279,59659,36828,5.87611e+18,241.782,3649.17,96487,191,182,95045,93834,51689,48329,51706
63377,146,296,39026,24351,5.87079e+18,165.899,2710.93,63377,118,122,62913,62580,34236,33062,34520
92377,275,314,56978,35399,5.87192e+18,203.494,3550.24,92377,148,139,92063,91957,86320,89340,86296
22909,5,158,14097,8812,5.86948e+18,72.4008,1411.06,22909,76,77,6457,0,168,951,1028
60167,62,314,37130,23037,5.87155e+18,202.015,2847.48,60167,116,113,58524,57185,12395,20067,11824
54931,33,250,33949,20982,5.87005e+18,130.67,2633.8,54931,102,100,47460,35499,11986,15790,13477
5807,163,249,3603,2204,5.88013e+18,103.975,952.772,5807,77,71,5558,5511,4951,4939,4722
68101,172,316,42102,25999,5.87313e+18,156.388,3130.16,68101,135,137,67596,67241,51325,48772,47607
61733,219,299,38016,23717,5.87072e+18,155.217,2728.4,61733,110,118,61420,61307,50696,55369,50313
72392,32,257,44736,27656,5.87032e+18,174.016,2982.57,72392,102,105,62509,47982,12293,18843,12449
78970,232,285,49112,29858,5.8778e+18,211.15,3416.54,78970,175,176,78628,78404,66825,71031,68103
14517,101,155,8913,5604,5.87111e+18,79.4937,1085.99,14517,69,73,14348,14264,10936,10507,10468
24247,135,283,15016,9231,5.87238e+18,165.619,1731.49,24247,93,101,23874,23717,17045,16485,20147
47933,231,235,29528,18405,5.87021e+18,124.396,2157.16,47933,93,94,47698,47698,47578,47655,47698
97505,253,317,60256,37249,5.8728e+18,193.558,3686.44,97505,152,157,97176,97051,86001,91334,83071
22386,11,162,13754,8632,5.87091e+18,95.9988,1357.23,22386,73,78,12636,8103,2106,2652,2424
89834,221,238,55478,34356,5.87016e+18,151.747,3182.04,89834,95,95,89596,89577,89560,89534,89497
90452,2,288,55779,34673,5.87011e+18,148.567,3149.91,90452,105,108,8243,0,873,0,587
95077,59,238,58779,36298,5.87025e+18,155.266,3257.08,95077,95,100,93328,90699,26986,34911,34050
37968,141,189,23443,14525,5.8701e+18,98.3923,1902.77,37968,84,87,37779,37721,32474,34690,31962
73034,108,313,45082,27952,5.87365e+18,192.739,3257.65,73034,148,148,71649,70316,37969,41416,36989
22435,101,219,13869,8566,5.87067e+18,128.197,1462.62,22435,81,87,22121,21900,11663,11496,12119
4470,192,200,2781,1689,5.86806e+18,72.085,722.733,4470,60,64,4270,4267,4264,4267,3812
8739,106,273,5411,3328,5.87758e+18,68.8523,1163.41,8739,80,76,8392,8234,7516,7489,7065
72554,178,274,44931,27623,5.8723e+18,204.071,2883.06,72554,140,140,72065,71593,49103,49258,48265
4850,107,166,2985,1865,5.87244e+18,63.5794,649.822,4850,58,58,4684,4664,3490,3664,3314
83045,83,288,51215,31830,5.8699e+18,147.173,3038.48,83045,105,108,82267,81717,30022,37270,39353
52989,228,264,32828,20161,5.87179e+18,204.798,2441.91,52989,121,127,52707,52600,45935,49748,49819
90538,202,262,55962,34576,5.87009e+18,154.251,3345.44,90538,110,108,90239,90110,83525,86861,88756
89894,250,397,55629,34265,5.87144e+18,177.77,3801.25,89894,126,117,89497,89431,87745,87672,86570
6281,73,150,3864,2417,5.86905e+18,70.9616,771.276,6281,59,61,6102,6047,3808,3845,3941
48450,47,252,30003,18447,5.87029e+18,169.513,2494.14,48450,98,98,45647,42308,11584,14851,13675
87971,200,274,54340,33631,5.87493e+18,239.817,3418.48,87971,175,175,87420,86788,67273,73363,69275
57626,180,217,35461,22165,5.87016e+18,133.438,2442.59,57626,88,95,57409,57391,51982,54997,53872
28684,106,260,17664,11020,5.87237e+18,133.92,1796.95,28684,99,101,28183,27770,16708,17035,17992
3802,63,147,2344,1458,5.86715e+18,65.6312,606.563,3802,56,60,3618,3496,2313,2391,2608
87971,106,301,54243,33728,5.87093e+18,164.108,3221.83,87971,117,125,87172,86364,48085,46734,57326
80602,111,324,49921,30681,5.87756e+18,185.086,3677.86,80602,168,174,78512,76143,39920,43852,37670
56834,22,210,35101,21733,5.87019e+18,111.094,2485.62,56834,88,88,43204,31217,9020,12705,9003
73163,99,307,45654,27509,5.88705e+18,232.066,3648.53,73163,189,196,69047,64178,27744,28506,27014
47581,159,274,29414,18167,5.87565e+18,216.421,2550.47,47581,150,145,46958,46401,31182,29378,29011
76805,119,342,47874,28931,5.88337e+18,195.297,3928.68,76805,175,189,74478,71341,42834,42830,40318
40076,145,290,24769,15307,5.87131e+18,153.712,2253.65,40076,106,111,39659,39431,25501,24501,24013
15892,154,248,9862,6030,5.88e+18,153.203,1490.46,15892,113,105,15529,15263,11620,11432,12008
13347,61,257,8376,4971,5.8886e+18,136.961,1544.54,13347,122,114,11600,10025,5436,6406,4874
90129,142,314,55593,34536,5.87072e+18,232.095,3284.97,90129,121,133,89482,89102,49833,46571,57525
24624,152,154,15200,9424,5.86947e+18,91.1866,1473.56,24624,72,75,24470,24470,24469,24470,24470
4275,24,76,2654,1621,5.87093e+18,61.0526,490.026,4275,54,59,3321,2312,1064,1327,1641
86030,66,231,53155,32875,5.87004e+18,149.745,3057.1,86030,95,97,84997,83843,25510,33103,33240
46340,109,397,28713,17627,5.87078e+18,137.991,2723.27,46340,108,107,45741,45363,33457,31830,31732
51181,22,189,31588,19593,5.86981e+18,110.214,2168.24,51181,85,93,40639,30851,7355,7991,8796
42578,149,202,26272,16306,5.86999e+18,102.106,2105.4,42578,85,90,42376,42328,33442,36513,31541
82271,140,313,50900,31371,5.87305e+18,186.856,3401.78,82271,148,152,81326,80728,49957,48987,47306
37407,38,180,22981,14426,5.87016e+18,119.608,1769.96,37407,83,93,35111,32548,7932,11993,11395
67449,203,300,41666,25783,5.87093e+18,156.894,2863.96,67449,111,121,67108,66919,51404,52233,53475
21897,138,142,13493,8404,5.86942e+18,71.5961,1385.12,21897,72,76,21755,21755,21651,21727,21482
45474,188,194,28089,17385,5.86989e+18,104.003,2193.57,45474,85,86,45280,45280,45276,45276,45278
27577,97,320,17121,10456,5.87934e+18,115.207,2237.76,27577,122,119,26613,25624,17774,18462,14983
90532,8,281,56103,34429,5.873e+18,206.689,3317.88,90532,154,163,41714,0,6099,9522,2505
38076,142,224,23560,14516,5.87035e+18,125.696,1867.9,38076,89,98,37840,37716,25357,23123,24149
39052,98,251,24027,15025,5.8698e+18,127.791,1985.2,39052,91,92,38647,38292,16769,18864,16789
74463,175,200,45944,28519,5.87025e+18,124.128,2777.69,74463,87,92,74263,74244,69518,72372,73222
19272,61,256,12019,7253,5.87908e+18,176.501,1662.52,19272,116,119,17604,16284,5253,7562,6155
1558,12,85,955,603,5.862e+18,36.8935,297.628,1558,39,40,1012,633,217,300,227
52950,22,342,32645,20305,5.87059e+18,159.247,2726.43,52950,113,108,40371,29720,6797,10255,5023
37129,218,264,22832,14297,5.87347e+18,201.926,2091.11,37129,115,123,36846,36702,31493,34373,33142
79137,152,342,48755,30382,5.87029e+18,154.387,3203.45,79137,116,115,78647,78274,48965,47182,54312
62984,83,259,38823,24161,5.87041e+18,114.616,2577.63,62984,95,105,62398,61959,31311,34502,35854
95922,25,289,59136,36786,5.87036e+18,148.792,3232.47,95922,104,114,78950,59042,12491,21174,14390
18293,28,247,11419,6874,5.8864e+18,158.877,1671.37,18293,132,119,13617,9849,2268,4039,2732
17033,1536,5712,10664,6369,5.57144e+18,700.986,8081.68,17033,442,204,11321,10708,4179,3955,494
28887,144,165,17765,11122,5.87043e+18,103.458,1536.76,28887,76,82,28722,28675,25463,27281,26757
95519,200,304,59590,35929,5.8864e+18,225.307,4085.67,95519,202,206,94896,94100,64205,64450,62927
76341,207,246,47012,29329,5.87002e+18,136.574,2793.35,76341,101,103,76095,76092,71890,74323,75256
30360,73,172,18673,11687,5.87023e+18,105.662,1660.21,30360,76,81,29986,29776,13301,13402,13414
71783,108,279,44338,27445,5.8703e+18,149.699,2983.51,71783,107,113,71143,70678,41128,36237,41097
1036,2,81,626,410,5.84809e+18,36.2162,240.16,1036,34,35,94,0,10,0,23
77068,92,315,47558,29510,5.87258e+18,165.684,3292.17,77068,138,138,75606,74117,34312,37147,40345
89548,16,316,55196,34352,5.87277e+18,196.066,3493.13,89548,144,144,61287,40932,9619,12477,9070
70940,131,272,43618,27322,5.87215e+18,192.691,2804.48,70940,134,133,70197,69513,36582,31707,34457
66065,163,260,40746,25319,5.87013e+18,114.127,2677.18,66065,96,102,65805,65719,47646,43314,44549
75526,34,231,46681,28845,5.86996e+18,134.26,2849.79,75526,94,96,67645,55073,14820,21544,16883
88350,149,279,54551,33799,5.87016e+18,151.157,3306.94,88350,109,114,87904,87506,62469,58840,70612
1021,7,70,633,388,5.86426e+18,50.6758,240.536,1021,41,39,359,0,40,73,105
23786,203,261,14906,8880,5.88932e+18,200.509,1993.09,23786,151,143,23484,23277,20108,21474,21105
76188,34,270,47179,29009,5.8703e+18,243.115,3319.01,76188,137,142,64994,49645,13596,18840,12542
45201,98,226,27979,17222,5.87035e+18,125.236,2027.25,45201,90,99,44790,44432,23556,22229,24238
68529,72,262,42258,26271,5.87019e+18,114.234,2730.1,68529,97,102,67756,67104,24920,33831,33538
17879,47,162,11050,6829,5.87007e+18,104.983,1236.34,17879,75,77,17196,16662,4564,6771,6861
33671,84,261,20711,12960,5.87177e+18,133.189,1920.71,33671,99,104,32979,32429,13627,15923,17689
13126,141,252,8138,4988,5.8711e+18,96.0963,1255.5,13126,77,77,12864,12811,12255,12246,12094
70587,273,303,43585,27002,5.87133e+18,158.575,2929.94,70587,113,121,70284,70238,63762,67644,66737
70353,193,279,43462,26891,5.87008e+18,139.719,2971.89,70353,106,111,70036,69834,59268,59242,64618
93994,167,327,58216,35778,5.87651e+18,185.919,3936.11,93994,175,182,93167,92298,64725,63321,61241
7988,59,169,4892,3096,5.8689e+18,79.1199,798.866,7988,64,66,7715,7518,3332,3620,3835
94126,4053,4910,59271,34855,5.84921e+18,311.226,10315.3,94126,319,248,89216,89212,74763,78457,19896
17086,133,409,10637,6449,5.87561e+18,147.959,2005,17086,115,104,16541,16149,11968,11225,11429
42231,177,257,25992,16239,5.87102e+18,172.064,2122.16,42231,109,113,41884,41695,32976,35297,36112
79327,232,376,49049,30278,5.87051e+18,185.904,3420.39,79327,116,113,78951,78845,77264,77188,76900
83096,241,270,51366,31730,5.87008e+18,196.501,3231.56,83096,108,109,82825,82750,78605,81232,77528
18250,94,218,11229,7021,5.86959e+18,103.953,1312.86,18250,77,79,17966,17768,12132,12117,14000
42748,44,263,26455,16293,5.87141e+18,166.656,2161.43,42748,107,114,40373,37888,8780,12731,10900
26425,119,173,16343,10082,5.86927e+18,104.544,1604.55,26425,78,81,26242,26206,19518,20252,17621
33296,120,257,20538,12758,5.87064e+18,110.524,2070.35,33296,91,95,32895,32637,19219,17128,21933
90601,221,286,56150,34451,5.87848e+18,232.376,3674.24,90601,194,182,90179,89770,73761,80088,76349
68952,91,268,42563,26389,5.87026e+18,142.629,2680.17,68952,100,104,68360,67785,33430,32830,43324
77353,60,215,47743,29610,5.8702e+18,129.641,2869.07,77353,89,91,76153,74514,24094,29593,29837
55178,152,259,34050,21128,5.86986e+18,121.869,2429.43,55178,96,101,54909,54794,36350,31741,30004
40686,142,220,25024,15662,5.8699e+18,124.954,1908.64,40686,89,94,40434,40256,30320,28810,35410
56221,68,328,34897,21324,5.87724e+18,152.54,3125.2,56221,141,137,53706,51195,21463,23371,24024
69716,147,259,43107,26609,5.87074e+18,153.605,2683.16,69716,112,116,69340,69070,42107,37067,34934
1665,72,87,1027,638,5.86386e+18,39.6517,311.596,1665,40,38,1578,1576,1451,1524,1495
55171,192,314,34105,21066,5.87323e+18,153.937,2884.45,55171,131,132,54763,54529,46157,44615,42959
83765,68,324,51887,31878,5.87745e+18,187.219,3737.4,83765,167,174,79261,74854,24379,32102,24605
26927,18,256,16735,10192,5.88203e+18,191.106,1996.49,26927,141,137,18194,11578,2581,5137,2746
90670,48,214,55912,34758,5.87013e+18,142.915,3027.93,90670,96,100,87603,83968,20839,30748,28177
59199,75,213,36587,22612,5.87024e+18,121.249,2533.43,59199,91,88,58767,58421,31216,29225,31543
8688,72,183,5376,3312,5.87029e+18,61.0843,895.641,8688,56,65,8501,8481,6021,5627,6163
47889,80,397,29684,18205,5.87292e+18,163.31,3038.03,47889,129,122,46404,45218,21213,22143,21429
97699,124,279,60373,37326,5.8702e+18,155.615,3440.06,97699,112,115,97109,96618,54042,49183,62626
76470,231,323,47931,28539,5.89007e+18,227.35,3763.82,76470,201,204,76087,75819,56138,60287,54555
38581,143,263,23908,14673,5.87255e+18,207.242,2128.67,38581,115,123,38028,37740,23612,21597,26996
8892,38,123,5460,3432,5.8704e+18,72.3403,804.299,8892,60,63,8411,7877,2456,3161,3466
58892,103,220,36380,22512,5.86983e+18,138.288,2526.19,58892,89,90,58570,58383,32171,29151,31560
25779,35,256,15847,9932,5.87327e+18,140.062,1710.6,25779,97,97,23253,20559,4718,7303,6504
70651,340,381,43696,26955,5.87098e+18,165.764,3297.98,70651,124,126,70270,70210,65556,68326,67322
2435,144,187,1526,909,5.87036e+18,98.5996,538.819,2435,56,52,2248,2225,1926,2091,1946
30475,257,307,19033,11442,5.88601e+18,195.521,2430.44,30475,152,154,30168,30113,26314,27635,26331
92481,53,285,56988,35493,5.87021e+18,151.628,3183.9,92481,104,112,90071,86529,24862,34385,32676
90303,43,286,56124,34179,5.88199e+18,242.259,3798.3,90303,198,198,77668,65941,14186,23606,13549
29959,80,412,18893,11066,5.89794e+18,207.708,2664.54,29959,170,173,26046,21686,5816,8439,2180
6596,214,260,4095,2501,5.87849e+18,83.2717,1021.28,6596,85,79,6336,6326,6064,6054,5976
84973,190,327,52687,32286,5.87714e+18,186.14,3806.81,84973,168,178,84413,83900,66213,64841,62088
18816,105,123,11685,7131,5.87066e+18,64.7507,1235.97,18816,70,71,18693,18693,16717,17778,16472
93622,23,271,57931,35691,5.87012e+18,232.406,3572.94,93622,134,130,69825,48216,14162,16438,8630
87951,176,286,54765,33186,5.88445e+18,215.978,3805.62,87951,202,194,87028,85616,59194,56785,61158
30821,233,248,18957,11864,5.86984e+18,125.79,1759.55,30821,86,91,30573,30560,29216,29813,29789
27986,174,258,17307,10679,5.88171e+18,199.866,1992.87,27986,141,131,27560,27132,20048,21101,21547
15074,159,211,9275,5799,5.86926e+18,90.5042,1169.01,15074,72,80,14863,14852,12754,13739,12939
53632,259,426,33327,20305,5.87753e+18,155.983,3532.67,53632,149,143,53206,53169,48131,47806,43399
36019,82,223,22137,13882,5.87068e+18,125.081,1824.9,36019,90,95,35508,35120,16011,16603,18715
91340,29,323,57164,34176,5.88708e+18,214.391,4130.74,91340,201,208,67097,48422,13007,20210,12184
3800,132,198,2413,1387,5.9072e+18,143.871,751.318,3800,92,81,3524,3301,2590,2581,3015
93705,33,309,57643,36062,5.87188e+18,226.349,3378.79,93705,127,135,83487,68990,12386,24747,15840
45596,66,188,28173,17423,5.87011e+18,114.252,2018.12,45596,84,91,44954,44548,17417,18508,22597
3259,28,129,2007,1252,5.87038e+18,59.8558,495.456,3259,49,47,2873,2510,640,1068,687
19785,35,272,12456,7329,5.89592e+18,170.848,1923.9,19785,151,144,13647,8545,3418,4253,2435
49257,10,190,30412,18845,5.86987e+18,108.868,2133.59,49257,88,92,25901,17770,4146,5027,3458
31972,140,171,19757,12215,5.86983e+18,95.6797,1766.15,31972,81,81,31801,31769,30223,30989,29646
65168,207,249,40085,25083,5.87041e+18,154.374,2505.37,65168,109,116,64911,64840,54885,60660,58472
66960,288,381,41446,25514,5.87094e+18,177.3,3058.89,66960,124,133,66579,66463,53856,59325,49321
4148,93,132,2558,1590,5.86772e+18,64.3467,566.363,4148,61,61,4016,4016,4012,4014,4010
60974,75,242,37671,23303,5.87027e+18,119.121,2464.77,60974,93,101,60257,59776,19267,24711,31231
98739,73,311,62203,36536,5.89715e+18,234.755,4258,98739,215,208,84885,69017,20832,28974,27692
57823,139,182,35714,22109,5.87017e+18,118.184,2377.24,57823,84,89,57625,57543,49909,52522,52562
23952,5,171,14762,9190,5.86969e+18,80.9519,1526.23,23952,74,78,6798,0,134,1020,892
82171,160,231,50774,31397,5.87007e+18,131.309,2963.68,82171,94,96,81931,81834,66409,72914,64885
72144,252,411,44750,27394,5.8751e+18,165.464,3812.21,72144,151,143,71733,71671,66826,66536,62576
1514,31,90,934,580,5.87033e+18,37.0013,312.709,1514,41,39,1329,1142,593,627,640
36806,15,260,22684,14122,5.8718e+18,209.231,2088.79,36806,116,118,25062,15150,4299,6353,2519
36204,1222,5393,22757,13447,5.73201e+18,504.051,9375.09,36204,305,262,30811,28441,10414,15323,7760
22787,97,235,14052,8735,5.87041e+18,93.0825,1556.35,22787,79,81,22534,22469,17292,17564,16278
13099,73,163,8103,4996,5.8698e+18,81.5139,1134.97,13099,70,74,12880,12757,7518,7472,8098
23695,86,253,14868,8827,5.88883e+18,203.453,1958.94,23695,148,143,21762,19559,9076,8805,9686
33584,128,214,20601,12983,5.87166e+18,158.414,1768.38,33584,91,95,33262,33047,22114,19971,21021
69545,254,327,43139,26406,5.87837e+18,187.439,3505.49,69545,168,175,69210,69114,60209,62525,55758
86377,117,252,53390,32987,5.87009e+18,145.084,3253.79,86377,107,107,85846,85430,57298,55784,59239
57346,112,278,35590,21756,5.88023e+18,203.073,2965.23,57346,167,169,55364,53002,25443,25812,24455
84985,73,264,52403,32582,5.87021e+18,148.457,2995.07,84985,103,110,83937,83210,25491,33723,32765
32842,141,197,20323,12519,5.86978e+18,109.598,1803.85,32842,79,82,32645,32571,30966,31571,30648
54051,169,279,33379,20672,5.87031e+18,155.366,2608.23,54051,101,110,53710,53504,38471,33589,44190
5491,14,104,3416,2075,5.86914e+18,51.1783,598.361,5491,54,57,3514,2153,661,1156,402
5133,85,211,3162,1971,5.87931e+18,93.4483,809.837,5133,72,69,4794,4579,2850,2879,2717
94296,276,342,58618,35678,5.88077e+18,199.72,4239.59,94296,178,188,93954,93848,85134,86946,81853
7919,131,239,4909,3010,5.87425e+18,97.9265,1027.85,7919,77,79,7646,7523,4969,4685,4474
95179,118,288,58737,36442,5.87013e+18,150.266,3224.32,95179,104,112,94734,94291,57084,57954,69497
47680,189,197,29472,18208,5.87003e+18,118.665,2224.91,47680,84,88,47483,47481,47448,47459,47481
29778,107,282,18703,11075,5.89233e+18,201.533,2326.05,29778,165,156,27894,25599,12997,12395,14031
72228,171,269,45122,27106,5.88456e+18,222.827,3390.58,72228,194,189,71315,70071,46990,45675,48065
75755,30,217,46726,29029,5.87033e+18,133.476,2803.16,75755,91,97,65515,52160,12870,19782,14696
38768,77,194,23951,14817,5.86974e+18,106.163,2024.36,38768,82,85,38453,38336,21072,20936,21905
41063,127,259,25319,15744,5.86986e+18,118.432,2121.08,41063,90,88,40775,40638,31660,33832,34247
83599,266,285,52088,31511,5.87934e+18,236.128,3586.26,83599,187,190,83312,83253,75702,80157,79628
82896,242,294,51225,31671,5.87042e+18,190.191,3035.61,82896,117,121,82602,82578,77489,80560,79681
10847,14,153,6707,4140,5.86831e+18,92.9234,958.119,10847,61,68,7096,4365,1224,2048,1722
96863,84,282,59708,37155,5.87257e+18,214.644,3424.47,96863,154,161,94401,92063,27537,38932,34059
92490,135,307,57024,35466,5.87311e+18,194.838,3520.98,92490,158,157,91426,90423,51542,49615,45921
26550,25,256,16644,9906,5.88851e+18,182.235,2077.2,26550,155,149,18462,12178,2716,5228,3305
54594,15,230,33772,20822,5.87031e+18,124.445,2491.83,54594,90,90,33623,19131,6149,8249,6631
64648,79,259,39945,24703,5.8702e+18,157.064,2852.03,64648,103,104,63758,63307,27011,25466,27796
84696,130,209,52317,32379,5.87002e+18,128.625,2978.65,84696,92,95,84447,84267,63758,62592,72710
23151,115,186,14253,8898,5.8699e+18,76.0883,1480.8,23151,74,78,22965,22935,21789,22212,21920
74360,229,240,45948,28412,5.87032e+18,141.827,2713.17,74360,106,113,74120,74120,73466,73738,73427
38339,128,173,23617,14722,5.86956e+18,110.719,1841.91,38339,80,87,38158,38047,31816,34526,35037
84442,64,316,52125,32317,5.87317e+18,195.085,3484.96,84442,146,148,81520,78980,24952,32057,29492
86439,100,274,53406,33033,5.87501e+18,240.495,3393.05,86439,175,173,84053,81653,35702,37206,35522
18941,336,397,11779,7162,5.87719e+18,152.672,2069.17,18941,119,114,18544,18465,16259,17199,15488
86799,220,285,54169,32630,5.88278e+18,243.764,3769.43,86799,197,196,86370,85909,72052,77772,75465
6196,14,107,3802,2394,5.86945e+18,54.5223,639.25,6196,58,59,3859,2197,661,1002,1009
64385,14,301,39617,24768,5.87095e+18,181.773,2726.68,64385,100,109,40945,23935,6982,8247,6387
68623,175,312,43298,25325,5.89946e+18,215.327,3533.17,68623,201,193,67798,66373,43013,43726,50707
20756,4,143,12784,7972,5.87024e+18,74.4907,1340.2,20756,69,72,4791,0,18,663,524
88004,240,335,55062,32942,5.88671e+18,209.917,4149.6,88004,193,206,87626,87407,67895,70677,61908
31748,43,411,19736,12012,5.88288e+18,180.497,2766.13,31748,154,148,26530,21693,5576,7908,4788
18019,60,217,11151,6868,5.87106e+18,107.01,1304.51,18019,78,80,17532,17196,6767,7612,7896
31230,152,261,19552,11678,5.88701e+18,204.514,2245.95,31230,158,156,30471,29535,19395,19004,20512
84794,21,409,52434,32360,5.87096e+18,178.734,3641.22,84794,122,118,61678,43601,11855,15080,10203
47497,39,257,29333,18164,5.8701e+18,139.824,2440.1,47497,99,97,43518,39007,10710,14105,11865
86798,197,302,53626,33172,5.87068e+18,159.041,3174.99,86798,116,128,86435,86233,65113,63261,67131
14627,99,142,9024,5603,5.87066e+18,86.6931,1124.55,14627,69,73,14467,14419,10988,10133,11463
67307,57,270,41658,25649,5.87082e+18,157.546,2650.87,67307,113,123,65365,63727,16557,24267,20687
61613,79,259,37966,23647,5.87011e+18,116.558,2555.75,61613,99,101,60964,60511,29338,33113,32603
4154,74,75,2557,1597,5.86803e+18,65.3442,484.942,4154,55,55,4079,4064,4012,4062,3982
24177,76,189,14862,9315,5.87e+18,113.926,1514.43,24177,75,81,23802,23634,11117,10927,11449
14668,101,240,9089,5579,5.875e+18,137.301,1296.51,14668,88,91,14226,13885,8269,8312,9033
4836,10,111,2976,1860,5.86856e+18,61.6005,587.486,4836,52,56,2654,1837,393,621,419
32652,127,190,20119,12533,5.87041e+18,104.184,1800.24,32652,82,87,32454,32332,24212,23359,23026
59575,213,315,36823,22752,5.87301e+18,160.106,2971.1,59575,129,131,59209,59046,51958,52436,50101
5321,58,71,3276,2045,5.8685e+18,56.7863,537.244,5321,54,56,5232,5133,4815,4855,5013
89007,41,315,54883,34124,5.87326e+18,192.765,3541.61,89007,150,153,82126,74136,15918,25132,19913
78612,182,308,48426,30186,5.8736e+18,213.365,3280,78612,151,155,78042,77502,52084,45475,44134
96842,12,285,60258,36584,5.87842e+18,234.066,3779.29,96842,197,194,56141,34161,8405,13775,3655
8519,10,226,5262,3257,5.87263e+18,80.7818,1017.68,8519,74,76,4214,2791,834,1012,1028
9523,92,178,5876,3647,5.86932e+18,83.773,1006.12,9523,69,71,9336,9293,6096,5575,4523
85658,100,277,53294,32364,5.87741e+18,230.217,3492.27,85658,188,178,82694,79561,33576,34614,32563
64635,139,397,40022,24613,5.87303e+18,184.262,3458.6,64635,143,140,63812,63073,45039,44388,43048
43569,67,186,26841,16728,5.87012e+18,123.776,1958.64,43569,85,91,42913,42523,17074,17800,16627
53139,119,266,32662,20477,5.8724e+18,190.616,2440.83,53139,126,127,52375,51578,26960,25764,29455
3634,79,175,2293,1341,5.90679e+18,136.602,708.529,3634,91,77,3038,2351,1525,1416,1774
26222,112,171,16151,10071,5.87004e+18,79.5031,1591.38,26222,77,79,26051,25973,21926,21857,21697
53734,171,226,33234,20500,5.87034e+18,130.529,2204.12,53734,96,102,53508,53433,44570,49086,50680
34363,175,179,21143,13220,5.87025e+18,105.115,1826.55,34363,79,82,34184,34182,34173,34176,34184
84841,187,295,52365,32476,5.8702e+18,167.563,3040.21,84841,110,114,84537,84345,66798,71459,74164
34362,8,223,21107,13255,5.87083e+18,122.569,1781.26,34362,89,95,15521,0,2318,3191,1927
44024,173,220,27217,16807,5.87046e+18,161.319,2028.02,44024,98,100,43761,43656,35968,40118,38094
17036,84,142,10497,6539,5.87116e+18,72.2394,1211.65,17036,69,70,16885,16870,11389,10547,11262
43071,17,197,26553,16518,5.86997e+18,112.682,2083.17,43071,85,86,29983,19040,5273,7026,5307
60492,21,285,37670,22822,5.88005e+18,236.624,3070.31,60492,174,172,44190,32294,6455,12223,5618
37979,6595,11950,23904,14075,5.58023e+18,845.358,16428,37979,773,295,26029,25818,17940,18261,7629
24648,160,216,15253,9395,5.87008e+18,118.283,1514.78,24648,81,88,24432,24367,19869,21836,19797
76604,84,267,47434,29170,5.87091e+18,173.105,2811.6,76604,122,128,75333,74181,23879,31231,36865
77665,141,278,47885,29780,5.87029e+18,169.337,2900.7,77665,109,117,77255,76954,50802,45895,49345
6388,143,240,4021,2367,5.8956e+18,158.352,1033.89,6388,113,103,6033,5669,4381,4356,4991
48973,2,215,30202,18771,5.87009e+18,131.664,2266.75,48973,86,90,4446,0,405,0,122
16705,26,145,10315,6390,5.86942e+18,82.5878,1192.16,16705,70,72,13926,10526,3222,4754,4679
54492,211,257,33617,20875,5.8703e+18,139.488,2413.77,54492,94,97,54235,54167,52590,53556,53204
79929,282,294,49362,30567,5.87038e+18,165.05,2962.66,79929,108,113,79635,79633,78737,79381,79591
51690,85,279,32248,19442,5.88177e+18,202.066,2860.93,51690,170,171,48620,45356,17475,21945,17438
19014,8,255,11721,7293,5.87086e+18,132.556,1495.91,19014,90,94,8663,0,1519,2056,902
12890,195,249,8034,4856,5.88186e+18,151.267,1380.04,12890,109,103,12615,12520,10952,11313,10725
94350,223,307,58783,35567,5.88532e+18,243.607,4068.64,94350,207,201,93907,93469,74118,79918,78510
99982,206,282,61991,37991,5.8732e+18,227.416,3504.2,99982,167,167,99498,98931,77263,86762,80552
31837,242,260,19884,11953,5.88673e+18,202.167,2264.53,31837,166,153,31577,31480,29437,30571,30746
52384,29,272,32402,19982,5.87577e+18,236.261,2716.12,52384,152,157,43160,35024,6947,12219,4918
99125,177,315,61161,37964,5.87182e+18,205.115,3632.93,99125,144,148,98593,98175,75694,81084,80034
79118,128,327,49041,30077,5.87506e+18,196.952,3556.99,79118,154,147,78139,77060,45614,40944,56230
96525,123,316,59820,36705,5.87801e+18,230.647,3941.39,96525,192,194,94152,91213,43642,44316,31986
65507,212,279,40470,25037,5.86985e+18,162.907,2890.11,65507,107,106,65215,65064,61815,62960,62636
91936,312,342,57351,34585,5.88446e+18,204.239,4290.53,91936,188,203,91594,91558,85181,88235,85681
87638,198,276,53972,33666,5.87047e+18,159.728,3018.84,87638,123,128,87307,87093,69643,77329,74691
23180,46,173,14377,8803,5.86983e+18,100.818,1488.6,23180,76,76,22043,20569,6525,8265,8003
63682,304,411,39524,24158,5.87656e+18,160.632,3685.61,63682,159,150,63271,63201,59016,59579,53707
49247,112,202,30356,18891,5.87011e+18,99.1224,2257.32,49247,86,91,49003,48845,34048,31431,31480
41430,90,279,25614,15816,5.86991e+18,153.257,2376.34,41430,103,97,40733,40344,22106,20408,22328
10488,28,279,6480,4008,5.87461e+18,136.793,1243.57,10488,86,89,8655,6986,1579,2732,1438
7607,222,224,4767,2840,5.88505e+18,148.107,1068.55,7607,98,95,7383,7383,7376,7377,7358
91542,236,271,56608,34934,5.87001e+18,208.961,3471.04,91542,123,122,91233,91101,85211,88681,87874
9616,18,149,5921,3695,5.86898e+18,81.3852,874.785,9616,61,64,7298,5005,1341,2198,2076
62224,103,259,38349,23875,5.8699e+18,135.04,2564.2,62224,95,101,61790,61391,35848,35744,41818
2471,17,76,1521,950,5.86827e+18,56.7382,380.329,2471,48,51,1607,963,440,568,730
18303,106,251,11396,6907,5.88317e+18,195.98,1667.86,18303,130,123,17343,16384,8093,8238,8339
68880,110,279,42583,26297,5.86992e+18,150.434,2948.78,68880,106,103,68269,67908,42899,40039,42264
36192,58,256,22406,13786,5.87126e+18,173.793,1986.95,36192,109,111,34818,33847,9279,13238,14384
43316,169,381,26819,16497,5.87158e+18,184.661,2647.77,43316,119,125,42803,42484,25474,25193,28189
72874,202,300,45046,27828,5.87096e+18,196.908,2959.97,72874,112,119,72540,72349,62260,65954,67860
38284,218,322,23782,14502,5.88084e+18,141.753,2656.64,38284,147,142,37955,37888,31790,31668,29284
93772,273,278,57993,35779,5.87078e+18,156.242,3167.8,93772,121,130,93494,93491,93400,93388,93269
71010,200,285,44224,26786,5.87904e+18,230.203,3279.06,71010,180,177,70509,69986,52182,55986,54587
34011,5,179,20919,13092,5.86954e+18,112.879,1676.75,34011,79,88,10122,0,383,1618,816
87159,262,279,53615,33544,5.87391e+18,214.822,3263.79,87159,160,160,86874,86814,79393,83446,85250
75506,188,397,46797,28709,5.87328e+18,198.878,3646.44,75506,152,157,74896,74389,49433,48844,49590
21717,93,297,13453,8264,5.87751e+18,170.223,1909.39,21717,123,123,20650,19605,8756,10053,7807
35403,25,172,21772,13631,5.87044e+18,100.026,1783.5,35403,77,84,29226,21839,5827,9405,8104
77186,11,272,47782,29404,5.87126e+18,196.57,2903.27,77186,136,138,45195,30084,7352,9958,3226
35997,204,327,22233,13764,5.8701e+18,160.852,2314.01,35997,102,98,35645,35550,33278,33083,33915
80452,235,301,49616,30836,5.87099e+18,165.835,3109.12,80452,114,121,80140,80040,72733,76278,72409
95270,182,275,58710,36560,5.87632e+18,244.784,3563.81,95270,177,180,94506,93664,64703,63945,67189
95945,325,342,59253,36692,5.87048e+18,173.495,3549.5,95945,121,111,95603,95596,95597,95458,95468
38956,87,180,24090,14866,5.87006e+18,119.516,1806.27,38956,82,90,38570,38207,21154,20335,26247
46428,3,220,28561,17867,5.86965e+18,160.207,2074.16,46428,95,103,8115,0,73,364,715
70237,44,295,43416,26821,5.87058e+18,167.068,2759.29,70237,103,113,67031,63041,14086,22215,19005
97563,291,303,60266,37297,5.87082e+18,156.455,3371,97563,118,129,97260,97251,92302,95786,95338
10922,24,147,6724,4198,5.86976e+18,64.2895,936.312,10922,64,67,8638,6150,1874,3039,1264
94924,1448,4914,59773,35151,5.84956e+18,310.046,10336.9,94924,319,248,90010,88877,34110,51774,7022
35018,184,275,21575,13443,5.87653e+18,211.602,2182.13,35018,124,127,34626,34394,26567,28499,26218
29714,32,177,18378,11336,5.8695e+18,116.118,1583.19,29714,79,88,26680,22527,5709,9044,7058
11130,39,331,6850,4280,5.87017e+18,103.649,1307.65,11130,77,80,10126,9301,2018,3054,1391
11958,35,240,7383,4575,5.8739e+18,90.4148,1199.78,11958,81,83,10514,8937,3038,4244,3389
78075,177,342,48137,29938,5.87057e+18,146.174,3194.27,78075,118,114,77657,77434,57872,53744,63085
59303,57,273,36900,22403,5.87748e+18,231.128,2896.26,59303,167,161,54870,51607,11686,19328,13218
54163,145,301,33395,20768,5.87121e+18,157.565,2600.28,54163,107,105,53740,53550,40857,43370,43871
75615,23,217,46642,28973,5.87025e+18,133.641,2801.11,75615,91,97,59682,43603,10697,16124,11391
50716,271,275,31231,19485,5.87591e+18,201.187,2555.55,50716,138,136,50441,50431,49663,50116,50394
97747,387,411,60487,37260,5.87225e+18,181.147,4152.16,97747,141,129,97336,97318,97295,97295,96644
64608,123,217,39804,24804,5.87047e+18,128.89,2593.23,64608,89,94,64330,64118,39056,34612,34907
74546,124,272,46152,28394,5.87154e+18,195.353,2861.36,74546,137,138,73660,72719,36863,35432,38002
18527,245,257,11492,7035,5.86996e+18,108.152,1546.64,18527,81,83,18270,18270,18263,18269,17536
42530,214,245,26126,16404,5.87087e+18,165.643,2044.97,42530,102,107,42280,42213,36872,39886,38588
51920,123,342,32054,19866,5.87035e+18,147.209,2718.26,51920,113,103,51354,50960,34351,32769,34793
61883,24,257,38252,23631,5.87005e+18,131.36,2781.19,61883,102,102,48090,33616,10942,14036,10903
82189,36,257,50804,31385,5.87023e+18,184.358,3182.84,82189,106,106,73598,64165,15530,23110,18665
18709,87,136,11495,7214,5.87019e+18,71.2908,1252.36,18709,71,72,18569,18553,13042,12773,13294
33617,67,287,20756,12861,5.87155e+18,117.976,2048.17,33617,100,100,32688,31776,15305,19221,17045
25675,272,297,15979,9696,5.88227e+18,119.453,2115.6,25675,124,122,25378,25363,24910,25155,24924
15010,192,239,9380,5630,5.88221e+18,157.753,1480.17,15010,120,112,14750,14600,12660,13694,13552
63012,139,259,38767,24245,5.8706e+18,118.538,2625.12,63012,97,102,62728,62559,39567,34965,37451
99293,21,338,62030,37263,5.88546e+18,214.971,4378.95,99293,201,209,66598,44451,9992,16861,7467
83295,102,220,51437,31858,5.87005e+18,133.608,3008.61,83295,92,96,82932,82727,50099,48589,55898
11557,218,266,7144,4413,5.87145e+18,159.478,1305.05,11557,89,91,11276,11193,10604,10849,10999
92406,149,279,56884,35522,5.87111e+18,184.651,3167.93,92406,137,135,91800,91327,52580,46704,50667
75515,45,242,46665,28850,5.87051e+18,140.008,2754.68,75515,102,112,72361,68952,14998,23381,18792
45021,71,397,27894,17127,5.87301e+18,158.734,2951.62,45021,123,119,43446,41979,20107,21518,20566
8263,174,218,5159,3104,5.88053e+18,134.172,1033.8,8263,86,85,8032,7936,6774,7404,6817
93664,100,342,57843,35821,5.87028e+18,176.324,3504.73,93664,121,111,92809,92186,47016,43386,46387
56539,12,304,34938,21601,5.87382e+18,184.266,2869.7,56539,137,141,32664,20049,5163,8224,4481
84352,163,295,51977,32375,5.8704e+18,161.144,3032.28,84352,109,115,84023,83805,58630,60549,59369
96167,43,279,59511,36656,5.87138e+18,182.401,3241.75,96167,134,142,90973,84991,16261,26679,17436
68889,223,316,42557,26332,5.87301e+18,162.165,3136.55,68889,135,139,68527,68386,57683,61393,55180
71148,153,235,43822,27326,5.87024e+18,144.203,2626.1,71148,104,109,70843,70638,49212,49580,55940
4514,118,170,2772,1742,5.87249e+18,65.9459,636.607,4514,57,57,4344,4286,3597,3758,3699
93416,146,232,57641,35775,5.87008e+18,148.742,3175.63,93416,95,100,93149,92933,68034,68140,67393
12738,44,213,7865,4873,5.87214e+18,95.2379,1099.16,12738,73,75,12073,11494,2832,4567,4808
35836,189,194,22115,13721,5.86995e+18,102.405,1891.01,35836,83,87,35642,35642,35626,35629,35640
16761,112,245,10596,6165,5.902e+18,189.301,1693.72,16761,147,135,15558,14028,8873,8165,9778
41125,203,272,25399,15726,5.87424e+18,204.88,2346.99,41125,136,135,40777,40544,34163,36940,37038
53482,147,264,33106,20376,5.87113e+18,169.13,2381.49,53482,113,120,53029,52737,35338,33176,41684
66205,172,224,40948,25257,5.86969e+18,155.915,2713.36,66205,90,93,65978,65890,57394,61703,62136
20419,122,152,12599,7820,5.87005e+18,80.0744,1341.87,20419,72,75,20267,20236,18148,19272,18996
56183,3163,6260,35351,20832,5.75531e+18,534.873,11554.9,56183,352,286,49923,49842,34356,35551,16842
59825,154,300,36886,22939,5.87132e+18,137.385,2695.96,59825,106,108,59425,59278,48131,47263,50009
37676,190,250,23285,14391,5.86948e+18,126.993,2173.87,37676,95,97,37411,37307,31312,30935,35770
32060,239,263,19962,12098,5.8838e+18,211.523,2220.88,32060,152,148,31796,31745,30179,31026,31221
91905,145,282,56659,35246,5.87273e+18,203.19,3349.95,91905,154,160,90971,90246,51774,48886,52965
31522,139,261,19764,11758,5.89065e+18,217.041,2312.32,31522,164,157,30494,29296,18231,16366,19716
21616,3,214,13254,8362,5.87105e+18,90.0449,1400.36,21616,81,83,3718,0,99,291,549
40393,44,182,24870,15523,5.8702e+18,109.985,1993.46,40393,81,85,38580,35919,11510,14821,13319
51639,30,316,31868,19771,5.87323e+18,148.839,2751.92,51639,122,115,43805,35112,8238,13800,9284
13731,57,167,8418,5313,5.87023e+18,87.9113,1047.74,13731,71,72,13368,13140,5126,5438,5930
29057,80,165,17871,11186,5.87043e+18,108.189,1544.51,29057,76,84,28723,28515,15900,15670,18193
68572,115,300,42220,26352,5.87127e+18,194.634,2875.08,68572,115,115,67964,67409,36796,32331,35045
73919,27,363,45706,28213,5.87107e+18,178.283,3036.25,73919,115,128,62875,49806,8629,18036,7329
78663,236,269,48327,30336,5.87084e+18,143.654,2899.39,78663,116,117,78394,78394,69169,73983,72329
13314,220,409,8284,5030,5.87384e+18,115.88,1720.97,13314,101,97,12905,12901,12173,12067,11519
5388,50,81,3317,2071,5.86813e+18,67.346,572.024,5388,60,66,5121,4733,3559,3379,4291
21869,38,203,13516,8353,5.87038e+18,101.589,1597.99,21869,82,82,19636,17410,6173,7144,7374
95322,45,352,58725,36597,5.87029e+18,176.696,3516.69,95322,120,120,90243,84390,19028,26684,20627
27625,64,163,16996,10629,5.86891e+18,101.36,1502.36,27625,76,82,27207,26980,13807,14804,16278
19403,14,285,11999,7404,5.87496e+18,116.916,1725.2,19403,95,97,11939,6707,2222,2811,1741
98692,157,281,61074,37618,5.87124e+18,181.402,3305.13,98692,134,143,98125,97673,59906,52755,59638
87403,120,327,54189,33214,5.8765e+18,184.876,3823.85,87403,164,172,85804,83833,49177,48278,50689
32187,159,250,20301,11886,5.89693e+18,193.223,2324.37,32187,172,162,31494,30530,22006,22321,24706
66726,332,335,41801,24925,5.88869e+18,200.074,3614.27,66726,186,192,66391,66389,66131,66292,66264
39312,145,197,24333,14979,5.87005e+18,108.207,2044.62,39312,81,85,39115,39056,33179,35984,32626
38273,220,282,23834,14439,5.88382e+18,197.197,2545.41,38273,156,162,37948,37753,31897,32860,29916
47456,88,260,29369,18087,5.87146e+18,170.928,2239.49,47456,115,113,46580,45741,17494,20173,21960
90576,261,303,55904,34672,5.87102e+18,167.394,3281.04,90576,118,127,90273,90191,81837,86813,84346
51598,229,260,31717,19881,5.87243e+18,179.021,2372.98,51598,121,118,51322,51217,45219,48448,47968
46679,196,261,29238,17441,5.8874e+18,223.933,2752.32,46679,182,171,46235,45718,36980,39591,38461
83458,124,274,51653,31805,5.8714e+18,181.698,2971.23,83458,132,132,82697,81830,41909,40360,39831
45141,93,397,27973,17168,5.87299e+18,159.146,2957.76,45141,123,119,44015,43024,25159,23506,23769
73622,268,285,45872,27750,5.88065e+18,241.306,3384.37,73622,181,183,73337,73247,71486,72525,72761
91231,110,289,56213,35018,5.87036e+18,149.817,3166.61,91231,103,110,90732,90221,51919,51562,58361
65481,101,274,40512,24969,5.87683e+18,236.22,3024.35,65481,176,165,63278,61047,27006,27784,25030
94797,255,411,58661,36136,5.87887e+18,235.469,4358.46,94797,187,194,94353,94161,66790,63840,47995
11567,9,133,7130,4437,5.87042e+18,86.9811,971.698,11567,66,70,5543,0,900,1013,971
7302,13,74,4552,2750,5.8703e+18,66.9159,641.049,7302,60,63,4238,2500,856,1012,1332
95785,211,425,59205,36580,5.87086e+18,174.946,3873.03,95785,122,117,95342,95285,93385,93687,93321
45988,122,270,28472,17516,5.87708e+18,194.569,2522.42,45988,154,151,44793,43355,22355,22194,25647
94650,252,273,58745,35905,5.87531e+18,239.209,3545.29,94650,174,176,94351,94216,84401,90105,90599
28733,99,221,17663,11070,5.8705e+18,123.884,1638.59,28733,84,93,28392,28111,15049,14190,16606
81001,80,262,49909,31092,5.87044e+18,136.103,2947,81001,100,106,80239,79728,28468,32719,36581
5636,79,115,3462,2174,5.87213e+18,58.8201,637.703,5636,54,56,5518,5483,4475,4439,4458
66820,161,302,41200,25620,5.87068e+18,158.554,2866.91,66820,110,117,66375,66122,49073,49090,52955
36305,24,256,22475,13830,5.87109e+18,191.369,2007.89,36305,115,113,30081,23651,4540,8381,5367
75438,73,275,46698,28740,5.87083e+18,157.501,2814.88,75438,120,124,74013,73050,18812,29304,26184
70702,169,279,43668,27034,5.87016e+18,160.725,2959.87,70702,107,113,70336,70095,50832,45277,55357
58877,214,273,36510,22367,5.87461e+18,209.576,2736.73,58877,148,148,58514,58227,47740,52857,49516
84880,36,224,52451,32429,5.87022e+18,135.731,3032.01,84880,92,93,76903,67951,16351,25766,18561
49748,53,272,30705,19043,5.87406e+18,218.671,2584.56,49748,138,148,46674,44431,11208,16944,12451
66691,164,316,41062,25629,5.87218e+18,191.887,2989.81,66691,119,121,66272,66105,50361,54707,48704
39123,38,176,24153,14970,5.86998e+18,98.2279,1916.42,39123,79,87,36314,33141,8303,11852,10958
47039,231,260,28980,18059,5.87142e+18,199.901,2306.06,47039,121,126,46763,46644,41078,44212,44252
43746,173,190,26953,16793,5.86989e+18,112.846,1993.02,43746,85,90,43556,43556,42265,42997,43010
23509,74,426,14750,8759,5.88946e+18,169.344,2535.53,23509,148,148,20691,17574,6947,8018,5908
30802,186,4703,19376,11426,5.7566e+18,391.512,7911.65,30802,273,220,23403,20540,3434,8078,928
86317,261,285,53848,32469,5.8814e+18,240.914,3688.17,86317,201,191,86027,85924,80909,83755,84288
6991,39,76,4298,2693,5.8698e+18,69.4994,631.766,6991,62,61,6449,5776,3112,2967,3706
89829,228,285,55882,33947,5.87879e+18,236.56,3687.36,89829,185,187,89433,89093,74368,79638,75170
45114,104,269,27872,17242,5.8755e+18,184.218,2430.29,45114,142,138,43819,42487,19974,20496,20020
87763,243,278,54282,33481,5.87075e+18,151.772,3081.62,87763,120,127,87485,87452,75394,82253,81051
36999,165,217,22763,14236,5.86997e+18,167.396,1871.49,36999,94,99,36730,36581,29644,32816,29975
65046,264,342,40232,24814,5.87059e+18,160.42,2994.44,65046,115,106,64704,64609,62372,63472,62659
3166,114,126,1942,1224,5.86781e+18,54.4567,476.504,3166,48,49,3040,3034,2991,3003,2958
35955,46,221,22252,13703,5.87045e+18,123.63,1800.72,35955,85,94,34563,33275,8318,11742,10857
58207,155,291,35837,22370,5.87053e+18,167.057,2582.4,58207,115,118,57779,57500,32162,30325,32455
5063,42,204,3149,1914,5.88084e+18,106.617,779.753,5063,70,72,4363,3760,1075,1653,1708
3027,40,74,1887,1140,5.86498e+18,58.3449,416.462,3027,52,54,2769,2478,1575,1554,2040
12736,35,237,7869,4867,5.87468e+18,164.163,1274.67,12736,96,96,10903,9300,2227,3489,2162
66925,304,426,41795,25130,5.88461e+18,197.861,4090.71,66925,181,188,66499,66424,57638,57514,47346
70489,27,227,43408,27081,5.87021e+18,132.022,2646.94,70489,96,102,59836,46174,10688,14572,13051
81343,239,277,50651,30692,5.8837e+18,219.347,3608.84,81343,199,192,81034,80848,71855,77142,77103
33102,38,158,20371,12731,5.86992e+18,86.531,1756.36,33102,79,82,30692,27895,8003,11386,9561
97261,9,271,60159,37102,5.87008e+18,226.532,3631.77,97261,135,128,43074,0,6594,7854,4248
11078,144,237,6856,4222,5.87607e+18,177.05,1219.38,11078,95,93,10743,10587,7592,7543,6879
83317,95,314,51361,31956,5.87087e+18,221.581,3206.28,83317,124,129,82323,81391,32734,36025,36147
58038,24,269,36234,21804,5.88415e+18,219.051,3001.59,58038,182,181,42801,30666,6314,12337,5998
58871,262,327,36445,22426,5.87032e+18,161.014,2854.76,58871,105,104,58544,58476,58022,58242,57855
42634,77,219,26370,16264,5.87074e+18,163.558,1985.94,42634,96,101,41883,41353,15190,18020,23033
38546,255,275,23759,14787,5.87646e+18,169.769,2275.78,38546,129,132,38271,38252,34598,36801,35792
31416,233,258,19564,11852,5.88423e+18,191.272,2192.47,31416,154,146,31152,31068,28877,30186,30126
95624,121,289,58947,36677,5.87016e+18,142.145,3231.81,95624,108,111,95201,94746,49434,47636,45519
6254,88,140,3827,2427,5.86645e+18,73.5417,689.519,6254,60,66,6103,6029,4514,4346,4192
21859,132,162,13437,8422,5.8699e+18,102.352,1347.87,21859,75,77,21697,21632,19017,20427,18378
26767,45,249,16502,10265,5.87032e+18,118.836,1706.02,26767,86,90,25445,24131,6497,7731,8946
65353,109,300,40342,25011,5.87079e+18,153.195,2809.25,65353,107,109,64730,64155,38647,36664,45526
33314,23,285,20739,12575,5.88094e+18,183.103,2343.69,33314,141,136,24707,17447,4020,7142,4370
71890,189,273,44240,27650,5.87085e+18,159.245,2735.78,71890,114,128,71551,71349,53502,60240,57834
87587,213,294,54057,33530,5.87007e+18,162.808,3080.71,87587,109,115,87293,87176,75098,81112,78179
87283,10,397,54056,33227,5.87267e+18,190.712,3891.58,87283,150,158,43875,29589,7143,10161,4883
12489,231,238,7761,4728,5.88103e+18,141.971,1333.54,12489,106,104,12251,12251,12247,12245,12243
88875,140,426,55060,33815,5.87389e+18,184.238,4191.23,88875,148,140,88046,87041,60423,59853,59475
20636,63,376,12788,7848,5.87175e+18,143.203,1996.68,20636,105,101,19497,18501,7147,7685,7194
12202,48,250,7546,4656,5.88276e+18,139.053,1344.77,12202,105,100,10703,9340,3401,4214,4282
37410,19,177,23086,14324,5.86968e+18,101.17,1879.9,37410,80,85,27581,18456,4842,5308,4351
72769,5,271,45417,27352,5.88672e+18,224.202,3454.99,72769,200,192,19224,0,563,3476,808
84601,197,285,52784,31817,5.88263e+18,242.351,3694.43,84601,195,198,83994,83235,61832,67000,64113
88544,114,342,54657,33887,5.87022e+18,158.086,3387.65,88544,119,116,87830,87220,48477,44833,48883
91214,85,211,56327,34887,5.86999e+18,130.434,3090.37,91214,94,99,90681,90379,44580,43045,50846
84110,88,228,51843,32267,5.87018e+18,143.519,2938.93,84110,96,102,83506,83020,38827,38548,41669
10503,8,237,6461,4042,5.87771e+18,141.182,1133.74,10503,87,87,4824,0,718,1254,374
9092,19,134,5630,3462,5.86881e+18,68.7549,847.499,9092,61,65,6806,4654,1472,2237,1500
78239,181,301,48129,30110,5.87077e+18,199.326,3016.1,78239,112,119,77862,77654,63670,70691,66017
50973,117,264,31540,19433,5.87272e+18,200.011,2401.97,50973,122,128,50159,49334,24506,23724,23747
52614,165,266,32397,20217,5.87093e+18,186.78,2377.92,52614,114,121,52191,51898,37971,37025,40042
97450,162,244,60237,37213,5.87011e+18,158.195,3269.23,97450,98,101,97185,97013,74534,80673,75199
46341,75,270,28828,17513,5.88273e+18,217.812,2695.93,46341,169,173,42764,39311,11738,17872,13710
73107,185,269,44996,28111,5.87091e+18,164.236,2739.96,73107,116,126,72762,72531,54440,58007,57663
73455,35,262,45300,28155,5.87013e+18,111.166,2833.36,73455,99,103,66673,57280,16061,21023,17947
10598,48,258,6638,3960,5.88474e+18,103.857,1321.08,10598,105,92,9117,7679,4158,4180,3991
55483,60,266,34075,21408,5.87211e+18,185.104,2429.88,55483,118,121,53718,52404,12522,19775,18988
29409,23,165,18201,11208,5.87035e+18,110.565,1548.97,29409,77,83,24060,18295,4846,6967,6157
1189,45,98,730,459,5.86533e+18,38.6627,287.531,1189,37,35,1084,1054,552,620,546
9875,81,396,6136,3739,5.87821e+18,135.1,1543.09,9875,99,94,9114,8548,4533,4775,3901
23570,18,217,14592,8978,5.87025e+18,118.589,1464.44,23570,81,85,17860,12324,3124,5293,3308
45049,28,180,27797,17252,5.87033e+18,99.2182,2132.65,45049,84,83,37630,27976,7734,9572,9184
61344,81,306,38000,23344,5.87363e+18,184.334,2978.68,61344,139,143,59470,57822,26565,32807,27093
89251,253,263,54978,34273,5.87021e+18,132.73,3076.62,89251,99,109,88988,88980,88226,88326,88761
9271,74,123,5757,3514,5.86963e+18,59.3172,842.961,9271,63,66,9148,9140,6117,5780,4665
6827,19,109,4220,2607,5.86861e+18,69.2456,680.377,6827,61,67,4657,2887,1239,1515,345
92822,58,381,57403,35419,5.87075e+18,174.327,3604.12,92822,131,135,89942,87276,20340,30231,20518
65703,125,303,40593,25110,5.87095e+18,161.877,2840.37,65703,113,119,65105,64580,41037,42086,42119
78119,286,294,48319,29800,5.87088e+18,150.822,2985.44,78119,117,125,77825,77824,76788,77200,77819
87684,93,291,55103,32581,5.89411e+18,232.672,3988.04,87684,209,202,80245,70770,28534,30177,33972
56564,115,235,34965,21599,5.87016e+18,114.56,2340.44,56564,94,102,56247,55934,32916,28915,33387
80189,58,294,49586,30603,5.871e+18,153.964,3033.32,80189,117,125,78022,76026,22393,29927,26819
4171,93,98,2585,1586,5.86845e+18,46.5164,531.092,4171,50,51,4073,4073,3998,4046,4059
22387,112,158,13881,8506,5.86978e+18,72.1548,1446.7,22387,74,79,22229,22224,17749,17289,14591
1866,91,128,1157,709,5.86583e+18,53.4298,407.655,1866,45,49,1738,1722,1663,1637,1594
55141,263,314,34062,21079,5.87239e+18,157.297,2837.83,55141,119,115,54827,54751,52374,53303,51712
59581,131,184,36672,22909,5.87021e+18,117.433,2410.24,59581,85,89,59370,59258,48499,49800,51863
31084,137,162,19224,11860,5.8701e+18,111.836,1610.22,31084,79,82,30922,30859,26663,29187,27782
48997,92,199,30292,18705,5.8697e+18,105.871,2290.5,48997,85,89,48729,48637,32948,31040,32067
20155,23,218,12408,7747,5.86991e+18,105.454,1373.03,20155,79,83,16527,12807,2887,4628,2687
79308,28,220,48966,30342,5.87012e+18,134.366,2931.49,79308,92,93,65985,48880,13845,20081,14483
35752,118,220,22128,13624,5.87024e+18,121.348,1797.97,35752,88,93,35463,35240,23173,21677,28371
55588,127,287,34925,20663,5.89391e+18,220.04,3151.96,55588,196,184,53270,49840,25604,24410,29733
8115,155,199,5001,3114,5.8708e+18,86.281,869.549,8115,65,67,7916,7901,7015,7526,7131
77039,86,342,47557,29482,5.8703e+18,138.796,3186.57,77039,116,111,76065,75374,37161,39559,40481
99591,80,276,61460,38131,5.87378e+18,226.955,3570.16,99591,174,172,96202,93069,24068,37870,30375
68091,166,257,42088,26003,5.87026e+18,158.284,2884.11,68091,104,102,67739,67435,49346,44230,54818
88909,144,273,54725,34184,5.87082e+18,171.778,3029.91,88909,125,134,88357,87915,52192,48653,59487
78397,156,214,48365,30032,5.87018e+18,143.606,2837.21,78397,94,96,78173,78011,66555,70786,74203
40238,170,174,24738,15500,5.87003e+18,114.94,1883.5,40238,82,91,40064,40064,40057,40063,40054
26056,223,260,16253,9803,5.88485e+18,183.703,2050.35,26056,144,140,25773,25702,22001,22986,22024
39019,7,173,24099,14920,5.87031e+18,104.464,1871.88,39019,81,87,15438,0,1994,2623,2457
98472,47,285,60693,37779,5.8701e+18,155.581,3272.49,98472,107,111,94731,90874,18777,29732,24320
89590,60,303,55224,34366,5.871e+18,177.266,3249.34,89590,122,127,87371,85425,23785,31926,28881
30121,118,256,18656,11465,5.87122e+18,146.133,1821.53,30121,103,104,29654,29259,19598,20649,23181
14057,71,249,8714,5343,5.87303e+18,134.839,1315.78,14057,87,90,13414,12960,4652,6283,5730
53495,31,226,33085,20410,5.87054e+18,157.424,2230.7,53495,99,105,47631,40574,8269,14573,10671
20530,204,250,12877,7653,5.89054e+18,176.834,1820.72,20530,141,138,20260,20131,17017,18032,17688
79269,237,296,48805,30464,5.87071e+18,148.944,3005.29,79269,118,122,78973,78920,67262,74086,64162
54972,144,195,33971,21001,5.87015e+18,98.5165,2405.05,54972,85,87,54777,54705,46915,49805,47497
18197,68,162,11188,7009,5.86889e+18,103.729,1246.96,18197,73,74,17867,17677,8534,9293,9936
97274,208,279,59874,37400,5.87116e+18,184.035,3254.44,97274,142,140,96921,96599,78558,87766,80926
70957,182,274,43855,27102,5.87528e+18,226.686,3083.79,70957,169,166,70327,69612,49070,50393,53607
9765,54,127,6010,3755,5.86993e+18,65.9857,848.101,9765,61,61,9565,9335,4795,5111,5186
40311,82,260,24857,15454,5.87319e+18,207.173,2214.53,40311,125,121,39041,37965,12808,16187,12937
79101,317,323,49548,29553,5.88943e+18,222.355,3870.47,79101,201,206,78778,78778,78694,78755,78751
43866,184,261,27445,16421,5.88633e+18,225.38,2651.71,43866,174,171,43323,42670,31060,32992,33294
78461,168,259,48513,29948,5.86998e+18,161.559,3081.57,78461,105,104,78106,77813,70721,71135,74620
27185,136,283,16838,10347,5.87222e+18,205.846,1842.54,27185,99,107,26719,26473,15316,13502,15047
8830,195,224,5537,3293,5.88763e+18,154.029,1140.97,8830,102,97,8605,8558,7442,7999,7611
49747,26,267,30855,18892,5.8736e+18,206.375,2453.32,49747,134,134,41490,33246,5880,12085,4595
29713,39,282,18665,11048,5.89265e+18,210.057,2335.28,29713,168,161,22270,15889,4427,6187,5083
89402,88,262,55123,34279,5.86998e+18,145.762,3051.57,89402,105,111,88640,87957,39704,41584,51046
84111,207,314,51896,32215,5.87213e+18,178.177,3401.59,84111,141,137,83723,83470,74205,74001,72903
60952,247,271,38263,22689,5.89211e+18,210.457,3243.74,60952,191,186,60671,60575,56444,58713,58623
83853,70,316,51728,32125,5.87272e+18,175.324,3402.12,83853,139,140,81559,79398,27694,33441,30548
96636,292,307,60263,36373,5.88593e+18,244.586,4132.71,96636,206,208,96329,96250,94139,95128,93271
47363,138,200,29282,18081,5.87032e+18,106.968,2245.55,47363,84,84,47159,47079,41813,43052,42327
88015,175,328,54524,33491,5.87419e+18,205.123,3619.85,88015,148,145,87515,87115,67927,73583,70613
53789,88,217,33181,20608,5.87036e+18,108.736,2396.03,53789,86,91,53420,53188,33094,32024,34356
11644,205,264,7235,4409,5.88198e+18,141.731,1342.22,11644,107,102,11380,11353,9506,10245,8494
84414,133,217,52143,32271,5.87018e+18,127.782,2962.39,84414,92,94,84147,83964,63339,57759,68838
92144,112,270,56964,35180,5.87033e+18,185.576,3375.01,92144,111,109,91441,90948,48294,42652,52952
65302,196,235,40215,25087,5.86985e+18,133.249,2484.86,65302,99,105,65067,65010,56143,61444,63113
77952,119,300,47958,29994,5.87101e+18,198.374,3010.37,77952,114,121,77358,76834,43186,36403,41622
79025,156,220,48743,30282,5.87024e+18,118.319,2889.36,79025,90,97,78798,78695,63302,67604,64299
22728,118,300,14294,8434,5.89667e+18,185.336,2173.96,22728,154,152,21447,19810,10626,10657,6961
96170,62,279,59533,36637,5.87113e+18,181.975,3210.5,96170,139,139,93516,91550,20770,32664,27861
48834,140,183,30159,18675,5.87003e+18,115.006,2185.18,48834,82,87,48638,48558,42739,45244,45293
37832,60,220,23422,14410,5.87048e+18,121.511,1851.17,37832,89,95,37055,36475,10761,15088,15637
85895,169,213,52983,32912,5.87033e+18,130.844,2998.78,85895,90,95,85682,85624,78938,82281,83647
23212,210,215,14291,8921,5.87084e+18,159.818,1493.79,23212,86,90,22997,22960,22891,22957,22997
88587,124,282,54476,34111,5.8708e+18,151.885,3098.53,88587,117,130,87956,87336,48016,45185,56726
24248,14,204,14993,9255,5.87068e+18,77.4501,1543.68,24248,74,78,14840,8717,2814,2834,3110
10851,54,217,6674,4177,5.87095e+18,100.223,1027.99,10851,76,76,10322,10004,3068,4348,4548
78284,87,273,48598,29686,5.87616e+18,229.608,3250.7,78284,173,171,75291,72234,23238,29874,26772
18809,166,253,11715,7094,5.88305e+18,194.881,1694.62,18809,125,128,18397,18057,13540,13872,14231
75299,175,211,46485,28814,5.87009e+18,133.421,2832.28,75299,90,92,75088,75073,70496,72984,73154
10477,114,232,6510,3967,5.87282e+18,126.87,1125.88,10477,87,83,10122,9835,6724,6975,7547
75880,30,293,46732,29148,5.87056e+18,152.551,2947.3,75880,119,127,66112,54910,12030,19201,14315
57565,64,196,35505,22060,5.87036e+18,128.009,2420.77,57565,87,87,56829,56048,22799,24640,25788
47660,313,328,29541,18119,5.87531e+18,141.322,2802.11,47660,122,115,47332,47328,47296,47316,46968
78893,138,282,48942,29951,5.87347e+18,212.251,3142.36,78893,146,157,77890,76962,44543,41584,46468
29979,103,189,18478,11501,5.86969e+18,96.5129,1690.89,29979,82,84,29748,29617,22526,21273,20875
4751,14,79,2945,1806,5.86851e+18,64.2749,532.067,4751,60,63,2749,1554,611,768,990
75673,178,352,46622,29051,5.87039e+18,172.331,3148.52,75673,113,116,75249,75014,48117,42713,57047
66545,233,273,41234,25311,5.87396e+18,207.8,2895.9,66545,153,151,66232,66075,57720,62103,61364
13314,12,137,8230,5084,5.87059e+18,71.1462,1043.25,13314,70,72,7370,4478,1439,1719,1886
56881,161,279,35133,21748,5.87025e+18,133.582,2684.22,56881,104,110,56512,56235,41308,37519,44728
54856,187,260,33810,21046,5.87032e+18,128.934,2434.2,54856,94,96,54596,54504,47549,50842,50379
25231,100,272,15701,9530,5.87666e+18,162.926,1912.17,25231,116,119,24380,23655,14545,15291,14596
49740,199,212,30593,19147,5.8702e+18,124.338,2221.89,49740,89,93,49528,49526,49100,49310,49518
90715,73,232,55988,34727,5.87001e+18,136.539,3103.29,90715,93,98,89959,89382,36891,39311,40189
59669,134,271,36710,22959,5.87385e+18,198.68,2679.89,59669,143,138,58842,58083,32299,27815,30432
26720,356,5069,16794,9926,5.70408e+18,529.464,8369.71,26720,281,245,19123,16056,3305,6361,2076
75056,44,213,46323,28733,5.87036e+18,124.006,2825.17,75056,88,89,71298,65716,17529,24371,22608
62545,198,269,38520,24025,5.87133e+18,200.679,2639.35,62545,126,136,62176,61855,50190,55673,49463
9185,99,187,5645,3540,5.87218e+18,70.9309,939.631,9185,66,65,8998,8944,8242,8335,8351
91933,31,230,56652,35281,5.8702e+18,141.933,3068.33,91933,97,105,80655,65194,15320,23630,17281
39014,163,174,23995,15019,5.87008e+18,107.107,1883.37,39014,79,90,38840,38831,38355,38589,38258
22120,71,245,13868,8252,5.89148e+18,186.803,1889.19,22120,155,143,19403,16616,5830,7503,7589
32574,214,297,20202,12372,5.87477e+18,129.222,2215.92,32574,124,118,32269,32136,28371,29587,27157
26342,222,257,16188,10154,5.87247e+18,187.701,1725.83,26342,100,101,26080,26014,24777,25254,25711
13222,56,137,8142,5080,5.87018e+18,74.5265,1051.23,13222,64,65,12990,12724,6030,6124,6803
77479,8467,10561,48786,28693,5.76675e+18,459.744,16649.9,77479,761,288,66918,66912,58062,59664,20385
87889,71,272,54268,33621,5.87466e+18,241.86,3423.82,87889,168,180,83904,80466,19763,31914,24660
58847,94,223,36391,22456,5.86998e+18,119.305,2563.26,58847,90,92,58478,58340,38653,36391,38061
45055,115,202,27754,17301,5.87022e+18,101.346,2164.39,45055,85,91,44817,44676,30062,27775,27361
40898,92,297,25264,15634,5.87096e+18,116.86,2270.52,40898,91,95,40384,40015,24352,23226,26892
89951,154,281,55279,34672,5.8713e+18,154.108,3092.7,89951,120,129,89509,89191,59553,52325,66723
15219,65,146,9361,5858,5.87052e+18,86.6194,1162.03,15219,68,69,14988,14899,7013,7025,7053
88054,84,259,54435,33619,5.8701e+18,154.665,3287.83,88054,108,107,87141,86664,40838,37879,43724
80255,168,285,49455,30800,5.8702e+18,137.276,2984.53,80255,104,111,79961,79815,58314,54809,58245
22235,153,183,13728,8507,5.87035e+18,85.8817,1549.74,22235,79,80,22052,22028,21649,21811,21580
33854,9,193,20878,12976,5.8695e+18,95.8159,1824.63,33854,82,81,15966,0,2818,2606,2400
85081,269,273,52811,32270,5.87598e+18,224.007,3381.88,85081,180,172,84808,84779,83028,84208,84808
50063,112,273,31050,19013,5.87389e+18,165.224,2535.65,50063,132,135,49093,48114,27261,27138,27669
57444,190,223,35518,21926,5.86964e+18,120.88,2536.47,57444,90,92,57221,57191,56001,56655,56130
55846,12,297,34415,21431,5.87097e+18,155.171,2630.27,55846,113,117,33009,20474,5962,7145,3504
71042,64,411,44088,26954,5.87813e+18,183.754,3926.38,71042,169,168,66439,61710,24068,28209,24320
61026,88,212,37568,23458,5.86997e+18,127.324,2445.34,61026,94,99,60546,60158,33005,30707,39737
94908,267,301,58505,36403,5.87094e+18,201.195,3357.89,94908,125,131,94607,94493,88126,91920,90834
84825,102,216,52284,32541,5.87024e+18,130.096,2911.29,84825,94,103,84389,84009,48479,44754,59557
35255,238,291,21726,13529,5.87139e+18,167.038,2128.69,35255,105,110,34964,34915,29690,32731,28311
35295,64,274,21790,13505,5.87402e+18,175.101,2147.41,35295,121,119,33648,32249,9772,13874,15001
29659,143,156,18314,11345,5.86975e+18,89.646,1628.39,29659,76,80,29503,29501,28530,28945,28787
32237,35,256,19964,12273,5.8712e+18,173.915,1895.69,32237,107,105,29134,25908,5918,8683,7856
24712,79,174,15276,9436,5.86988e+18,82.1006,1585.99,24712,78,80,24482,24392,14242,14133,15590
33074,51,342,20345,12729,5.87078e+18,132.945,2071.52,33074,95,103,31734,30630,7080,10453,7269
98590,46,426,61337,37253,5.87928e+18,178.41,4705.49,98590,177,182,87156,75266,21874,28728,24321
97437,224,286,60440,36997,5.87946e+18,241.698,3841.29,97437,201,191,97015,96543,79608,86657,84305
63752,240,274,39332,24420,5.87338e+18,210.529,2839.51,63752,152,147,63450,63312,56548,59896,61071
93792,126,397,57984,35808,5.87063e+18,179.915,3744.27,93792,116,117,93136,92568,65178,59212,71715
23352,228,244,14401,8951,5.87113e+18,91.9771,1581.65,23352,86,84,23108,23097,22445,22671,23039
53388,206,228,33013,20375,5.86986e+18,138.544,2475.32,53388,92,89,53160,53149,53045,53061,53057
19982,173,258,12388,7594,5.87937e+18,175.362,1692.45,19982,117,120,19626,19360,14149,14833,13738
92655,47,233,57219,35436,5.87008e+18,154.668,3216.49,92655,99,98,88586,83383,21240,30200,27769
45479,77,195,28098,17381,5.87009e+18,103.935,2193.92,45479,85,84,45157,45035,25882,25250,25703
71667,150,260,44193,27474,5.87005e+18,143.936,2751.08,71667,100,103,71374,71186,56247,57951,61804
97578,166,294,60229,37349,5.87029e+18,160.066,3227.55,97578,110,118,97253,97000,69207,72854,80308
27454,109,174,16994,10460,5.86989e+18,106.621,1498.47,27454,78,83,27244,27080,19623,19735,23496
62396,31,195,38535,23861,5.86993e+18,111.702,2550.12,62396,86,88,54049,42205,12093,18224,14220
36435,113,282,22900,13535,5.89406e+18,214.1,2583.63,36435,178,167,34302,31552,14790,14281,17324
40437,136,285,25194,15243,5.8806e+18,210.886,2541.84,40437,155,142,39577,38697,21575,19883,21917
52762,167,314,32598,20164,5.8725e+18,163.23,2793.23,52762,118,116,52326,52082,45772,45439,45171
31541,285,303,19884,11657,5.90001e+18,200.501,2397.34,31541,170,169,31238,31231,30578,30965,30567
78691,219,285,49061,29630,5.88155e+18,247.805,3550.16,78691,185,188,78264,77793,64264,69541,68079
67345,248,270,41693,25652,5.87007e+18,202.354,3105.04,67345,132,133,67063,66958,66318,66669,66099
50320,99,255,31013,19307,5.86991e+18,124.381,2294.47,50320,95,98,49890,49507,23631,25822,24531
78839,123,217,48630,30209,5.87031e+18,143.216,2846.65,78839,91,97,78532,78242,54037,51176,60418
53818,86,260,33151,20667,5.87003e+18,131.972,2411.69,53818,94,96,53274,52855,25342,25869,28617
23422,159,247,14478,8944,5.86979e+18,152.975,1793.6,23422,96,93,23124,22880,20117,20334,20729
28439,188,225,17460,10979,5.87014e+18,153.14,1637.45,28439,90,94,28208,28121,25013,26755,26615
60041,186,213,37039,23002,5.87009e+18,130.346,2448.87,60041,90,94,59828,59788,57161,58605,59316
61858,239,286,38375,23483,5.87953e+18,195.546,3095.74,61858,175,174,61553,61456,52839,57568,54108
63847,180,269,39292,24555,5.87134e+18,159.816,2596.86,63847,114,124,63515,63312,44668,44950,41005
18174,211,282,11294,6880,5.87647e+18,115.347,1665.83,18174,99,94,17892,17853,17181,17145,16626
98624,213,281,61127,37497,5.87263e+18,199.532,3448.19,98624,153,162,98219,97846,79386,87840,79990
55115,72,211,34052,21063,5.86988e+18,111.846,2445.71,55115,86,87,54679,54254,26902,28075,28778
25523,107,216,15775,9748,5.86991e+18,123.769,1524.66,25523,85,87,25227,25005,16376,16936,17767
14555,140,209,8980,5575,5.86862e+18,101.171,1139.96,14555,74,79,14344,14263,11321,11777,13469
67790,186,235,41731,26059,5.87004e+18,148.08,2533.51,67790,106,115,67526,67431,56751,62942,60813
14936,215,266,9278,5658,5.87943e+18,128.33,1532.11,14936,103,104,14670,14604,13159,13473,12842
65367,55,352,40226,25141,5.87048e+18,176.542,2846.76,65367,106,114,63436,61462,13046,21224,10539
58795,45,286,37017,21778,5.89596e+18,223.589,3270.19,58795,198,190,44744,31984,9188,12726,10709
84776,202,273,52077,32699,5.87193e+18,186.187,3027.03,84776,136,138,84420,84105,66776,74231,66405
71612,131,271,44312,27300,5.87186e+18,193.335,2800.15,71612,132,138,70829,70180,36926,34348,42862
29496,71,253,18397,11099,5.88564e+18,196.828,2131.74,29496,154,148,26733,24077,7727,10735,10093
53891,95,252,33161,20730,5.87006e+18,113.689,2339.64,53891,96,97,53460,53071,32273,32131,31040
91986,205,280,56877,35109,5.87016e+18,209.722,3467.05,91986,116,118,91634,91433,76379,83592,81747
16121,27,242,9935,6186,5.87228e+18,130.124,1348.8,16121,89,93,13615,11119,2419,4391,3288
18583,241,257,11573,7010,5.87995e+18,185.614,1643.26,18583,116,117,18326,18306,17529,17961,17803
46210,158,274,28527,17683,5.87411e+18,180.368,2459.17,46210,129,134,45660,45249,32175,29881,32887
35302,146,243,21780,13522,5.87034e+18,110.336,1955.93,35302,86,85,35059,34964,32954,33166,33463
90999,168,279,56209,34790,5.87026e+18,159.907,3301.89,90999,105,113,90644,90416,61484,52367,72977
16534,62,140,10234,6300,5.87001e+18,97.3509,1145.26,16534,69,74,16227,16082,7917,7659,9059
50016,288,426,31079,18937,5.8779e+18,160.834,3436.74,50016,149,142,49590,49553,46030,46087,41362
37521,145,195,23131,14390,5.87e+18,110.637,1918.48,37521,83,86,37326,37236,34360,34796,35969
76675,134,269,47447,29228,5.87084e+18,174.707,2814.22,76675,122,129,76063,75484,41553,39333,47526
64955,19,275,40006,24949,5.87559e+18,215.668,2886.6,64955,155,146,48613,33610,6043,13310,3669
43020,3,263,26494,16526,5.87059e+18,168.786,2159.47,43020,109,110,7491,0,6,335,833
74385,77,279,46143,28242,5.87966e+18,235.961,3354.58,74385,185,179,69983,65652,19000,27024,21404
40615,15,192,25094,15521,5.86938e+18,103.156,2070.52,40615,85,84,25874,15027,5037,4877,4272
73634,59,214,45490,28144,5.87021e+18,121.195,2768,73634,92,93,72431,70862,25540,31370,31585
37390,32,265,23100,14290,5.87506e+18,175.544,2200.31,37390,128,132,32158,27265,5615,9810,5984
45757,27,224,28153,17604,5.86977e+18,123.7,2034.26,45757,92,102,39013,30639,7779,11594,9392
34612,11,219,21400,13212,5.87011e+18,140.298,1778.33,34612,88,93,20192,13371,3313,4076,2787
31343,80,190,19347,11996,5.86936e+18,107.392,1790.43,31343,82,84,31094,30999,16391,15416,16466
18779,172,260,11714,7065,5.88738e+18,195.736,1752.7,18779,134,130,18403,18118,13747,14409,14056
41515,178,381,25701,15814,5.87127e+18,146.31,2622.98,41515,119,115,41059,40833,28225,27887,31073
8529,60,126,5225,3304,5.86874e+18,61.8478,786.818,8529,59,60,8368,8292,4974,4706,4839
68513,191,242,42326,26187,5.87033e+18,125.155,2600.24,68513,97,105,68271,68203,57967,64082,63409
25712,271,285,15969,9743,5.87808e+18,170.94,1995.08,25712,115,111,25427,25423,25364,25395,25049
87355,44,303,53880,33475,5.8707e+18,165.292,3211.92,87355,120,124,83024,77921,17475,27240,25337
96068,87,243,59166,36902,5.87023e+18,140.46,3126.77,96068,100,107,95354,94733,44204,43987,56364
7194,142,207,4460,2734,5.87214e+18,105.26,854.663,7194,67,66,6987,6914,5788,6258,5718
56209,300,312,34770,21439,5.87355e+18,155,2866.94,56209,132,134,55897,55880,53584,55244,55177
34223,128,253,21149,13074,5.87056e+18,106.466,1918.38,34223,88,85,33947,33840,27846,27442,30152
49354,181,245,30509,18845,5.87026e+18,161.445,2186.19,49354,101,109,49071,48932,37939,43041,41594
58465,184,307,36350,22115,5.88302e+18,229.84,3197.34,58465,178,176,57897,57398,38796,40812,40460
29716,141,164,18292,11424,5.8697e+18,112.333,1577.24,29716,78,82,29552,29513,26098,27967,27035
55951,26,328,34704,21247,5.87603e+18,152.032,3066.03,55951,129,129,44250,31776,8211,13004,8550
98230,260,271,60577,37653,5.87004e+18,151.595,3195.3,98230,112,114,97959,97959,96076,97341,97663
96932,315,381,59946,36986,5.87054e+18,161.158,3718.9,96932,127,120,96551,96454,91891,94475,91314
78456,146,277,48644,29812,5.87316e+18,199.019,3114.98,78456,149,155,77610,76973,47448,43282,48552
33535,38,190,20682,12853,5.87032e+18,103.469,1814.51,33535,83,86,31123,28498,8914,11303,10851
50362,11,215,31058,19304,5.87001e+18,124.914,2317.67,50362,88,92,27480,17573,4741,5596,2846
40241,46,260,24799,15442,5.87185e+18,206.172,2165.61,40241,117,123,37742,35576,7840,12685,10125
92245,81,276,57047,35198,5.87607e+18,221.675,3577.01,92245,185,180,88260,84352,23453,35076,28690
88598,8,317,54656,33942,5.87066e+18,231.756,3284.64,88598,124,134,39431,0,6553,7367,2840
53751,145,426,33642,20109,5.88681e+18,192.163,3724.95,53751,175,180,52511,50880,30741,29407,25055
91747,17,281,56554,35193,5.87273e+18,217.77,3347.39,91747,158,164,66105,45028,11232,16843,8897
40735,185,290,25205,15530,5.87146e+18,173.169,2226.89,40735,108,115,40386,40199,27233,25015,24565
78178,90,290,49019,29159,5.89181e+18,231.739,3721.39,78178,208,200,71692,63421,22745,27374,27072
26196,74,174,16200,9996,5.86998e+18,103.415,1462.2,26196,77,81,25817,25576,12892,12880,16245
21322,135,216,13183,8139,5.87035e+18,102.274,1385.53,21322,81,84,21095,20996,15372,15054,18653
96767,208,226,59827,36940,5.87028e+18,152.363,3242.26,96767,93,99,96541,96525,95984,96306,96266
33479,129,166,20628,12851,5.86974e+18,108.049,1697.21,33479,77,83,33307,33206,27799,30605,28508
53755,66,259,33148,20607,5.87026e+18,140.243,2401.18,53755,95,96,52869,52105,19634,21924,24472
68470,89,335,42839,25631,5.88768e+18,196.356,3722.55,68470,184,191,63872,58219,25512,28864,21559
94652,38,302,58326,36326,5.87047e+18,155.065,3319.25,94652,121,131,87791,80537,16962,27413,17540
14534,229,233,9154,5380,5.89607e+18,181.729,1537.9,14534,140,127,14301,14297,14223,14273,14269
72431,168,238,44762,27669,5.87024e+18,157.698,2872.28,72431,95,95,72184,72039,62172,65849,65733
34390,118,273,21213,13177,5.87721e+18,175.856,2172.79,34390,128,131,33522,32658,19013,18495,18399
31186,134,180,19159,12027,5.87026e+18,117.281,1618.59,31186,80,88,31006,30906,26149,28483,29290
9037,73,204,5731,3306,5.90584e+18,169.632,1173.44,9037,123,109,7450,5558,3134,2810,3810
78218,216,314,48262,29956,5.87245e+18,179.472,3315.16,78218,138,135,77850,77645,69557,70867,67988
43288,146,228,26759,16529,5.87081e+18,129.457,2015.5,43288,88,97,43050,42936,28841,26911,25372
29387,102,409,18223,11164,5.87301e+18,144.484,2483.42,29387,120,108,28582,27956,18314,16995,16617
16168,14,123,10033,6135,5.86976e+18,63.2861,1146.52,16168,67,70,10065,5982,1906,2780,1988
52975,221,255,32650,20325,5.87011e+18,121.992,2357.57,52975,95,99,52720,52703,45698,49784,49809
57496,208,217,35395,22101,5.86995e+18,130.944,2456.68,57496,88,95,57279,57274,57086,56939,57065
40331,235,263,25004,15327,5.87238e+18,199.847,2162.84,40331,123,121,40061,39964,35706,38256,37781
27930,102,192,17276,10654,5.86968e+18,109.302,1689.34,27930,76,79,27713,27593,16473,15030,15872
98174,130,281,60540,37634,5.87279e+18,226.795,3482.87,98174,167,167,96797,95392,49638,48720,57270
18060,146,159,11171,6889,5.87017e+18,101.272,1220.08,18060,72,76,17901,17871,17185,17578,17752
50898,99,257,31471,19427,5.8697e+18,169.209,2557.52,50898,101,99,50257,49898,27579,25236,25188
73557,100,291,46256,27301,5.89469e+18,220.324,3636.27,73557,204,197,68007,61184,27899,27135,31713
12006,21,237,7439,4567,5.87632e+18,181.557,1284.08,12006,100,98,8849,6482,1328,2586,730
94824,72,229,58504,36320,5.87031e+18,139.467,3193.25,94824,92,97,94083,93378,38159,39056,44714
3842,189,209,2390,1452,5.8695e+18,74.5211,711.208,3842,63,64,3633,3622,3470,3560,2738
49489,121,259,30515,18974,5.86998e+18,125.11,2296.42,49489,93,93,49182,48977,36729,37923,40959
84097,250,288,51852,32245,5.87011e+18,146.666,3042.71,84097,108,109,83809,83801,78713,81786,80724
39317,180,270,24333,14984,5.87e+18,191.654,2350.88,39317,111,113,38897,38566,30093,27362,33922
97878,148,241,60378,37500,5.87011e+18,157.855,3277.57,97878,95,102,97594,97354,69025,68167,67055
91117,254,295,56129,34988,5.87034e+18,158.336,3138.1,91117,110,115,90822,90814,85349,88559,89068
14741,25,140,9131,5610,5.86962e+18,69.1805,1124.51,14741,67,70,12072,8822,2607,4029,2612
12550,211,405,7838,4712,5.88124e+18,148.273,1809.12,12550,117,103,12145,12111,10024,9574,8176
18987,157,158,11662,7325,5.86971e+18,101.694,1246.59,18987,71,77,18829,18829,18827,18828,18829
25820,182,187,15883,9937,5.87057e+18,103.169,1577.53,25820,80,84,25633,25629,25436,25479,25623
16764,46,247,10433,6331,5.88175e+18,151.054,1576.87,16764,125,113,14326,12101,3083,4704,3648
4795,35,145,2956,1839,5.87236e+18,75.2158,630.536,4795,54,57,4378,3978,1040,1616,1132
79140,199,277,48777,30363,5.87038e+18,152.679,2929.71,79140,119,123,78834,78665,61460,69533,55243
77964,179,280,48623,29341,5.88188e+18,207.237,3482.9,77964,193,184,77218,76074,52870,53051,56143
25313,137,164,15563,9750,5.87031e+18,108.229,1477.6,25313,74,78,25149,25127,21647,23587,22798
36842,17,218,22663,14179,5.86969e+18,140.504,1831.97,36842,88,94,27017,18495,4859,6432,4094
11096,125,396,6891,4205,5.87846e+18,142.492,1627.97,11096,103,96,10579,10215,7309,6806,6768
31026,89,270,19191,11835,5.87007e+18,223.501,2164.9,31026,117,126,29687,28700,12838,10842,12448
27561,220,250,17323,10238,5.89299e+18,186.391,2133.25,27561,167,149,27311,27241,24997,26078,26719
36053,95,260,22223,13830,5.87181e+18,210.103,2070.49,36053,115,115,35179,34363,14145,15258,10978
51894,20,270,32155,19739,5.8702e+18,188.383,2666.27,51894,114,117,35951,25209,7529,9109,6409
87092,115,301,53756,33336,5.8708e+18,159.542,3201.33,87092,117,126,86387,85665,50610,53160,55865
5658,62,230,3486,2172,5.874e+18,77.0855,780.471,5658,62,63,5356,5209,1528,2070,503
71155,208,214,43874,27281,5.87031e+18,133.639,2657.86,71155,95,101,70941,70941,70692,70695,70779
49436,3,226,30420,19016,5.87025e+18,127.245,2130.29,49436,93,97,8559,0,293,255,629
5730,101,119,3514,2216,5.86754e+18,65.8447,654.985,5730,54,57,5611,5594,4978,5339,5030
87159,138,279,53815,33344,5.87018e+18,153.462,3286.11,87159,109,115,86666,86228,55589,52503,64404
80097,109,291,50281,29816,5.89329e+18,237.967,3789.06,80097,211,204,75312,69280,30782,30577,34593
54585,259,322,33912,20673,5.88038e+18,168.354,3158.57,54585,160,168,54263,54188,47694,49261,45182
14455,122,246,8936,5519,5.86906e+18,107.91,1388.81,14455,83,85,14128,13912,8871,8378,9005
92675,121,342,57208,35467,5.87021e+18,155.085,3451.52,92675,120,117,92018,91445,53614,51712,55177
57170,168,229,35189,21981,5.86992e+18,134.673,2302.52,57170,98,101,56927,56827,46687,51076,53637
20776,84,186,12844,7932,5.87005e+18,89.6727,1518.01,20776,78,80,20564,20493,11926,11154,10694
68670,280,284,42414,26256,5.8702e+18,161.867,2732.13,68670,104,107,68386,68385,68239,68345,68384
53420,120,381,33066,20354,5.87118e+18,180.297,2752.59,53420,119,128,52656,51914,20384,21342,23034
10893,13,154,6714,4179,5.86792e+18,63.8245,976.194,10893,66,67,6414,3700,1410,1387,782
83158,42,277,51213,31945,5.87059e+18,154.564,2952.69,83158,116,129,78790,73363,14987,22118,19069
69104,251,397,42811,26293,5.87278e+18,177.372,3531.81,69104,149,146,68699,68600,56989,56019,51968
47430,79,314,29342,18088,5.87387e+18,151.963,2706.55,47430,129,126,46002,44819,18919,21443,20109
98842,55,284,61256,37586,5.8727e+18,202.014,3465.4,98842,155,160,94477,91094,22005,32635,22625
46432,90,196,28706,17726,5.87022e+18,102.359,2209.17,46432,84,84,46158,46035,26118,23760,25263
85656,128,294,52776,32880,5.87028e+18,162.807,3030.81,85656,109,114,85188,84808,50218,48053,63039
26838,292,426,16897,9941,5.89611e+18,198.546,2636.61,26838,158,163,26412,26359,19692,19722,12650
16420,60,149,10119,6301,5.86966e+18,84.5554,1213.37,16420,69,71,16141,15927,7115,7165,7647
33450,106,260,20958,12492,5.89102e+18,220.774,2382.56,33450,168,169,31346,28952,13814,13769,13689
54920,194,264,33749,21171,5.87142e+18,168.983,2423.14,54920,116,120,54601,54408,43421,48128,44004
75427,37,274,46651,28776,5.87625e+18,231.982,3217.63,75427,182,168,66048,57820,11483,19795,10777
25336,51,397,15740,9596,5.87536e+18,151.807,2374.02,25336,121,117,22881,20758,6930,8350,7399
43677,23,397,27073,16604,5.87286e+18,161.601,2921.64,43677,125,119,31890,21733,6548,9609,5540
97151,21,285,60416,36735,5.8788e+18,234.434,3786.46,97151,190,191,72464,54147,10547,20532,9134
86638,38,278,54189,32449,5.88634e+18,220.291,3795.87,86638,205,196,69738,55331,12070,19889,13947
19501,217,253,12048,7453,5.88101e+18,165.256,1649.38,19501,120,110,19233,19139,17198,18083,17793
79333,86,270,49109,30224,5.87024e+18,205.417,3303.18,79333,126,131,77809,76830,35694,31102,36821
25863,79,258,15945,9918,5.87942e+18,173.928,1871.1,25863,129,124,24505,23300,8286,10575,9827
56368,139,265,34861,21507,5.87153e+18,169.495,2435.12,56368,116,122,55871,55492,35350,34423,40563
61051,333,411,37875,23176,5.87347e+18,165.832,3452.29,61051,135,123,60640,60604,59330,59346,58073
95430,220,426,59475,35955,5.88055e+18,204.518,4702.99,95430,187,193,94927,94660,75820,71627,63335
87999,159,217,54268,33731,5.87013e+18,138.885,3017.54,87999,92,101,87775,87619,74503,79579,82997
71555,66,217,44084,27471,5.87042e+18,129.359,2676.58,71555,94,99,70649,69925,24694,28669,31887
57772,4,262,36163,21609,5.88973e+18,230.2,3109.84,57772,191,191,11627,0,9,1158,679
34713,61,195,21420,13293,5.86997e+18,104.781,1866.28,34713,82,88,34092,33562,14071,14853,16537
27801,93,251,17213,10588,5.87216e+18,129.368,1732.64,27801,97,98,27227,26713,12530,12843,15496
33336,3,189,20564,12772,5.86971e+18,92.7565,1762.88,33336,82,84,5763,0,202,296,594
81594,21,300,50283,31311,5.87115e+18,193.925,3113.65,81594,120,124,63794,48302,9351,17674,8908
86438,140,274,53560,32878,5.8726e+18,202.215,3198.45,86438,153,148,85560,84826,46946,41284,45612
83483,87,284,51454,32029,5.87029e+18,174.985,3000.3,83483,113,122,82553,81713,33404,36432,34022
85525,22,280,52883,32642,5.88074e+18,229.962,3593.14,85525,194,181,63811,47706,7686,17485,8002
94358,131,322,58203,36155,5.87064e+18,203.317,3422.25,94358,128,131,93690,93110,47610,47382,44777
38026,41,168,23498,14528,5.86996e+18,96.3049,1889.96,38026,79,80,35714,32120,8994,13307,11708
4872,30,115,3014,1858,5.8683e+18,62.8181,598.511,4872,53,56,4342,3744,1303,1663,1819
22724,127,145,14048,8676,5.86903e+18,99.4108,1363.32,22724,73,77,22579,22538,21090,22001,21757
73771,131,317,46260,27511,5.89085e+18,229.747,3699.04,73771,198,204,71134,67407,30648,30368,21254
27515,53,163,16920,10595,5.86951e+18,106.714,1526.84,27515,75,82,26856,26024,9402,11467,12745
55495,104,284,34461,21034,5.88037e+18,206.015,2959.55,55495,171,174,53229,50827,24832,26497,21722
42965,47,197,26488,16477,5.87025e+18,112.666,2072.35,42965,84,86,41356,39532,11794,15922,15298
27161,127,170,16730,10431,5.86982e+18,90.7378,1591.11,27161,79,77,26991,26929,25736,25950,26297
73789,179,237,45354,28435,5.87035e+18,142.812,2692.39,73789,102,111,73512,73399,61055,67843,63097
1489,49,77,917,572,5.87414e+18,56.0846,302.116,1489,43,45,1366,1255,993,921,1092
77356,31,276,47850,29506,5.87679e+18,232.118,3294.81,77356,180,177,64631,53604,10730,19520,10853
1193,143,165,751,442,5.89368e+18,72.2716,381.871,1193,46,45,1028,1021,959,966,968
29503,130,270,18248,11255,5.87609e+18,187.056,2016.32,29503,126,126,28800,28115,14485,14260,12196
36074,17,397,22389,13685,5.87383e+18,150.005,2720.25,36074,123,119,22917,13412,4155,6097,3661
97144,232,316,59886,37258,5.87277e+18,200.629,3619.86,97144,146,149,96809,96627,90023,92065,89539
99697,23,327,61799,37898,5.87588e+18,210.53,4026.32,99697,169,172,76702,56030,11335,20269,10498
5929,29,216,3722,2207,5.89001e+18,161.246,953.1,5929,94,86,4094,2844,768,1233,722
14153,34,237,8769,5384,5.87231e+18,131.509,1236.51,14153,86,83,12607,11041,2241,3741,2266
63913,130,293,39480,24433,5.87045e+18,171.05,2660.4,63913,102,105,63527,63237,37822,32049,33255
48610,79,226,30093,18517,5.87024e+18,127.959,2090.94,48610,92,101,47968,47514,20032,21277,25794
98596,229,231,60774,37822,5.86998e+18,142.921,3164.28,98596,98,104,98365,98365,98364,98365,98365
69001,122,244,42646,26355,5.87032e+18,148.083,2581.62,69001,103,114,68570,68124,38623,34444,44864
89235,95,277,55248,33987,5.87204e+18,193.718,3161.71,89235,144,145,87670,86090,32160,36531,35370
98470,293,302,60684,37786,5.87062e+18,160.213,3375.09,98470,125,132,98168,98165,96629,97759,97746
69172,117,270,42518,26654,5.87161e+18,160.448,2709.34,69172,114,116,68576,67902,32575,30018,25289
29889,155,297,18501,11388,5.87601e+18,146.83,2178.6,29889,127,123,29404,29084,20001,18724,17547
34181,98,197,21020,13161,5.87002e+18,115.843,1840.64,34181,80,84,33921,33788,23311,21919,24537
29971,199,217,18544,11427,5.87092e+18,158.38,1671.69,29971,88,95,29744,29670,26691,28352,28425
47540,58,260,29443,18097,5.87205e+18,194.835,2315.74,47540,123,126,45592,44186,10920,16959,14680
31499,100,168,19482,12017,5.86935e+18,100.193,1717.26,31499,77,78,31303,31240,22497,21513,22929
79527,55,216,49028,30499,5.86993e+18,138.948,2859.16,79527,95,98,77838,75307,20797,28662,29003
7210,36,142,4465,2745,5.87028e+18,64.3245,820.945,7210,62,66,6437,5641,2062,2323,2527
90643,136,306,56025,34618,5.8707e+18,160.398,3257,90643,119,128,90065,89596,54447,55037,58192
67482,80,270,41486,25996,5.87168e+18,199.112,2730.61,67482,131,134,65903,64619,18746,26236,25148
53574,80,315,33112,20462,5.87161e+18,139.603,2697.83,53574,108,108,52667,51937,26109,25139,30416
81578,90,232,50390,31188,5.87008e+18,145.795,3045.32,81578,97,97,81077,80822,44818,42916,47267
41725,268,426,26243,15482,5.89315e+18,210.605,3220.33,41725,177,183,41299,41226,27477,27555,15963
99132,50,283,61062,38070,5.87109e+18,180.019,3311.1,99132,137,136,95230,91604,18289,30411,22973
11676,29,245,7374,4302,5.9003e+18,172.198,1385.76,11676,136,123,6780,3585,1320,1484,2025
70127,301,304,43275,26852,5.87368e+18,192.069,3140.91,70127,150,147,69823,69821,69817,69818,69794
12107,80,149,7425,4682,5.86983e+18,81.0861,976.052,12107,65,69,11910,11803,6986,6323,6138
3737,18,119,2307,1430,5.87176e+18,60.6262,505.479,3737,51,50,2965,2190,633,864,1098
81065,178,282,50276,30789,5.87343e+18,215.025,3179.05,81065,148,158,80462,79853,55314,51064,57081
85876,102,271,53161,32715,5.87151e+18,191.35,3057.81,85876,138,144,84635,83367,37314,37719,40836
79442,275,301,48947,30495,5.87089e+18,198.041,3077.58,79442,121,119,79141,79068,75520,77642,77553
59590,3,270,36938,22652,5.87391e+18,203.282,2721.13,59590,148,139,10341,0,4,638,563
21319,179,186,13193,8126,5.86952e+18,82.7867,1552.85,21319,78,80,21133,21133,21129,21133,21026
87131,111,270,53861,33270,5.87024e+18,182.736,3279.45,87131,107,107,86455,86000,46028,40454,49686
95580,185,282,58850,36730,5.87137e+18,192.274,3277.74,95580,142,150,95110,94672,66436,68761,67863
24817,154,188,15334,9483,5.86916e+18,119.462,1475.02,24817,84,83,24629,24612,21356,23216,22933
60498,177,202,37298,23200,5.87014e+18,117.936,2467.34,60498,90,94,60296,60240,55409,57817,57584
97555,86,298,60166,37389,5.87038e+18,163.269,3372.24,97555,124,129,96349,95243,36943,43892,39327
9070,11,262,5613,3457,5.8762e+18,76.8567,1169.32,9070,78,75,4522,2628,941,844,698
64198,173,317,40269,23929,5.89132e+18,220.934,3504.58,64198,192,198,63331,62131,37582,34990,29702
57237,235,266,35226,22011,5.87112e+18,172.929,2457.78,57237,114,119,56971,56907,50071,54229,54024
62242,235,258,38371,23871,5.87041e+18,129.835,2569.31,62242,96,100,61984,61954,57980,60073,61310
86008,153,302,53145,32863,5.87088e+18,149.958,3176.67,86008,116,127,85562,85292,50064,45503,48890
92334,78,269,56950,35384,5.87016e+18,145.855,3094.15,92334,104,111,91316,90582,32443,39046,48131
9686,55,215,5951,3735,5.87132e+18,103.603,981.163,9686,71,75,9175,8871,3005,3934,4817
91476,159,257,56581,34895,5.8704e+18,152.807,3328.05,91476,109,108,91096,90693,68648,61150,71078
61494,97,328,38185,23309,5.87847e+18,171.646,3327.31,61494,156,164,59473,57289,29859,30366,30941
96382,217,279,59527,36855,5.87003e+18,176.237,3456.85,96382,111,108,96086,95946,94767,95281,95355
73832,218,340,46092,27740,5.88537e+18,196.178,3878.02,73832,182,192,73410,73162,56353,56740,49500
66192,148,285,41246,24946,5.88138e+18,237.019,3230.98,66192,180,178,65019,63730,38519,34598,40290
90466,331,411,56015,34451,5.87746e+18,195.296,4291.18,90466,180,181,90055,89960,80053,83457,72758
36544,153,10573,22914,13630,5.61381e+18,734.574,14912.8,36544,715,286,17915,11409,2116,4065,152
43627,85,291,26883,16744,5.87094e+18,146.105,2332.48,43627,104,110,42837,42213,21830,25959,24618
52610,132,257,32544,20066,5.87024e+18,133.639,2529.62,52610,95,98,52212,51913,29076,25373,33833
80921,300,342,50223,30698,5.87948e+18,207.098,3922.11,80921,173,168,80579,80525,77123,77835,76338
87258,38,285,53759,33499,5.87022e+18,147.388,3088.12,87258,107,111,81198,74473,15017,23183,19907
65941,387,426,41032,24909,5.87855e+18,182.085,3913.31,65941,161,159,65515,65477,64343,64917,62166
45591,178,296,28091,17500,5.87142e+18,136.657,2387.61,45591,97,101,45295,45206,43526,43472,43327
67989,228,260,41899,26090,5.87025e+18,111.663,2691.29,67989,96,101,67729,67711,60771,64461,65067
2169,82,140,1341,828,5.87831e+18,56.0212,425.249,2169,46,46,2021,1976,1455,1442,1688
30532,152,157,18842,11690,5.86988e+18,91.7601,1648.8,30532,76,81,30375,30375,30351,30253,30223
57144,267,302,35215,21929,5.87058e+18,161.826,2663.24,57144,107,114,56842,56785,51269,54554,53619
95352,260,381,58981,36371,5.87052e+18,162.987,3693.96,95352,127,119,94971,94860,87131,89342,86678
88479,211,238,54655,33824,5.87026e+18,161.457,3178.45,88479,96,97,88241,88211,87682,87875,88065
82686,130,222,51052,31634,5.87023e+18,139.419,2996.09,82686,92,95,82411,82209,61405,59213,67526
95524,317,318,59202,36322,5.87836e+18,225.622,3958.76,95524,191,191,95206,95206,95206,95206,95206
80496,13,293,49604,30892,5.87025e+18,162.201,2936.07,80496,107,115,50109,29769,9231,8514,4039
66940,123,215,41327,25613,5.87011e+18,125.286,2650.52,66940,91,95,66667,66451,43167,38905,38951
84467,47,216,52088,32379,5.87e+18,133.928,2961.03,84467,93,98,81276,77502,18902,28339,28098
21936,240,297,13719,8217,5.88713e+18,144.604,2056.14,21936,135,130,21639,21601,19048,19491,18628
3211,33,79,1988,1223,5.86814e+18,64.3912,441.467,3211,53,58,2732,1975,1268,1230,1520
33460,58,181,20585,12875,5.86952e+18,111.788,1665.22,33460,80,85,32807,32274,12240,14312,15810
10647,203,221,6710,3937,5.89887e+18,172.555,1307.14,10647,126,114,10422,10370,9872,10171,10222
84156,182,273,52175,31981,5.87407e+18,233.332,3269.81,84156,165,164,83519,82887,58011,59550,60601
96430,170,289,59402,37028,5.87034e+18,158.711,3251.07,96430,105,112,96108,95942,76211,71579,86238
25090,132,270,15518,9572,5.86992e+18,213.806,1941.59,25090,110,117,24407,23767,13427,11338,13930
68265,53,207,42146,26119,5.8698e+18,122.809,2700.48,68265,89,91,66547,63168,20848,26393,24834
43616,54,273,27117,16499,5.87697e+18,234.256,2500.61,43616,145,147,40256,37854,8701,13635,9590
61611,50,264,38144,23467,5.87095e+18,171.285,2540.06,61611,116,124,59159,57117,12834,19832,15148
85579,70,227,52825,32754,5.8701e+18,133.691,3030.46,85579,93,98,84772,83827,30925,34231,35685
81208,149,294,50041,31167,5.87017e+18,161.23,2956.73,81208,107,112,80836,80555,53989,50196,65928
28306,89,263,17444,10862,5.87116e+18,175.627,1811.97,28306,100,108,27633,27047,9555,11723,9343
15484,75,159,9528,5956,5.87009e+18,98.036,1143.35,15484,68,72,15228,15103,9005,8530,10325
42338,126,183,26127,16211,5.87021e+18,114.651,2038.86,42338,80,83,42135,42026,34110,35753,36588
2685,84,129,1648,1037,5.87227e+18,49.8622,464.611,2685,48,48,2556,2524,2020,2072,1836
2341,38,76,1444,897,5.86716e+18,62.0376,373.468,2341,50,52,2079,1833,1033,1001,1224
40238,113,268,24844,15394,5.87484e+18,168.408,2279.47,40238,130,136,39305,38324,19672,19945,21103
58923,56,206,36461,22462,5.86978e+18,125.165,2500.56,58923,86,88,57643,55336,18381,21977,21114
36283,73,340,22466,13817,5.87391e+18,100.857,2500.1,36283,114,104,35092,33870,18560,18375,18938
46924,64,258,28952,17972,5.87019e+18,126.04,2245.16,46924,92,93,46137,45420,18214,19856,20949
51752,119,201,31990,19762,5.86985e+18,115.831,2263.72,51752,87,85,51523,51440,40989,40967,45751
3926,17,74,2448,1478,5.86579e+18,60.2598,470.268,3926,54,57,2565,1524,643,882,943
32163,89,163,19762,12401,5.87064e+18,117.785,1632.23,32163,81,87,31855,31602,19410,17711,21182
41540,164,342,25608,15932,5.87044e+18,150.344,2451.18,41540,109,108,41112,40879,28355,27164,30297
56447,26,381,34932,21515,5.87128e+18,173.63,2994.57,56447,125,127,45896,34464,7990,13338,7959
10274,182,206,6295,3979,5.87152e+18,84.0617,965.041,10274,71,72,10068,10067,9648,9815,9969
55867,50,308,34490,21377,5.87021e+18,150.347,2538.34,55867,93,104,53974,51676,12285,18409,13621
41336,51,273,25674,15662,5.87546e+18,206.437,2341.01,41336,135,135,38452,36588,8477,13536,11106
68610,72,273,42631,25979,5.87599e+18,228.221,3040.93,68610,163,167,65300,62541,15796,25481,20694
81387,38,230,50146,31241,5.87007e+18,140.988,2900.59,81387,96,102,75590,69083,15007,22813,20108
62774,191,218,38826,23948,5.87009e+18,133.69,2612.23,62774,88,88,62556,62528,62056,62116,62318
67722,47,317,41904,25818,5.87327e+18,198.43,3157.52,67722,140,144,63258,58966,13775,21278,10063
53093,172,224,32655,20438,5.86967e+18,131.622,2178.05,53093,94,104,52859,52777,45227,49349,48952
84836,105,342,52882,31954,5.88383e+18,202.298,4127.13,84836,183,196,81445,77387,38149,35796,36981
2121,62,85,1305,816,5.86659e+18,38.793,342.505,2121,41,44,2036,2036,1666,1537,1609
42506,25,307,26694,15812,5.8928e+18,190.568,2907.46,42506,173,176,27566,15955,4744,7649,3645
39655,124,342,24505,15150,5.87283e+18,105.949,2506.75,39655,107,101,39186,38853,31634,34232,33471
77444,153,381,47920,29524,5.87077e+18,171.647,3326.76,77444,129,134,76824,76354,42701,41570,46668
75009,49,259,46095,28914,5.87094e+18,144.955,2759.45,75009,108,115,72429,69973,15217,23554,20330
60602,6,273,37644,22958,5.87702e+18,236.191,2905.01,60602,161,161,21243,0,2116,4059,970
17303,69,131,10646,6657,5.87081e+18,68.5945,1180.78,17303,69,71,17143,16950,10645,9395,8307
14022,74,168,8646,5376,5.87047e+18,72.2115,1026.41,14022,72,75,13840,13726,12921,13426,13729
70985,38,289,43688,27297,5.87053e+18,139.787,2817.34,70985,101,107,65919,60436,13502,19736,14880
89221,319,381,55171,34050,5.87059e+18,183.735,3636.9,89221,123,118,88840,88756,86621,87817,86433
92037,252,292,56663,35374,5.87044e+18,142.552,3169.82,92037,105,113,91745,91739,85676,89180,89164
50724,158,211,31310,19414,5.87005e+18,126.613,2243.82,50724,87,91,50513,50421,46931,48283,48124
95202,187,270,58904,36298,5.87005e+18,190.797,3570.57,95202,125,128,94748,94296,78701,78056,88333
29243,193,286,18045,11198,5.87184e+18,121.621,1938.99,29243,101,102,28943,28849,22918,23271,21006
49173,53,224,30423,18750,5.86978e+18,125.918,2113.76,49173,93,100,47925,46591,13059,18492,19402
80627,268,269,49643,30984,5.87116e+18,188.311,2942.03,80627,135,133,80358,80358,80358,80358,80358
1736,53,67,1065,671,5.87485e+18,47.4885,297.098,1736,45,43,1661,1585,1489,1522,1628
27190,91,164,16709,10481,5.87013e+18,113.056,1499.42,27190,78,83,26922,26691,17780,16337,21087
96728,126,411,59906,36822,5.87472e+18,203.365,4316.26,96728,164,159,95353,93726,54452,49829,51381
15606,51,252,9677,5929,5.87886e+18,153.583,1492.6,15606,115,108,13923,12835,3660,5553,3670
9880,202,224,6238,3642,5.89797e+18,161.097,1260.39,9880,122,112,9656,9630,9234,9419,9363
83658,156,215,51540,32118,5.86995e+18,129.475,2895.75,83658,95,99,83433,83316,71448,72928,77469
13661,45,210,8465,5196,5.86968e+18,110.88,1292.92,13661,81,81,12588,11274,4131,4507,5034
7068,249,250,4452,2616,5.90659e+18,161.012,1125.37,7068,113,103,6818,6815,6817,6816,6818
17307,46,251,10640,6667,5.87424e+18,108.296,1426.08,17307,87,85,16267,15309,4902,6188,6775
69841,142,260,43083,26758,5.87006e+18,145.2,2720.41,69841,100,104,69536,69305,53692,56523,59560
53724,225,274,33194,20530,5.87508e+18,222.224,2687.07,53724,157,147,53404,53182,45773,49525,49599
79198,67,294,48890,30308,5.87012e+18,162.787,2922.81,79198,108,110,77907,76892,20209,29750,34744
16889,21,139,10380,6509,5.86956e+18,89.0153,1159.52,16889,69,72,13092,9634,2855,4216,2835
49987,182,265,30932,19055,5.87167e+18,185.258,2327.46,49987,116,121,49633,49418,37946,40974,41546
16842,26,142,10420,6422,5.86997e+18,93.6931,1163.28,16842,68,70,14115,10778,2987,4763,3068
64933,157,290,40752,24181,5.89334e+18,235.427,3427.01,64933,200,195,63659,61860,38189,36717,41828
49274,210,266,30297,18977,5.87153e+18,166.554,2302.1,49274,111,117,48984,48838,41534,45057,42915
37736,59,294,23291,14445,5.87166e+18,127.436,2206.11,37736,100,100,36605,35473,13592,15947,14670
85805,5,328,53150,32655,5.87374e+18,201.267,3543.2,85805,145,138,24792,0,425,4359,1349
26977,147,267,16692,10285,5.87666e+18,181.942,1945.82,26977,128,128,26452,26039,15502,13867,13115
9318,55,131,5773,3545,5.87121e+18,61.9554,854.16,9318,62,62,9103,8905,5983,6119,6674
64700,164,285,40292,24408,5.87952e+18,223.202,3151.52,64700,173,174,63873,62991,41222,39592,42146
84722,278,340,52966,31756,5.88615e+18,204.135,4109.53,84722,190,201,84382,84298,71850,74587,69736
4430,15,115,2731,1699,5.86729e+18,65.9052,574.797,4430,52,54,3093,1994,555,905,680
43591,182,267,27052,16539,5.87444e+18,206.953,2362.14,43591,135,132,43198,42821,31927,35606,31048
23336,124,175,14355,8981,5.87017e+18,105.274,1391.08,23336,76,80,23156,23059,18639,19372,19970
50980,66,274,31545,19435,5.87655e+18,237.008,2679.91,50980,153,151,48009,45406,11135,17857,12753
34065,173,273,21013,13052,5.87705e+18,166.996,2165.12,34065,127,130,33634,33318,24372,22832,22727
78494,222,262,48380,30114,5.87022e+18,137.621,2865.93,78494,101,107,78232,78169,70329,75026,75063
88591,170,318,54938,33653,5.87885e+18,224.275,3858.27,88591,187,190,87638,86580,54856,50363,49526
43694,112,180,26941,16753,5.87011e+18,118.736,2064.86,43694,82,85,43469,43299,31913,32050,34890
88098,101,328,54622,33476,5.87514e+18,197.864,3732.1,88098,157,157,86324,84392,40364,39702,44204
48058,145,210,29709,18349,5.86957e+18,122.904,2218.3,48058,85,85,47848,47745,36740,40953,39462
79543,201,217,49152,30391,5.8701e+18,118.092,2878.66,79543,92,94,79326,79318,77719,78808,78919
65980,202,298,40657,25323,5.87076e+18,162.202,2834.17,65980,115,120,65640,65440,52411,53758,51856
23229,46,219,14381,8848,5.87006e+18,116.21,1474.7,23229,78,87,22207,21261,6663,8740,9638
28869,249,292,17810,11059,5.87169e+18,113.057,1936.12,28869,91,89,28577,28529,27642,28074,27753
47746,105,190,29347,18399,5.86988e+18,113.642,2083.28,47746,84,96,47462,47189,31122,28284,38301
60338,193,269,37165,23173,5.87118e+18,207.104,2606.9,60338,127,135,59962,59643,46265,51605,45543
74187,214,281,45761,28426,5.87292e+18,217.683,3054.65,74187,152,155,73821,73505,59571,66318,54457
83796,79,227,51730,32066,5.87e+18,133.865,2992.6,83796,94,99,83185,82866,39828,40513,42148
6673,120,214,4230,2443,5.90331e+18,153.084,1006.97,6673,109,101,6214,5635,4097,3990,4437
99790,69,289,61503,38287,5.87227e+18,199.411,3490.11,99790,157,161,96582,93761,22239,35715,24731
28199,180,285,17534,10665,5.87925e+18,175.187,2124.52,28199,126,121,27864,27689,22492,23876,23730
96629,245,279,59718,36911,5.87014e+18,172.358,3368.95,96629,101,109,96350,96299,79739,89631,74342
40529,193,261,24937,15592,5.87239e+18,203.147,2172.35,40529,116,124,40175,39939,32277,35464,33144
74621,116,217,46027,28594,5.87021e+18,119.122,2783.15,74621,90,96,74325,74070,50549,45842,50588
99515,199,314,61667,37848,5.87281e+18,205.837,3554.17,99515,156,159,99025,98576,64646,58650,59389
60348,132,289,37104,23244,5.87035e+18,144.347,2574.32,60348,94,102,60011,59756,32563,28007,24382
29109,29,262,18201,10908,5.88825e+18,201.681,2179.49,29109,160,149,21272,15536,3626,6169,3560
37439,177,381,23177,14262,5.87124e+18,151.694,2558.81,37439,115,112,36992,36771,29964,30005,30846
45056,117,397,27945,17111,5.87431e+18,176.561,3000.47,45056,143,137,43976,42935,24317,24065,22027
96911,145,328,60063,36848,5.87643e+18,189.126,3999.93,96911,169,179,95736,94533,60864,65206,61213
21657,96,247,13404,8253,5.87064e+18,154.018,1735.69,21657,93,91,21150,20859,11631,10586,10629
7800,27,147,4803,2997,5.86898e+18,64.6231,794.446,7800,63,62,6524,4958,1771,2453,1906
40503,255,257,24932,15571,5.87084e+18,171.715,2081.84,40503,107,112,40246,40243,40191,40191,40242
9902,178,202,6116,3786,5.87112e+18,91.4957,949.15,9902,69,72,9700,9686,9296,9512,9580
51958,245,288,32014,19944,5.87084e+18,165.791,2499.53,51958,114,120,51670,51632,43766,48349,43657
80541,222,411,49972,30569,5.87663e+18,188.866,4099.99,80541,164,167,80085,79867,68727,66739,62109
92107,206,303,56784,35323,5.871e+18,175.873,3286.15,92107,123,127,91760,91536,79292,81478,81646
75649,171,216,46708,28941,5.87007e+18,120.22,2818.59,75649,91,95,75433,75391,65416,70733,65896
98723,106,285,61430,37293,5.8781e+18,231.261,3835.39,98723,193,192,95604,92079,39756,40763,33185
11046,137,258,6955,4091,5.89241e+18,170.888,1436.25,11046,120,117,10530,10054,6453,5944,5177
49258,152,285,30696,18562,5.88051e+18,207.933,2809.74,49258,162,161,48445,47575,31445,31614,34703
81748,78,273,50682,31066,5.87351e+18,217.582,3161.45,81748,157,158,79226,76986,21812,31112,25884
18970,125,260,11748,7222,5.86964e+18,128.689,1608,18970,90,93,18596,18346,11696,10914,12835
40618,131,181,24988,15630,5.87019e+18,98.2776,1975.02,40618,82,88,40435,40368,32971,36251,33268
14229,86,240,8820,5409,5.87341e+18,150.054,1293.2,14229,89,92,13690,13280,5691,6089,5769
41643,150,301,25716,15927,5.8712e+18,141.503,2324.41,41643,102,100,41250,41089,33605,33522,35276
97126,38,281,59835,37291,5.87071e+18,163.009,3243.78,97126,123,131,90265,83138,15553,27372,18709
98934,36,285,60978,37956,5.87015e+18,154.692,3281.88,98934,107,111,90669,81344,16527,26363,20090
40671,22,285,25301,15370,5.87881e+18,212.618,2514.91,40671,146,143,30477,22494,4716,9059,4746
73687,213,411,45650,28037,5.87361e+18,154.704,3746.44,73687,143,131,73259,73159,68369,67753,65691
52459,148,211,32369,20090,5.87032e+18,126.743,2288.28,52459,87,91,52244,52130,44910,46750,47204
84690,25,273,52540,32150,5.87532e+18,214.484,3332.39,84690,169,169,68774,53159,10324,19251,8670
44337,37,342,27336,17001,5.87016e+18,152.283,2520.84,44337,109,108,40226,35964,7826,10879,8274
61416,56,194,37889,23527,5.87026e+18,114.785,2539.72,61416,86,88,60187,57978,18998,24134,22779
96999,387,409,59954,37045,5.8708e+18,175.273,3873.43,96999,126,118,96590,96585,96573,96565,96396
71372,286,397,44235,27137,5.87358e+18,205.109,3576.56,71372,149,157,70975,70863,60030,63284,52871
61334,122,281,38186,23148,5.87985e+18,200.656,3049.56,61334,173,173,59637,57446,29160,28370,32107
71178,5,281,44327,26851,5.87878e+18,199.249,3270.29,71178,178,173,20576,0,348,3619,964
2758,8,94,1717,1041,5.8676e+18,48.9956,414.968,2758,44,45,1296,0,200,353,152
31301,287,302,19490,11811,5.88295e+18,142.903,2392.07,31301,146,140,30999,30990,30594,30867,30573
38580,330,342,23830,14750,5.87211e+18,105.242,2438.91,38580,104,100,38238,38238,38224,38233,38098
54988,187,274,33958,21030,5.87451e+18,211.276,2684.36,54988,140,148,54534,54122,39319,42708,37458
68060,115,213,41960,26100,5.87009e+18,132.459,2596.71,68060,93,99,67746,67399,45661,41796,54041
88955,177,314,54881,34074,5.87195e+18,202.925,3468.01,88955,141,139,88471,88073,70046,74863,77695
50424,53,196,31091,19333,5.86996e+18,119.32,2226.02,50424,88,89,49239,47448,15450,19085,21209
49138,200,264,30428,18710,5.87156e+18,187.399,2313.37,49138,115,118,48831,48610,41667,45222,43126
2514,85,102,1556,958,5.87154e+18,47.5378,432.239,2514,49,51,2412,2412,2213,2313,2157
28778,69,258,17801,10977,5.8728e+18,147.855,1791.24,28778,99,104,27892,27155,10124,11878,10714
83648,95,272,51399,32249,5.87169e+18,191.416,3011.18,83648,136,141,82314,81003,33941,36200,32597
31706,23,165,19516,12190,5.86972e+18,115.642,1634.02,31706,79,84,25710,19354,4893,5766,5977
63576,89,234,39218,24358,5.86973e+18,120.869,2491.67,63576,95,103,63030,62543,29287,29819,36639
42245,122,290,26513,15732,5.89307e+18,230.579,2797.49,42245,180,183,40197,37365,17509,17562,15896
8561,98,178,5267,3294,5.86988e+18,75.0041,939.94,8561,68,70,8383,8322,6679,6420,6308
34333,368,426,21642,12691,5.89641e+18,209.576,2871.22,34333,172,178,33907,33865,29611,31013,26849
77140,17,381,47732,29408,5.87101e+18,172.551,3346.86,77140,132,135,54380,35937,8641,14436,5636
36568,77,262,22924,13644,5.89203e+18,215.757,2483.56,36568,173,168,32736,28472,9976,12441,12231
64668,47,272,40051,24617,5.87194e+18,201.664,2676.32,64668,134,132,61315,58731,12264,18687,15634
86140,222,228,53114,33026,5.86995e+18,142.809,2973.45,86140,98,101,85912,85912,85910,85910,85912
95095,195,283,58869,36226,5.8716e+18,191.993,3276.51,95095,142,144,94676,94244,68646,77032,71011
85010,289,325,52669,32341,5.87747e+18,215.83,3797.94,85010,175,184,84685,84629,74809,80381,74866
30846,315,426,19136,11710,5.87466e+18,144.852,2659.19,30846,125,117,30420,30403,29410,29410,27664
61380,220,296,37788,23592,5.87044e+18,168.71,2651.49,61380,117,121,61083,60990,48671,54349,44461
70544,212,285,43979,26565,5.88053e+18,231.251,3314.02,70544,185,174,70124,69713,56522,61737,58257
32127,85,157,19823,12304,5.87066e+18,92.4817,1708.97,32127,76,82,31883,31774,18473,17270,20649
44951,156,270,28068,16883,5.88316e+18,212.655,2656.54,44951,173,163,44100,43183,28437,26765,29382
32622,104,261,20052,12570,5.87148e+18,132.629,1895.39,32622,101,106,32092,31663,18526,18438,20899
81824,126,335,51189,30635,5.88683e+18,202.057,4006.57,81824,192,198,79188,75562,43325,42816,34566
39470,207,257,24356,15114,5.87035e+18,136.494,2264.54,39470,98,99,39195,39092,35606,37590,37922
23751,168,261,14887,8864,5.88875e+18,191.863,1977.68,23751,146,143,23307,22837,16622,17208,17943
49181,121,273,30586,18595,5.8771e+18,192.428,2619.41,49181,154,150,47912,46318,23412,22235,25355
98697,138,317,60842,37855,5.87302e+18,204.792,3690.62,98697,152,158,97634,96740,58312,57045,59123
98628,130,277,61288,37340,5.87663e+18,242.031,3718.42,98628,187,185,96695,94335,48056,44488,48761
21548,127,243,13350,8198,5.87293e+18,160.194,1554.45,21548,102,97,21112,20681,12908,12751,12734
10559,57,118,6534,4025,5.86866e+18,56.6256,901.074,10559,64,65,10407,10184,7407,7506,7336
57651,16,184,35603,22048,5.87016e+18,120.851,2365.27,57651,85,91,39197,25400,6586,8895,5051
12472,10,267,7837,4635,5.88678e+18,114.377,1469.18,12472,116,106,5311,2931,703,1135,454
56125,83,253,34576,21549,5.87025e+18,118.771,2413.35,56125,95,99,55550,55104,27748,31042,30807
8658,16,127,5334,3324,5.87131e+18,65.0173,827.704,8658,62,61,5940,3893,1290,1669,1101
37704,110,197,23211,14493,5.87027e+18,117.262,1931.1,37704,85,85,37466,37310,28592,29411,30378
50647,239,257,31220,19427,5.87003e+18,125.456,2313.68,50647,98,100,50390,50382,48474,49526,48328
85161,291,327,52632,32529,5.87035e+18,180.098,3362.31,85161,111,109,84834,84787,84528,84679,84659
26627,11,218,16389,10238,5.86951e+18,122.482,1568.37,26627,82,89,15261,9922,2945,2976,2398
25942,132,163,15942,10000,5.86985e+18,112.068,1460.35,25942,73,84,25779,25690,23077,24580,25135
54357,17,306,33719,20638,5.87443e+18,211.582,2829.99,54357,140,148,38091,25410,6109,10295,3381
94851,96,244,58431,36420,5.86995e+18,141.689,3113.56,94851,102,106,94271,93738,47492,45021,51954
62644,8,316,38660,23984,5.87339e+18,161.939,3024.14,62644,125,129,27060,0,4140,4669,1980
27499,121,175,16904,10595,5.87015e+18,117.7,1510.56,27499,78,84,27297,27160,20637,21080,23304
6001,100,112,3699,2302,5.86878e+18,55.0108,680.632,6001,57,59,5889,5889,5646,5788,5748
99755,96,285,62239,37516,5.88198e+18,242.6,3985.96,99755,208,195,94924,89285,36546,38725,35377
74571,130,281,45995,28576,5.87294e+18,215.567,3078.72,74571,150,161,73457,72375,38702,38891,40699
79497,13,215,48986,30511,5.86997e+18,137.547,2846.55,79497,93,98,48086,28141,8681,8994,7062
64400,174,214,39694,24706,5.8702e+18,131.586,2543.92,64400,94,97,64186,64118,59705,61724,63216
32884,76,158,20303,12581,5.87033e+18,92.9339,1732.52,32884,79,81,32598,32444,16643,15455,17518
40818,74,183,25227,15591,5.86983e+18,114.756,1890.81,40818,83,90,40309,40001,17895,18019,20673
40338,172,265,24936,15402,5.8753e+18,189.99,2295.24,40338,140,138,39857,39397,28039,27673,30408
19716,75,179,12155,7561,5.86983e+18,82.3225,1349.8,19716,77,77,19451,19329,14707,14819,14731
87776,80,225,54194,33582,5.87032e+18,147.399,3116.82,87776,94,93,87220,86994,41533,40439,46223
86273,140,288,53190,33083,5.87002e+18,140.517,3084.52,86273,107,108,85937,85664,52160,47464,46730
57582,144,314,35554,22028,5.87214e+18,143.053,2853.64,57582,118,117,57123,56832,47695,50562,51513
15525,145,173,9548,5977,5.86925e+18,107.242,1151.06,15525,73,72,15352,15314,14786,15126,15218
48302,72,295,30507,17795,5.90126e+18,211.806,2926.24,48302,188,185,40156,30541,10345,13328,13423
60772,3,270,37643,23129,5.87255e+18,191.666,2648.76,60772,137,134,10657,0,3,645,685
1832,50,62,1142,690,5.87098e+18,46.4138,291.442,1832,42,44,1763,1721,1407,1413,1662
74155,39,279,45841,28314,5.87011e+18,152.753,3042.66,74155,108,107,68054,61144,15908,22610,18499
76656,51,298,47298,29358,5.87055e+18,167.402,3045.1,76656,119,124,73862,70956,16135,26300,20559
17925,45,163,11029,6896,5.87082e+18,104.665,1241.41,17925,71,78,17166,16445,4907,6677,7157
15084,72,178,9332,5752,5.87031e+18,82.0578,1286.97,15084,78,79,14849,14623,9779,9903,9548
64088,38,314,39578,24510,5.87203e+18,202.843,2992.9,64088,127,121,58449,52728,10543,17728,12352
74240,138,259,45768,28472,5.87022e+18,146.629,2802.02,74240,100,107,73918,73699,51092,54144,57370
8422,172,234,5191,3231,5.87412e+18,123.073,1014.38,8422,80,78,8188,8091,7726,7821,7802
69689,52,222,43074,26615,5.87013e+18,127.136,2766.66,69689,90,90,67607,63752,20541,25823,26847
10067,118,129,6236,3831,5.86807e+18,66.3644,884.877,10067,65,64,9938,9924,9597,9832,9705
18920,123,147,11667,7253,5.86992e+18,89.5809,1254.8,18920,70,73,18773,18728,17312,17912,18002
8945,42,247,5564,3381,5.88368e+18,99.147,1181.77,8945,91,86,7643,6350,3100,3432,3195
33123,26,173,20432,12691,5.86981e+18,103.464,1721.54,33123,79,84,27740,21084,5733,7253,7350
83421,253,262,51592,31829,5.8701e+18,162.24,3224.83,83421,107,112,83159,83157,83149,83153,83159
65962,159,291,40615,25347,5.87067e+18,154.777,2765,65962,116,119,65546,65278,41021,38977,40898
62902,78,268,38943,23959,5.87194e+18,203.267,2648.11,62902,127,138,61318,60037,16763,24855,26213
30074,28,260,18611,11463,5.87052e+18,147.334,2015.93,30074,99,96,24062,16838,5073,6976,4453
33068,17,176,20376,12692,5.87046e+18,103.027,1795.8,33068,79,80,22652,14048,4527,5243,3173
99510,132,288,61390,38120,5.87022e+18,150.26,3286.17,99510,107,110,99112,98788,62333,62458,76488
9652,6,136,5945,3707,5.86926e+18,63.6127,810.621,9652,63,65,3215,0,355,391,170
27489,107,240,16911,10578,5.87032e+18,160.965,1664.54,27489,93,97,27083,26708,14158,14074,14931
26916,94,153,16627,10289,5.87043e+18,81.955,1565.4,26916,74,78,26740,26687,17880,16705,18162
56381,114,274,34801,21580,5.87408e+18,215.616,2695.46,56381,151,145,55110,53694,27094,27297,30178
1505,5,78,916,589,5.87264e+18,34.5116,289.495,1505,39,39,457,0,10,130,98
95500,199,320,58798,36702,5.87249e+18,235.528,3587.52,95500,146,146,95076,94766,72762,81542,67560
21426,181,298,13241,8185,5.87916e+18,176.537,1834.49,21426,122,117,21046,20831,13711,12574,11165
7370,69,75,4570,2800,5.8681e+18,70.1588,649.047,7370,62,64,7285,7187,6718,6931,7234
36157,25,411,22504,13653,5.88565e+18,213.223,2897.64,36157,162,165,25530,17011,3733,7253,1851
41161,187,199,25423,15738,5.86983e+18,112.234,2125.18,41161,83,89,40962,40962,40559,40788,40343
69564,253,274,43060,26504,5.87072e+18,159.533,2691.79,69564,113,123,69290,69285,63662,66550,66428
55073,179,199,33981,21092,5.87036e+18,93.8729,2381.98,55073,84,90,54874,54866,52503,53818,53068
11239,175,231,7087,4152,5.89756e+18,183.063,1354.36,11239,126,115,10946,10715,8497,8809,9402
54662,44,272,33836,20826,5.88175e+18,195.17,2881.93,54662,174,159,47746,41409,8948,14280,10400
54525,82,368,33734,20791,5.87131e+18,179.387,2689.44,54525,114,128,53298,52275,12190,19426,14101
25394,22,247,15707,9687,5.87029e+18,147.084,1858.82,25394,97,94,18331,12696,3858,5210,3977
37241,7,394,23463,13778,5.89612e+18,207.737,2837.59,37241,178,179,11568,0,1089,2028,161
56156,188,215,34674,21482,5.87034e+18,133.913,2391.87,56156,87,91,55941,55932,51615,54187,52979
40030,137,262,25258,14772,5.89817e+18,213.639,2621.9,40030,184,178,38535,36342,22232,19457,25011
24728,32,174,15319,9409,5.86996e+18,74.1427,1571.74,24728,79,77,21269,16040,6995,7988,8064
31796,32,173,19684,12112,5.86983e+18,97.0776,1762.2,31796,78,79,27538,21093,7548,9887,8689
25159,61,164,15565,9594,5.86973e+18,80.1534,1536.33,25159,74,76,24801,24384,12026,11647,12128
31337,72,179,19258,12079,5.86996e+18,116.589,1621.89,31337,80,87,30864,30561,14321,15388,18735
6505,81,82,4020,2485,5.86977e+18,73.3912,634.863,6505,63,67,6422,6412,6382,6388,6422
9419,199,214,5818,3601,5.8718e+18,91.739,978.281,9419,72,75,9205,9204,9044,9087,9191
54189,216,274,33457,20732,5.87431e+18,211.59,2676.08,54189,139,148,53827,53584,45366,48941,44418
16232,201,259,10187,6045,5.89078e+18,156.348,1708.31,16232,129,131,15962,15876,13424,13560,12992
37949,26,217,23491,14458,5.87011e+18,126.324,2082.02,37949,87,84,30316,21503,6366,9961,6569
71510,37,198,44165,27345,5.87001e+18,127.486,2694.74,71510,88,94,65828,58802,14006,22144,19024
59236,32,266,36470,22766,5.87119e+18,189.986,2501.19,59236,118,126,52771,45427,9002,15304,11614
71998,154,211,44472,27526,5.8703e+18,121.152,2780.36,71998,88,89,71787,71680,60744,65374,63704
49475,10,273,30706,18769,5.87461e+18,204.945,2520.82,49475,144,138,26815,18607,3985,6227,2464
61982,23,270,38403,23579,5.87299e+18,195.614,2716.23,61982,137,134,50210,39078,6966,14383,5808
12514,39,126,7704,4810,5.87075e+18,60.7496,1008.25,12514,66,65,11724,10612,4368,4966,4726
39753,7,175,24553,15200,5.87009e+18,80.8714,2003.76,39753,83,82,15012,0,1801,2013,2669
19206,163,183,11856,7350,5.86913e+18,76.8291,1327.59,19206,78,77,19023,19009,18534,18829,18719
69814,273,342,43018,26796,5.87049e+18,142.663,3020.71,69814,114,112,69472,69373,61417,66058,64022
41111,125,267,25818,15293,5.8943e+18,214.679,2673.33,41111,186,174,39289,36706,20772,19868,23144
4596,76,115,2835,1761,5.86617e+18,63.7663,582.479,4596,53,56,4470,4440,3247,3167,3299
87543,87,314,54013,33530,5.8721e+18,202.179,3457.45,87543,142,138,85882,84271,33765,37740,43430
8091,71,80,4977,3114,5.8691e+18,69.7627,697.797,8091,66,69,8000,7926,7504,7766,7963
20451,272,288,12622,7829,5.87171e+18,87.5991,1568.49,20451,85,86,20163,20161,20048,20080,20095
23143,77,179,14342,8801,5.87002e+18,78.0495,1425.57,23143,76,75,22904,22791,19089,19040,19361
93983,155,270,58192,35791,5.87011e+18,233.94,3695.36,93983,148,152,92921,91575,63393,52922,67942
32817,2,257,20267,12550,5.87069e+18,126.038,2085.28,32817,95,96,2935,0,289,0,247
8105,40,156,4989,3116,5.8681e+18,70.533,880.263,8105,64,66,7574,6947,2314,3045,3095
55412,248,259,34282,21130,5.87009e+18,138.032,2651.06,55412,101,101,55153,55143,55147,55149,55153
95854,80,271,59274,36580,5.87013e+18,193.683,3546.91,95854,120,121,94497,93673,41359,39850,47159
73386,236,381,45427,27959,5.87077e+18,171.685,3142.53,73386,124,133,72994,72880,49802,43854,48302
57321,9,226,35364,21957,5.86992e+18,130.481,2383.06,57321,91,96,27868,0,4922,5018,3532
97988,273,309,60315,37673,5.87125e+18,226.678,3444.13,97988,132,139,97679,97583,95623,96862,96396
14627,72,213,9043,5584,5.8717e+18,90.1812,1157.17,14627,75,72,14283,14077,5177,5905,3385
53095,133,226,32836,20259,5.87038e+18,139.527,2185.16,53095,96,103,52796,52567,35944,35579,43300
26086,69,255,16053,10033,5.87205e+18,140.74,1715.06,26086,97,100,25267,24669,9978,11243,11709
43316,193,226,26652,16664,5.8698e+18,128.439,1982.84,43316,92,100,43090,43046,37938,40944,41558
17891,211,258,11148,6743,5.87982e+18,183.789,1620.81,17891,112,118,17611,17471,14816,15880,15387
51194,154,254,31507,19687,5.87065e+18,123.101,2313.48,51194,93,103,50932,50834,35776,31508,32737
91188,281,314,56228,34960,5.8722e+18,173.121,3512.57,91188,142,137,90874,90805,84535,88006,85062
25633,110,154,15870,9763,5.86994e+18,91.5106,1515.47,25633,75,75,25473,25437,22956,23512,23613
67985,9,273,42188,25797,5.8741e+18,227.031,2937.13,67985,153,154,34163,0,5299,7731,2789
78694,119,218,48473,30221,5.87012e+18,129.562,2799.46,78694,95,103,78387,78075,53206,50201,62739
2488,98,113,1524,964,5.8632e+18,53.4847,412.489,2488,44,47,2375,2369,2232,2311,2251
47994,51,267,29754,18240,5.87337e+18,207.934,2401.82,47994,131,134,45151,43357,9404,15293,10409
48664,41,312,30070,18594,5.87084e+18,130.597,2395.61,48664,88,100,45810,41791,10174,15978,14348
52866,103,226,32526,20340,5.86989e+18,133.014,2176.73,52866,94,102,52443,52037,28848,29101,31963
32082,16,159,19840,12242,5.87006e+18,91.4862,1704.49,32082,77,79,21238,13250,3787,5279,3775
53174,102,185,32852,20322,5.87033e+18,112.163,2289.21,53174,84,87,52928,52832,35623,34073,38636
84800,189,262,52282,32518,5.87002e+18,144.897,2984.63,84800,103,109,84538,84420,72177,78154,79302
73236,231,273,44998,28238,5.87155e+18,156.338,2763.93,73236,118,125,72963,72915,61072,68005,63627
85682,108,280,52778,32904,5.87029e+18,158.714,3021.4,85682,121,127,84879,84044,41398,43157,44990
35833,133,273,22274,13559,5.87549e+18,182.701,2206.18,35833,129,127,35162,34608,21536,21344,22923
59788,8,199,36861,22927,5.8699e+18,127.249,2477.67,59788,86,87,25491,0,3821,4018,2898
78028,219,260,48087,29941,5.87006e+18,129.7,2895.32,78028,97,106,77768,77705,68171,73611,75688
15193,33,212,9347,5846,5.87047e+18,92.2201,1196.03,15193,74,78,13636,11618,3515,4855,4822
16478,31,145,10166,6312,5.87072e+18,83.1994,1188.74,16478,70,72,14507,11791,3565,5188,4887
29205,48,273,18145,11060,5.87524e+18,165.923,2025.1,29205,119,120,26878,24827,6824,9849,8626
9544,51,210,5858,3686,5.87082e+18,92.017,963.7,9544,70,73,9093,8836,2249,3417,3144
89568,144,397,55477,34091,5.87292e+18,199.585,3940.68,89568,154,164,88520,87665,56290,54793,52775
71215,77,327,44172,27043,5.87666e+18,175.579,3495.01,71215,151,157,68444,65739,26616,29425,30539
41430,150,195,25578,15852,5.86991e+18,105.231,2017.03,41430,84,85,41235,41160,36435,38358,37508
92860,43,381,57419,35441,5.8709e+18,169.388,3568.41,92860,126,135,87480,80839,15397,24060,13958
70156,212,257,43370,26786,5.8702e+18,188.818,2920.85,70156,101,101,69873,69747,57962,64838,61631
80495,119,381,49794,30701,5.87097e+18,169.693,3460.61,80495,131,130,79609,78795,42839,43708,43948
97887,64,282,60342,37545,5.87258e+18,214.075,3442.33,97887,154,161,94258,91284,21484,34941,28113
50743,239,272,31403,19340,5.87725e+18,189.98,2658.94,50743,154,153,50465,50406,44800,48159,47944
75170,48,276,46361,28809,5.87275e+18,202.941,3059.3,75170,149,155,70589,66737,14389,24783,17645
81001,132,271,50495,30506,5.88526e+18,222.755,3628.47,81001,202,193,78676,75607,40567,38922,46333
57407,68,3079,36231,21176,5.85881e+18,221.501,6289.01,57407,249,209,44432,33074,8451,14273,342
6743,28,75,4147,2596,5.86865e+18,64.7798,621.593,6743,60,62,5538,4031,2097,2440,3213
80654,112,381,49878,30776,5.87064e+18,176.856,3488.25,80654,126,127,79730,78975,43250,42438,44028
93640,195,308,57646,35994,5.87313e+18,205.708,3513.13,93640,156,156,93144,92675,63216,57400,55438
24594,141,248,15241,9353,5.87177e+18,126.025,1639.94,24594,96,93,24284,24175,15322,13816,12725
93426,153,303,57606,35820,5.87079e+18,171.829,3301.31,93426,123,126,92931,92605,66436,68592,73735
99997,217,285,62228,37769,5.87803e+18,238.171,3857.89,99997,188,197,99512,98994,80427,86925,79805
38939,114,173,24026,14913,5.87015e+18,106.447,1881.71,38939,81,86,38730,38570,28599,26614,32471
94141,280,317,58121,36020,5.87261e+18,196.828,3624.14,94141,145,150,93824,93748,86442,90534,87458
2811,125,126,1736,1075,5.86799e+18,54.2263,470.838,2811,47,45,2685,2684,2681,2681,2685
70249,283,426,43921,26328,5.8855e+18,210.33,4180.35,70249,185,195,69823,69733,54431,55638,43207
80908,223,290,50673,30235,5.8903e+18,242.238,3787.53,80908,206,209,80511,80064,64971,68261,69986
86877,216,298,53567,33310,5.87085e+18,170.125,3215.42,86877,123,128,86547,86416,73158,79700,72729
7766,73,140,4776,2990,5.86824e+18,82.001,763.355,7766,60,63,7578,7472,4738,4731,5216
35744,77,160,22102,13642,5.86931e+18,91.5656,1810.26,35744,76,83,35466,35338,18767,17615,21801
34498,242,397,21399,13099,5.87435e+18,162.495,2676.46,34498,126,120,34101,33993,29143,28788,26159
88610,116,270,54837,33773,5.87009e+18,190.732,3434.28,88610,123,127,87708,86931,51579,48287,54398
13302,114,149,8162,5140,5.87022e+18,82.4883,1016.13,13302,66,72,13153,13088,10956,11777,12110
11822,8,126,7272,4550,5.86957e+18,59.8367,977.332,11822,65,65,5027,0,712,1122,775
22351,129,272,14106,8245,5.89926e+18,205.471,1989.58,22351,161,152,21198,19581,11503,10322,14303
54180,11,266,33350,20830,5.87049e+18,160.57,2391.28,54180,110,117,31260,20286,5876,6060,3390
14940,20,251,9240,5700,5.88066e+18,146.626,1464.86,14940,108,106,10796,7693,1664,3089,1931
4259,169,227,2642,1617,5.87247e+18,77.3304,754.887,4259,64,66,4032,3989,3710,3780,3659
16801,24,171,10396,6405,5.86989e+18,103.743,1186.66,16801,72,76,14028,10804,2914,4454,3560
62243,40,288,38419,23824,5.87017e+18,145.652,2650.34,62243,101,104,58331,53259,11177,17909,14759
13158,144,217,8088,5070,5.86939e+18,90.459,1135.32,13158,71,74,12941,12858,11310,11545,11648
36384,186,193,22485,13899,5.87036e+18,113.396,1880.94,36384,79,82,36191,36165,35776,35994,35819
23649,43,191,14576,9073,5.86945e+18,99.0782,1507.95,23649,78,79,22297,20331,7358,8434,6483
20546,88,246,12904,7642,5.89038e+18,179.722,1815.22,20546,141,139,18780,16685,8092,7894,8666
93626,14,230,57662,35964,5.87031e+18,141.242,3078.65,93626,98,107,59430,34879,10218,13297,8261
77194,23,259,47449,29745,5.87088e+18,143.055,2816.25,77194,108,114,62737,47903,8566,17609,9987
74523,63,215,45968,28555,5.87016e+18,132.565,2777.17,74523,91,96,73527,72570,27007,30574,30404
28512,179,197,17605,10907,5.86975e+18,107.662,1812.84,28512,84,83,28315,28296,28033,28211,27811
56680,210,304,34953,21727,5.87472e+18,210.447,2870.05,56680,146,147,56287,55989,40462,43980,38860
45034,63,197,27709,17325,5.87017e+18,123.218,2096.12,45034,84,89,44333,43745,17840,19247,20537
38504,112,197,23689,14815,5.87006e+18,120.264,1950.57,38504,86,87,38268,38107,29353,31184,30638
22420,187,231,13797,8623,5.86957e+18,102.294,1438.68,22420,82,87,22189,22177,19292,20973,20657
56917,102,258,35062,21855,5.8705e+18,130.59,2456.03,56917,95,100,56498,56135,32482,34156,36408
84829,277,278,52150,32679,5.87141e+18,145.755,3062.38,84829,114,124,84551,84551,84551,84551,84549
71015,7,273,43935,27080,5.87094e+18,160.421,2716.71,71015,115,127,29257,0,3999,5272,2497
81349,281,327,50440,30909,5.87721e+18,191.304,3738.89,81349,168,178,81022,80951,73548,76344,72409
87299,181,288,53874,33425,5.86998e+18,151.271,3111.76,87299,102,109,87000,86855,67878,69363,77200
71893,242,303,44363,27530,5.8711e+18,167.893,2968.1,71893,113,119,71586,71481,65619,68919,65604
75548,137,352,46539,29009,5.87057e+18,175.396,3143.98,75548,113,118,74996,74551,39964,37427,44563
69118,231,253,42468,26650,5.87078e+18,150.117,2601.34,69118,108,114,68865,68865,63316,66058,66387
27790,363,397,17203,10587,5.87167e+18,137.393,2206.69,27790,102,103,27393,27391,27363,27388,27316
96509,80,280,59440,37069,5.87044e+18,170.257,3204.69,96509,129,133,94959,93681,26455,38045,38691
31186,44,204,19286,11900,5.86962e+18,100.637,1884.82,31186,84,84,29186,26299,10279,12069,11768
33363,199,221,20506,12857,5.87093e+18,123.782,1752.32,33363,85,95,33142,33119,30386,31619,32752
20592,2981,5637,12905,7687,5.557e+18,931.838,8611.85,20592,263,274,14955,14885,13656,13657,13419
17486,107,251,10833,6653,5.87795e+18,155.312,1557.37,17486,115,106,16788,16119,9397,9362,10506
88749,23,274,54771,33978,5.87358e+18,233.168,3349.71,88749,166,164,71023,54985,10968,20112,6026
38332,69,285,23895,14437,5.88063e+18,184.747,2493.52,38332,149,147,35569,32847,10874,14302,13596
88843,182,323,55594,33249,5.88733e+18,205.817,4084.46,88843,199,206,88009,86826,59262,56170,50902
95725,258,328,59376,36349,5.87665e+18,220.617,3987.7,95725,175,176,95393,95236,87425,89475,85674
8433,111,261,5243,3190,5.88377e+18,97.6545,1233.35,8433,98,92,7957,7492,5846,5923,5072
34392,11,197,21257,13135,5.87019e+18,102.47,1968.41,34392,84,83,17637,11100,3066,3903,3208
12070,148,149,7478,4592,5.86939e+18,78.6645,971.387,12070,65,69,11921,11919,11854,11865,11920
21117,85,154,13089,8028,5.86983e+18,97.8761,1356.73,21117,74,75,20932,20904,13733,12629,12670
3498,22,109,2155,1343,5.86618e+18,54.4969,492.075,3498,49,49,2882,2317,761,1130,1019
2101,34,86,1282,819,5.86792e+18,39.3384,341.13,2101,44,43,1921,1675,801,823,643
26581,152,259,16484,10097,5.87001e+18,136.253,1887.77,26581,92,98,26241,26012,20116,18701,21980
85671,102,260,52781,32890,5.87043e+18,145.844,2994.68,85671,105,109,85114,84556,46686,43690,56926
12919,125,238,8016,4903,5.87372e+18,130.58,1228.81,12919,88,86,12586,12311,7795,7563,6986
11804,186,201,7311,4493,5.87074e+18,84.6577,1071.62,11804,72,72,11603,11586,11084,11423,11363
94535,93,285,58245,36290,5.87033e+18,152.529,3210.58,94535,104,111,93850,93278,44049,45559,54918
25309,381,426,15807,9502,5.88409e+18,162.763,2599.49,25309,140,137,24883,24856,23990,24319,22513
89512,9,217,55283,34229,5.87008e+18,138.392,3049.2,89512,94,99,42165,0,6819,7227,4343
54979,65,247,33768,21211,5.87088e+18,154.982,2298.46,54979,106,111,53753,52866,12951,19362,18543
62089,78,272,38243,23846,5.87152e+18,204.298,2635.18,62089,131,130,60516,59301,16249,25303,24041
45893,90,307,28538,17355,5.88239e+18,167.357,2864.34,45893,160,162,43526,40803,23640,26487,21142
90547,247,286,55978,34569,5.87092e+18,149.708,3179.9,90547,115,127,90261,90240,78108,84982,83040
15838,157,230,9940,5898,5.89349e+18,175.284,1582.33,15838,140,126,15409,14937,11575,11705,12251
58122,56,316,35840,22282,5.87263e+18,146.549,2882.92,58122,122,118,55885,53690,17326,21679,19958
54985,106,290,34017,20968,5.87139e+18,162.465,2570.55,54985,112,121,54287,53672,27032,27968,26772
21256,124,160,13086,8170,5.87036e+18,74.4656,1386.73,21256,76,78,21096,21057,19475,20280,18783
96551,109,411,59799,36752,5.87379e+18,183.86,4294.64,96551,158,149,95040,93467,52831,48949,50108
57620,190,211,35615,22005,5.87016e+18,117.134,2480.46,57620,88,87,57409,57406,55997,56561,56949
62908,30,268,38669,24239,5.87148e+18,164.701,2570.04,62908,115,124,55410,47112,8059,15463,8291
82005,136,328,50865,31140,5.8771e+18,178.749,3735.23,82005,167,172,80829,79550,53588,57697,55463
7221,104,212,4438,2783,5.87366e+18,105.549,868.034,7221,70,71,6986,6840,4262,4109,3429
33207,134,163,20401,12806,5.87015e+18,116.621,1656.21,33207,81,87,33041,32959,28839,31258,31637
64420,228,271,39861,24559,5.87003e+18,198.274,2937.08,64420,110,114,64135,64024,58647,61890,62091
85534,87,278,53441,32093,5.88531e+18,217.393,3736.04,85534,200,194,79954,73374,28169,30862,32478
76752,123,280,47490,29262,5.88138e+18,232.804,3438.11,76752,189,179,74646,71873,36748,33962,38590
51250,149,266,31506,19744,5.87287e+18,187.867,2403.82,51250,125,122,50733,50419,31016,26492,29491
87425,182,234,53828,33597,5.87003e+18,129.462,2949.94,87425,99,107,87191,87138,80595,82798,83272
32316,226,307,20176,12140,5.88748e+18,208,2442.53,32316,163,161,31991,31861,24664,25738,23328
77482,245,260,47886,29596,5.87e+18,160.045,3121.88,77482,108,109,77222,77167,77186,77199,77036
63858,19,210,39480,24378,5.87002e+18,112.81,2624.36,63858,88,90,45249,29270,9307,12105,7499
40770,24,226,25226,15544,5.87024e+18,122.364,1923.67,40770,88,94,33805,25761,5770,9455,8281
56410,73,202,34852,21558,5.8703e+18,125.491,2421.17,56410,88,87,55980,55524,26680,25324,27880
20188,119,282,12676,7512,5.89422e+18,169.182,1966.88,20188,144,145,19091,17628,9754,10146,9664
43963,69,180,27126,16837,5.87026e+18,116.713,2083.84,43963,82,83,43514,43115,19721,19934,23895
60707,191,196,37480,23227,5.86996e+18,110.87,2508.36,60707,84,89,60511,60509,60419,60509,60310
20623,47,302,12729,7894,5.87172e+18,74.6991,1635.04,20623,85,86,19396,17902,7737,8102,6940
81994,159,342,50965,31029,5.88093e+18,177.889,3993.39,81994,171,181,81195,80283,58507,60914,60477
57208,136,271,35396,21812,5.87014e+18,175.192,2722.41,57208,100,102,56762,56360,33892,28810,22042
30754,80,257,18915,11839,5.87381e+18,157.007,1886.43,30754,114,114,29737,28921,9376,12117,13133
57226,27,272,35260,21966,5.87154e+18,204.384,2548.17,57226,128,128,48570,39103,7849,13226,6786
20721,6,241,12824,7897,5.87322e+18,157.012,1521.27,20721,100,97,7651,0,812,1598,627
68808,356,411,42612,26196,5.87975e+18,207.052,3801.33,68808,178,180,68397,68310,59524,63774,57526
80005,218,259,49296,30709,5.87027e+18,145.661,2895,80005,102,107,79746,79669,73364,76908,78169
70728,225,285,44100,26628,5.88175e+18,236.488,3343.74,70728,186,183,70372,70077,59444,63897,62510
16944,43,138,10421,6523,5.86922e+18,69.0333,1207.44,16944,69,69,16212,15004,6063,7069,6169
83407,7,328,51714,31693,5.87459e+18,195.75,3585.45,83407,152,144,32126,0,3986,6363,2493
58682,137,257,36266,22416,5.87033e+18,139.155,2717.33,58682,103,104,58251,57878,40902,37224,44754
30961,216,273,19210,11751,5.8749e+18,176.332,2048.15,30961,124,119,30684,30566,28799,29260,29242
87317,38,293,53805,33512,5.87036e+18,199.651,3106.89,87317,116,123,81123,74645,13827,22154,15982
78992,175,200,48814,30178,5.87001e+18,124.025,2857.29,78992,87,94,78792,78770,74376,76997,78008
21808,13,154,13474,8334,5.86948e+18,71.5985,1428.3,21808,75,75,12682,7365,2674,3211,2422
80837,24,273,50030,30807,5.87072e+18,173.352,2896.42,80837,122,130,67222,52017,9995,19401,11982
9671,115,126,5933,3738,5.87001e+18,68.5234,841.804,9671,60,64,9545,9545,9348,9496,9485
80659,249,294,49795,30864,5.87008e+18,163.396,2939.59,80659,110,113,80365,80348,78334,79519,79330
82127,188,298,50775,31352,5.87048e+18,202.355,3088.7,82127,115,126,81766,81558,67567,74676,69945
40196,12,264,24771,15425,5.87274e+18,196.631,2175.93,40196,121,121,24529,15455,4371,5259,2724
82478,163,303,50984,31494,5.87089e+18,153.489,3112.1,82478,116,126,82056,81801,49913,43522,46796
30155,55,152,18657,11498,5.87003e+18,69.5984,1662.82,30155,76,78,29542,28343,16164,16332,17663
89312,303,318,55376,33936,5.87886e+18,225.345,3856.68,89312,188,190,88994,88982,86355,87739,87428
61205,104,260,37684,23521,5.86996e+18,130.748,2536.25,61205,96,99,60779,60409,35420,35546,40397
28632,58,253,17726,10906,5.87081e+18,168.289,1779.54,28632,100,101,27524,26715,7505,10618,12069
91465,285,307,56936,34529,5.88379e+18,246.82,3981.86,91465,199,201,91158,91053,86709,88985,87956
85492,33,281,52994,32498,5.87304e+18,206.306,3252.11,85492,152,158,75410,63330,12516,22344,12743
56425,118,272,34828,21597,5.8741e+18,210.913,2711.87,56425,145,150,55276,54020,27157,27641,22865
57317,219,224,35254,22063,5.87005e+18,153.954,2296.16,57317,101,113,57093,57093,56929,57030,56960
58977,181,272,36394,22583,5.87378e+18,214.553,2771.84,58977,142,153,58453,57995,41682,39420,41285
20633,163,217,12784,7849,5.87017e+18,95.1393,1385.5,20633,79,85,20416,20384,16752,18664,16752
36740,419,426,22968,13772,5.88509e+18,183.42,3110.27,36740,159,157,36314,36301,36309,36309,35755
6446,54,76,3998,2448,5.86681e+18,61.7142,600.195,6446,59,62,6288,5983,4820,4660,5547
11941,26,125,7345,4596,5.86963e+18,59.5352,987.94,11941,66,63,9869,7288,3060,3780,3914
81767,109,307,51078,30689,5.88823e+18,228.73,3849.74,81767,193,206,77797,72843,34534,35411,35011
64971,4,269,39929,25042,5.87169e+18,160.075,2616.15,64971,114,120,15393,0,8,2395,773
57548,158,381,35625,21923,5.87108e+18,161.875,3008.98,57548,124,120,57005,56617,38958,39297,40995
65603,235,271,40598,25005,5.86998e+18,202.666,2970.26,65603,111,117,65318,65206,62263,64221,63386
25900,160,258,16042,9858,5.87683e+18,190.673,1880.23,25900,118,128,25425,25082,17896,16707,17905
90873,17,314,56054,34819,5.87167e+18,221.972,3465.13,90873,140,140,64362,42461,11382,14800,4393
16640,179,235,10500,6140,5.9018e+18,185.859,1657.95,16640,146,136,16327,16028,13484,13783,14719
77531,141,300,47891,29640,5.87088e+18,197.355,3046.26,77531,117,120,77008,76690,47609,43641,43901
20662,25,342,12717,7945,5.87043e+18,108.806,1693.95,20662,85,94,17080,13140,2294,4297,642
11250,96,162,6917,4333,5.87012e+18,89.76,954.167,11250,69,67,11068,10956,7719,7625,8312
7988,57,76,4948,3040,5.86846e+18,72.7616,679.919,7988,63,66,7801,7500,5495,5262,6609
26536,48,258,16406,10130,5.88151e+18,199.404,1933.48,26536,135,127,23550,20843,4864,8019,6271
79079,218,282,49027,30052,5.87358e+18,211.587,3144.4,79079,151,156,78727,78412,63320,71352,61028
44211,185,257,27289,16922,5.87034e+18,125.025,2186.14,44211,88,93,43954,43875,42532,43086,43024
59354,115,295,36681,22673,5.87042e+18,152.826,2655.88,59354,105,106,58870,58470,38055,35679,41582
67204,187,322,41672,25532,5.8793e+18,190.771,3410.69,67204,166,173,66620,66064,47393,44312,40954
93710,117,302,57878,35832,5.87068e+18,199.677,3332.04,93710,121,132,92937,92177,50546,48121,66309
87760,30,285,54575,33185,5.87763e+18,224.085,3573.93,87760,186,180,72591,59962,10883,21129,11514
14466,104,133,8891,5575,5.87038e+18,63.7142,1088.19,14466,67,66,14333,14327,12764,13474,12068
36515,40,158,22568,13947,5.86977e+18,90.367,1824.46,36515,79,79,34077,30594,10371,13606,13316
50588,220,273,31419,19169,5.87501e+18,219.15,2600.86,50588,135,143,50237,50023,42222,45975,43117
94291,131,322,58163,36128,5.87063e+18,203.122,3425.79,94291,125,131,93624,93050,47985,47788,45216
85855,142,271,53105,32750,5.86999e+18,201.351,3364.95,85855,119,120,85238,84546,53663,46564,61446
88387,36,235,54608,33779,5.87005e+18,153.632,3152.7,88387,97,95,79724,70105,17541,26881,20343
7952,110,155,4883,3069,5.86891e+18,85.2339,820.232,7952,62,63,7797,7765,5808,6101,5109
36360,103,274,22473,13887,5.87484e+18,212.109,2218.23,36360,127,128,35358,34447,17037,17451,19599
14148,7,182,8694,5454,5.87039e+18,88.3036,1172.92,14148,70,75,5616,0,736,1085,888
41540,252,262,25574,15966,5.87157e+18,170.809,2133.82,41540,107,114,41278,41275,40342,40662,40564
92014,56,316,56777,35237,5.87289e+18,190.646,3599.61,92014,148,148,88224,84844,23987,32344,27837
98756,238,289,60874,37882,5.87049e+18,146.808,3273.29,98756,104,112,98467,98430,89656,93601,96890
61477,55,225,37987,23490,5.87021e+18,133.844,2593.74,61477,90,88,59981,57391,17215,22158,21253
58591,184,259,36142,22449,5.87007e+18,135.728,2499.93,58591,95,97,58332,58216,53401,55539,56400
84337,132,328,52246,32091,5.8773e+18,191.259,3771.08,84337,167,176,82855,81227,48431,51019,46185
45440,157,275,28017,17423,5.87617e+18,219.164,2462.1,45440,137,139,44841,44366,30094,26898,31315
56815,268,275,35005,21810,5.87582e+18,213.657,2712.77,56815,149,145,56540,56510,55833,56219,56279
11135,200,260,7008,4127,5.89729e+18,159.841,1450.33,11135,122,119,10875,10830,8728,8868,8454
22581,186,279,13974,8607,5.87001e+18,131.592,1795.08,22581,92,94,22266,22116,18303,17986,19919
87881,228,294,55200,32681,5.89354e+18,234.642,3973.16,87881,214,205,87509,87186,72919,76115,78938
55735,23,223,34212,21523,5.87104e+18,137.434,2231.73,55735,98,103,45770,35367,6634,12832,8577
75550,58,307,47025,28525,5.88431e+18,240.431,3633.6,75550,194,188,67208,60071,15139,23641,16740
47908,226,274,29595,18313,5.87455e+18,222.761,2526.24,47908,145,140,47593,47391,40787,44236,44752
96978,162,352,59783,37195,5.87046e+18,170.024,3559.9,96978,120,118,96482,96108,62397,60396,69824
3758,29,74,2344,1414,5.86729e+18,60.5136,461.041,3758,54,56,3100,2267,1276,1368,1853
72442,70,220,44741,27701,5.86999e+18,129.314,2830.65,72442,92,94,71817,70834,32758,33508,35530
67975,135,294,41914,26061,5.87021e+18,163.703,2734.43,67975,103,108,67599,67306,41863,36801,39500
46048,266,287,28934,17114,5.89407e+18,222.947,2888.59,46048,187,181,45761,45681,43478,44540,44244
36072,147,381,22323,13749,5.87139e+18,156.638,2525.63,36072,116,112,35531,35181,25842,25897,26295
2331,21,119,1438,893,5.86668e+18,52.4839,400.212,2331,47,47,1816,1372,453,604,483
66287,272,381,40992,25295,5.87081e+18,149.756,3198.93,66287,124,118,65906,65799,59394,61536,58234
75905,49,271,46961,28944,5.86976e+18,196.677,3171.48,75905,114,119,71797,66451,16197,22908,21874
1684,62,96,1029,655,5.86492e+18,44.8219,327.344,1684,41,40,1588,1563,1276,1287,1315
58596,159,200,36097,22499,5.86982e+18,128.765,2408.14,58596,90,94,58396,58298,53825,55559,57160
61378,207,286,38079,23299,5.87962e+18,204.782,3087.91,61378,173,177,60944,60528,47376,49518,45196
53340,14,264,33036,20304,5.87192e+18,186.637,2437.63,53340,124,128,35654,22166,5863,9546,4178
92379,60,264,57002,35377,5.86996e+18,141.796,3113.07,92379,103,110,90790,89217,26306,35311,35580
94036,193,217,57972,36064,5.87017e+18,140.238,3089.99,94036,93,102,93819,93798,89582,91863,92932
52291,38,211,32187,20104,5.8702e+18,125.458,2279.46,52291,89,94,48671,44603,11344,16069,14560
49419,137,215,30480,18939,5.86985e+18,126.726,2287.36,49419,88,91,49194,49060,34707,35344,32310
17446,57,144,10765,6681,5.87057e+18,80.748,1206.36,17446,69,73,17152,16792,8985,9549,9654
46160,160,283,29043,17117,5.89474e+18,213.133,2888.54,46160,187,178,45274,44057,29100,29075,32633
64452,7,279,39812,24640,5.87029e+18,152.968,2807.66,64452,102,110,24726,0,3073,4357,2708
27773,191,253,17215,10558,5.87352e+18,163.157,1792.3,27773,111,110,27481,27322,22497,24639,23055
94810,215,315,58494,36316,5.87192e+18,199.655,3564.45,94810,142,143,94448,94191,84991,86720,86783
97622,231,232,60242,37380,5.87022e+18,146.837,3244.9,97622,95,101,97390,97374,97389,97390,97390
50650,108,275,31210,19440,5.87649e+18,218.517,2587.22,50650,141,140,49359,48006,22122,21360,22400
13040,203,214,8067,4973,5.87006e+18,91.5537,1114.21,13040,76,76,12826,12823,12435,12694,12698
84245,103,276,52227,32018,5.87316e+18,219.305,3215.91,84245,160,158,82549,80851,35753,35908,33138
7884,109,121,4844,3040,5.87171e+18,63.0657,774.116,7884,60,61,7763,7757,7738,7745,7738
22978,96,290,14190,8788,5.87253e+18,91.6838,1724.49,22978,86,88,22595,22416,17037,18076,15829
13455,7,165,8313,5142,5.87036e+18,82.573,1150.06,13455,69,74,5216,0,645,868,740
9561,18,80,5884,3677,5.86951e+18,69.5806,760.146,9561,68,71,6385,3777,1678,2137,2420
18894,56,172,11626,7268,5.87035e+18,106.571,1255.15,18894,74,77,18411,18021,7235,8184,9065
62709,91,237,38659,24050,5.86997e+18,116.008,2497.29,62709,93,104,62206,61759,30920,31116,38166
49655,160,215,30635,19020,5.8699e+18,135.442,2255.91,49655,87,91,49440,49368,39464,44205,38372
11555,143,234,7180,4375,5.88317e+18,146.256,1285.95,11555,106,102,11175,10947,7606,7354,7755
85143,86,303,52493,32650,5.87083e+18,208.426,3210.91,85143,121,125,83941,82936,28439,34676,38292
48272,247,397,29854,18418,5.87135e+18,138.403,2871.54,48272,114,107,47875,47819,47127,47103,46328
53758,187,268,33304,20454,5.87246e+18,208.59,2483.71,53758,124,130,53372,53088,38849,43975,38769
1203,53,85,743,460,5.87345e+18,33.4331,266.501,1203,36,37,1118,1091,862,916,886
83112,73,317,51383,31729,5.87288e+18,196.154,3462.73,83112,144,149,80727,78838,26489,33019,30158
2537,45,95,1557,980,5.86695e+18,42.8656,402.203,2537,43,46,2427,2389,1302,1304,1261
75767,229,260,46669,29098,5.87073e+18,133.188,2804.75,75767,99,104,75507,75462,68788,72692,73472
8783,11,158,5395,3388,5.86965e+18,67.4109,863.041,8783,61,60,4859,3080,989,726,194
70921,143,260,43733,27188,5.87011e+18,143.376,2739.22,70921,100,103,70614,70392,53227,55823,58495
50120,82,209,30895,19225,5.86978e+18,127.568,2228.55,50120,84,93,49654,49379,25841,25035,29391
93856,81,301,57828,36028,5.87089e+18,186.865,3299.35,93856,122,124,92541,91499,32906,38835,44575
34726,180,249,21334,13392,5.87102e+18,126.855,1907.13,34726,92,96,34477,34415,26736,29712,23471
9725,93,126,6025,3700,5.8675e+18,60.0843,888.039,9725,62,68,9599,9599,7912,7934,7614
30428,49,179,18701,11727,5.86945e+18,116.747,1601.1,30428,80,85,29479,28677,7526,11492,11997
45477,4076,5137,28656,16821,5.78512e+18,407.866,9306.39,45477,306,249,40340,40335,34954,35563,13750
21007,143,184,12972,8035,5.86981e+18,86.9862,1520.31,21007,77,79,20823,20797,19830,19646,19816
91965,119,316,56744,35221,5.87275e+18,191.305,3601.34,91965,147,150,90791,89457,52882,54371,58673
86634,28,306,53448,33186,5.87048e+18,151.23,3223.89,86634,120,125,73902,58481,12169,20208,10311
44888,26,177,27735,17153,5.87019e+18,101.77,2050.51,44888,82,89,37339,28154,7240,11341,9692
46490,191,261,29128,17362,5.88883e+18,226.491,2776.64,46490,181,173,46014,45446,36059,38505,37826
97266,224,309,59841,37425,5.8718e+18,227.87,3432.75,97266,130,137,96924,96706,80149,88858,79897
31807,247,257,19645,12162,5.86979e+18,125.193,2057.75,31807,95,94,31550,31531,31539,31549,30923
80854,178,256,49967,30887,5.87037e+18,164.085,3114.71,80854,100,100,80586,80413,73166,76569,77567
56661,78,265,35587,21074,5.89152e+18,214.452,3102.09,56661,196,184,50936,44307,15923,18967,19445
65835,273,276,40802,25033,5.87865e+18,231.857,3131.41,65835,180,175,65559,65559,65534,65534,65559
42670,89,173,26319,16351,5.86968e+18,101.817,1982.54,42670,80,88,42368,42159,24504,23830,27219
18555,90,145,11422,7133,5.87011e+18,68.6478,1178.29,18555,76,76,18410,18367,17897,17833,17828
40820,152,199,25181,15639,5.87017e+18,100.855,2033.49,40820,84,90,40621,40576,34842,37413,33635
98380,60,329,60942,37438,5.87343e+18,237.036,3790.32,98380,159,151,94702,91343,22623,32860,27515
53199,105,250,32853,20346,5.87023e+18,134.329,2590.23,53199,102,100,52687,52337,31545,28329,29837
37031,284,288,22810,14221,5.87125e+18,177.553,2088.9,37031,108,112,36743,36741,36406,36667,36705
79242,66,275,49070,30172,5.87185e+18,196.213,2994.01,79242,139,139,76725,74680,17124,28033,23218
14401,358,376,8935,5466,5.8733e+18,132.018,1709.58,14401,98,98,14025,14007,13913,13979,13843
30497,7,169,18854,11643,5.87089e+18,100.511,1682.69,30497,77,78,11562,0,1329,2393,781
25634,234,267,15932,9702,5.87739e+18,182.06,1918.29,25634,126,129,25367,25325,21929,23796,22229
20008,80,236,12307,7701,5.87037e+18,114.778,1393.23,20008,85,88,19553,19214,7621,8662,8465
78587,145,269,48371,30216,5.87091e+18,174.491,2849.17,78587,121,132,78054,77621,46987,43892,53308
91695,339,352,56526,35169,5.87034e+18,168.885,3439.05,91695,117,120,91343,91343,91335,91334,91284
71254,34,259,44052,27202,5.87022e+18,149.263,2966.22,71254,103,102,62697,49582,14392,19530,17011
67741,303,324,42029,25712,5.87895e+18,184.775,3447.86,67741,165,169,67417,67377,63893,65703,63579
38292,165,216,23681,14611,5.87009e+18,135.848,1858.67,38292,89,96,38059,37956,32227,34947,35712
38777,250,273,24062,14715,5.87557e+18,209.359,2273.55,38777,135,128,38504,38434,37766,38134,38377
76688,264,307,47588,29100,5.88033e+18,247.437,3552.44,76688,184,187,76369,76275,73553,74439,75426
15622,198,255,9612,6010,5.87297e+18,129.046,1383.25,15622,89,91,15362,15272,13456,14406,13231
90665,8,227,55960,34705,5.87004e+18,140.185,3099.16,90665,94,99,38888,0,5921,6466,3287
28656,43,306,17865,10791,5.88431e+18,157.463,2326.1,28656,143,143,23964,19499,6750,8550,6569
25536,121,147,15711,9825,5.86988e+18,79.3495,1498.76,25536,74,77,25389,25356,22915,24251,24104
44400,160,245,27409,16991,5.87043e+18,142.155,2188.55,44400,90,93,44155,44035,40989,41943,41398
17255,103,147,10647,6608,5.86883e+18,84.0168,1227.64,17255,71,74,17095,17043,13319,13920,14039
29995,73,248,18471,11524,5.87027e+18,119.921,1801.98,29995,90,92,29442,29043,12435,15555,14912
39226,37,309,24451,14775,5.88465e+18,215.45,2682.83,39226,162,170,31634,25165,6044,9705,4564
2269,29,81,1398,871,5.87333e+18,64.4513,374.35,2269,51,55,1825,1288,687,698,831
94478,369,426,58855,35623,5.88027e+18,183.173,4668.02,94478,182,189,94052,93988,88572,90138,85146
8054,26,260,5010,3044,5.87414e+18,88.2841,1083.64,8054,77,79,6148,4318,1520,2096,2112
78538,149,273,48588,29950,5.87078e+18,156.296,2859.42,78538,115,128,78085,77762,48134,43330,53900
8877,14,75,5453,3424,5.86883e+18,68.4837,710.842,8877,64,66,5288,2935,1271,1460,1820
38772,73,288,23899,14873,5.87107e+18,173.326,2184.33,38772,109,114,37706,36968,10403,15978,13143
10952,74,237,6760,4192,5.87359e+18,141.019,1153.17,10952,88,88,10379,9992,3368,4475,3981
62624,14,203,38599,24025,5.87008e+18,120.822,2508.17,62624,91,94,39413,23110,7196,7818,5827
7655,102,154,4715,2940,5.86969e+18,79.7348,768.457,7655,60,60,7498,7423,5808,5981,6329
42428,315,397,26325,16103,5.87417e+18,169.199,2930.16,42428,139,132,42031,41940,38931,39913,36352
3463,10,119,2142,1321,5.87103e+18,56.0352,492.036,3463,48,48,1993,1426,378,523,324
73620,16,267,45552,28068,5.87134e+18,189.445,2779.21,73620,125,130,52759,37231,8169,14494,4242
49070,75,202,30236,18834,5.87014e+18,99.6483,2260.28,49070,86,91,48647,48328,25667,26542,26804
47507,94,173,29285,18222,5.87018e+18,106.786,2081.25,47507,83,92,47200,46938,29059,27857,33620
28243,20,253,17458,10785,5.87512e+18,174.855,1887.05,28243,123,119,21494,16237,3222,6461,2681
85558,84,285,53261,32297,5.88005e+18,241.514,3623.5,85558,190,193,81124,76532,21405,31498,21626
14392,16,227,8875,5517,5.87027e+18,72.3513,1158.21,14392,78,80,9060,5321,2111,2119,2866
58070,221,302,35813,22257,5.8708e+18,157.633,2708.84,58070,105,114,57750,57639,50613,53542,51151
69749,122,255,43111,26638,5.8704e+18,149.173,2619.39,69749,109,114,69293,68787,36704,33905,38219
15159,75,253,9450,5709,5.88518e+18,196.482,1536.9,15159,119,119,13874,12679,4415,5593,5471
69411,145,232,42893,26518,5.86989e+18,157.467,2804.62,69411,94,94,69141,68913,53166,55141,56376
38670,109,197,23812,14858,5.86991e+18,114.185,1954.31,38670,83,84,38426,38276,28529,28793,29653
54981,234,266,33777,21204,5.87162e+18,189.514,2426.23,54981,116,124,54709,54632,49054,52194,51448
51621,174,312,32092,19529,5.88164e+18,191.251,3026.62,51621,165,167,50978,50276,34191,32120,29666
29013,108,219,17810,11203,5.87056e+18,123.509,1621.97,29013,86,90,28711,28478,18584,18743,21437
11883,34,175,7331,4552,5.86938e+18,86.0296,1000.96,11883,69,69,10882,9620,2576,3443,2378
67575,148,291,41608,25967,5.87074e+18,154.094,2797.79,67575,116,120,67125,66802,39821,38377,39788
89250,208,301,55004,34246,5.87082e+18,188.58,3236.74,89250,121,122,88904,88696,75345,79682,80094
35073,169,175,21691,13382,5.86987e+18,97.5548,1852.6,35073,82,82,34898,34865,34886,34765,34898
7789,3,224,4885,2904,5.88752e+18,146.323,1077.06,7789,98,94,1177,0,6,112,99
78864,57,262,48765,30099,5.87018e+18,161.426,3132.29,78864,107,108,76672,73308,21137,25757,18257
44301,113,226,27408,16893,5.87008e+18,127.691,2000.41,44301,89,97,43977,43671,26577,26361,35294
16051,81,235,10152,5899,5.89959e+18,183.123,1637.36,16051,142,135,13941,11464,5975,5504,6489
97313,3590,4793,61285,36028,5.85285e+18,302.436,10184.8,97313,313,248,92520,92517,76241,82597,16006
60638,111,237,37283,23355,5.87052e+18,119.805,2450.09,60638,91,102,60273,59930,33345,30978,45094
18366,30,242,11376,6990,5.87295e+18,135.314,1424.53,18366,96,94,15961,13891,2788,4962,3836
70404,130,241,43285,27119,5.8703e+18,124.169,2662.34,70404,97,108,70086,69844,46020,41978,54591
42278,64,262,26152,16126,5.87188e+18,167.667,2151.25,42278,108,117,40978,39959,10412,15476,15006
72829,63,307,45303,27526,5.88328e+18,235.033,3538.96,72829,193,182,65789,59155,14595,23409,18252
13742,98,264,8530,5212,5.88101e+18,132.866,1471,13742,107,106,13042,12414,6813,6980,5576
52390,10,274,32339,20051,5.87383e+18,205.308,2581.57,52390,141,140,28213,19341,5050,6225,3143
14018,206,210,8613,5405,5.8715e+18,94.8666,1159.43,14018,74,78,13808,13808,13734,13775,13808
62867,128,257,38858,24009,5.87057e+18,173.33,2736.46,62867,93,99,62459,62168,31350,27073,38707
64058,102,273,39675,24383,5.87082e+18,161.572,2594.91,64058,118,122,63277,62522,29415,30388,35098
29499,206,219,18249,11250,5.87005e+18,130.032,1653.17,29499,81,91,29280,29257,27975,28266,29272
19326,90,162,11879,7447,5.86894e+18,100.641,1280,19326,74,76,19097,18938,12197,11638,11909
65575,197,207,40471,25104,5.87014e+18,125.571,2655.24,65575,88,90,65368,65368,65314,65306,65368
73318,266,397,45422,27896,5.87217e+18,160.262,3560.89,73318,132,123,72921,72828,68497,68986,66007
2092,14,60,1281,811,5.86577e+18,53.9818,317.788,2092,42,46,1290,731,318,453,626
50545,265,307,31676,18869,5.88895e+18,170.886,3131.92,50545,173,176,50238,50191,45699,47271,45730
64952,114,262,40035,24917,5.87018e+18,134.08,2632.46,64952,98,101,64574,64210,41336,42419,46829
52660,173,200,32544,20116,5.86977e+18,115.125,2308.79,52660,87,86,52460,52455,52271,52338,52270
56012,45,412,35240,20772,5.89404e+18,233.996,3497.12,56012,193,198,43502,32182,7904,12325,2775
41189,290,305,25804,15385,5.89142e+18,187.615,2835.86,41189,167,176,40884,40862,40353,40532,38633
32506,105,243,20001,12505,5.8709e+18,161.07,1777.36,32506,96,96,32074,31698,16199,16806,18082
59694,26,259,36920,22774,5.87016e+18,136.141,2744.75,59694,101,101,47186,32984,10834,15087,11252
63244,46,264,38846,24398,5.87164e+18,180.985,2577.73,63244,124,125,60263,57848,12568,19240,17231
33585,35,256,20717,12868,5.8702e+18,108.62,1917.17,33585,85,84,30391,26084,7314,10021,7422
50335,208,411,31256,19079,5.88007e+18,193.369,3413.42,50335,159,164,49846,49585,37954,36527,32313
18854,50,144,11630,7224,5.86877e+18,87.6482,1248.96,18854,70,70,18361,17726,6934,7727,6566
52929,90,266,32606,20323,5.87183e+18,185.833,2435.98,52929,125,121,51840,50784,18910,22380,20115
70968,178,285,44163,26805,5.87876e+18,212.999,3265.45,70968,174,177,70291,69487,49380,49069,52312
45314,100,273,28126,17188,5.87438e+18,192.923,2427.99,45314,139,134,44098,42963,20248,20313,19966
18965,136,182,11721,7244,5.86958e+18,84.8563,1367.75,18965,74,77,18783,18727,15364,15963,14680
23509,1432,4019,14808,8701,5.76618e+18,270.265,6262.66,23509,240,189,19490,18885,7198,10050,2230
55024,208,260,33840,21184,5.87036e+18,123.996,2411.58,55024,93,101,54764,54736,45468,50760,45869
87111,203,273,54024,33087,5.87381e+18,229.405,3292.93,87111,165,163,86622,86079,67568,75322,70507
6909,19,212,4294,2615,5.8809e+18,138.621,956.72,6909,92,83,4720,3105,608,1405,583
58323,251,285,36338,21985,5.87997e+18,209.001,3022.9,58323,167,173,58027,57951,51188,54460,52012
42276,215,298,26080,16196,5.87146e+18,133.25,2321.95,42276,100,103,41965,41846,36944,38729,37387
12371,100,132,7650,4721,5.86943e+18,75.7829,979.676,12371,64,69,12232,12204,9978,10689,10493
82562,48,294,50962,31600,5.87011e+18,160.775,2983.35,82562,109,115,79621,76692,17456,26224,26127
42769,109,270,26467,16302,5.87032e+18,179.696,2453.24,42769,109,108,42022,41451,24648,22129,25970
2902,5,101,1793,1109,5.86614e+18,42.6396,433.257,2902,45,49,911,0,22,206,167
58041,237,269,35784,22257,5.87277e+18,202.575,2644.18,58041,141,138,57762,57656,51641,55009,54384
88650,228,282,54505,34145,5.87095e+18,155.503,3080.54,88650,119,130,88364,88295,74589,82546,77502
89731,126,426,55683,34048,5.8756e+18,189.875,4349.24,89731,157,158,88448,86890,53005,47358,49205
59031,86,215,36452,22579,5.87004e+18,131.692,2469.48,59031,88,93,58568,58293,25275,25203,23238
80340,2,259,49635,30705,5.87017e+18,144.081,3145.46,80340,105,106,7200,0,754,0,1058
49051,23,182,30277,18774,5.87003e+18,118.691,2184.45,49051,84,87,38984,28622,7149,9884,8993
95934,261,270,59307,36627,5.87024e+18,200.446,3472.4,95934,113,115,95664,95664,95648,95654,95608
43286,140,275,26700,16586,5.87731e+18,230.091,2460.33,43286,140,146,42518,41946,24459,21069,23086
55829,197,261,35000,20829,5.88933e+18,230.366,3039.24,55829,189,185,55335,54688,43540,46139,47219
62931,107,273,39055,23876,5.87419e+18,214.219,2837.05,62931,145,148,61533,60094,30094,29727,28525
26537,96,174,16327,10210,5.87025e+18,105.876,1473.31,26537,76,84,26283,26051,16915,15719,20478
25096,190,300,15755,9341,5.89361e+18,173.214,2272.2,25096,154,152,24740,24561,18200,18128,15757
28649,153,249,17627,11022,5.86983e+18,126.08,1693.82,28649,86,89,28400,28324,18905,16526,15811
13702,115,259,8535,5167,5.88409e+18,181.748,1503.19,13702,113,110,13014,12409,6745,6810,7629
75486,86,301,46566,28920,5.87103e+18,158.794,3009.03,75486,114,123,74454,73581,30417,34442,36750
87170,88,270,53962,33208,5.87022e+18,230.943,3509.76,87170,137,143,85225,83908,36033,30165,35764
69303,142,259,42753,26550,5.87031e+18,143.512,2708.74,69303,98,105,69000,68804,50867,52995,55676
64840,230,272,40030,24810,5.87431e+18,219.283,2884.92,64840,154,155,64516,64330,54811,60009,60175
40860,224,249,25122,15738,5.87072e+18,128.109,2059.13,40860,95,97,40611,40593,36512,38422,39835
14481,8,81,8973,5508,5.86958e+18,70.9157,920.681,14481,68,72,6068,0,703,1310,1495
88537,194,325,54870,33667,5.87768e+18,221.765,3891.26,88537,172,186,87910,87321,63572,59392,55974
53453,150,211,33057,20396,5.87005e+18,115.917,2408.41,53453,88,87,53242,53153,45419,48870,45142
37727,219,287,23249,14478,5.87165e+18,116.616,2141.99,37727,100,101,37440,37350,32920,35037,31048
47655,2,262,29336,18319,5.8713e+18,158.796,2262.86,47655,108,116,4386,0,504,0,263
7706,19,236,4862,2844,5.89908e+18,145.149,1157.32,7706,109,102,4081,1616,749,1117,785
79503,231,318,49320,30183,5.87917e+18,221.571,3686.54,79503,178,186,79113,78838,62866,68678,60716
98508,88,289,60758,37750,5.87032e+18,145.991,3271.58,98508,107,113,97714,97056,40079,44725,49575
20786,235,258,12886,7900,5.8781e+18,180.397,1718.16,20786,119,123,20528,20488,18801,19666,19448
95062,231,285,58603,36459,5.87006e+18,151.338,3220.71,95062,105,109,94777,94717,83298,90070,92493
41945,243,274,25930,16015,5.87531e+18,218.103,2384.96,41945,140,136,41665,41574,39644,40357,41128
88007,1339,13494,55583,32424,5.74689e+18,516.776,20138.1,88007,854,308,74309,70810,11518,27720,819
83958,96,280,51905,32053,5.86999e+18,206.344,3288.89,83958,108,113,83049,82438,34455,31803,36449
86316,182,271,53175,33141,5.87046e+18,148.894,3004.1,86316,106,112,86036,85908,74671,74816,80459
1620,19,103,1002,618,5.86585e+18,45.3086,322.099,1620,46,43,1179,792,362,505,566
7570,69,117,4707,2863,5.8703e+18,58.2351,716.472,7570,59,61,7451,7407,4637,4365,2960
64881,224,260,39957,24924,5.87008e+18,132.858,2612.99,64881,99,101,64621,64570,57687,61646,61452
39935,146,179,24614,15321,5.87029e+18,99.9935,1982.44,39935,81,82,39756,39699,36702,38125,36688
91396,81,281,56657,34739,5.87314e+18,208.256,3349.09,91396,154,160,88927,86720,23307,36056,33303
36537,34,196,22595,13942,5.87002e+18,110.837,1946.52,36537,83,83,32155,25283,7816,11028,9933
1143,2,67,699,444,5.85555e+18,47.0691,242.06,1143,38,39,98,0,6,0,13
94573,163,260,58252,36321,5.87034e+18,145.246,3132.1,94573,106,113,94284,94130,77788,73880,84433
57657,59,226,35662,21995,5.87065e+18,155.198,2304.16,57657,103,113,56306,55311,13792,21229,22641
82551,213,397,51135,31416,5.87325e+18,208.143,3749.54,82551,155,162,82026,81676,55148,51209,49400
34507,4550,7701,21650,12857,5.6307e+18,760.239,12016.2,34507,438,287,26806,26788,21218,21561,16530
1110,37,52,691,419,5.86125e+18,41.2342,216.679,1110,39,37,1015,908,761,761,917
78212,59,281,48618,29594,5.88239e+18,209.572,3506.92,78212,195,185,70532,64108,15432,25227,19854
89043,54,381,55167,33876,5.87299e+18,217.266,3539.07,89043,150,159,84532,81106,15743,27671,9905
38212,247,258,23774,14438,5.87735e+18,202.137,2267.43,38212,146,138,37954,37929,36259,37299,37343
4001,52,171,2468,1533,5.87261e+18,68.3329,619.365,4001,59,58,3732,3601,1906,2224,2247
2203,65,86,1355,848,5.86348e+18,38.1979,355.835,2203,43,44,2117,2117,1847,1949,1854
10760,847,2802,6740,4020,5.55944e+18,722.522,4581.59,10760,184,183,7813,6188,3536,3582,3588
48365,247,271,30069,18296,5.87655e+18,187.058,2574.94,48365,152,144,48094,48068,44244,46474,46800
98635,267,281,60818,37817,5.87269e+18,229.076,3487.35,98635,168,166,98354,98317,95961,97369,97680
14448,152,212,8883,5565,5.87129e+18,91.3974,1165.97,14448,75,82,14236,14188,11655,12494,10945
96021,260,272,59286,36735,5.87421e+18,236.249,3543.73,96021,174,179,95737,95663,89644,92436,94610
55339,175,426,34638,20701,5.88653e+18,191.735,3773.69,55339,175,182,54619,53880,34536,34251,28021
81239,214,217,50110,31129,5.87e+18,138.224,2873.78,81239,92,98,81022,81021,81020,81022,81022
55316,116,285,34471,20845,5.8813e+18,204.942,2968.61,55316,166,172,53524,51442,27592,28696,27554
61834,66,315,38219,23615,5.87301e+18,163.779,3007.06,61834,128,131,59902,58222,21418,24304,24454
32407,73,187,20002,12405,5.86948e+18,93.0549,1741.77,32407,83,84,32038,31781,21648,22026,22556
20480,34,253,12811,7669,5.88232e+18,196.158,1763.8,20480,138,127,16317,12728,2897,4859,3194
83884,3,306,51859,32025,5.87088e+18,154.39,3159.51,83884,115,125,14671,0,21,690,677
32907,187,261,20582,12325,5.88563e+18,216.57,2309.03,32907,156,157,32485,32068,24859,25378,25448
18229,124,248,11314,6915,5.87993e+18,176.715,1606.89,18229,120,118,17594,16907,9982,9852,11168
36613,164,187,22614,13999,5.87003e+18,89.12,1840.94,36613,83,84,36426,36399,33940,35260,34513
91357,228,281,56319,35038,5.87242e+18,222.764,3350.37,91357,161,164,91007,90738,78314,84743,83687
75011,14,220,46327,28684,5.86995e+18,144.411,2894.48,75011,93,94,45238,26094,8845,8737,7431
61838,182,288,38168,23670,5.87014e+18,146.198,2639.62,61838,100,104,61550,61458,45144,51336,40435
15350,125,155,9433,5917,5.86973e+18,99.0104,1131.53,15350,69,74,15195,15122,13934,14449,14735
3921,11,113,2418,1503,5.86769e+18,49.6302,530.975,3921,53,52,2173,1363,474,467,278
63225,172,269,38970,24255,5.87239e+18,193.487,2745.74,63225,140,138,62727,62263,43272,41431,41818
14582,131,135,8969,5613,5.87013e+18,78.3068,1062.29,14582,67,70,14447,14443,14396,14383,14447
21215,103,159,13023,8192,5.86998e+18,99.5131,1306.53,21215,73,79,21025,20887,16234,16252,17730
67183,256,270,41560,25623,5.87018e+18,226.587,3166.55,67183,142,148,66899,66837,66717,66699,65861
25908,111,174,16018,9890,5.87033e+18,82.1159,1625.67,25908,80,81,25734,25652,18824,17659,18393
11284,11,141,6987,4297,5.8707e+18,71.5961,965.614,11284,69,72,5840,3683,865,1457,947
25345,68,258,15650,9695,5.87958e+18,189.808,1870.73,25345,126,128,23687,22231,6991,10026,9648
5659,22,98,3474,2185,5.86732e+18,50.5337,618.671,5659,55,56,4497,3382,1167,1611,1236
36183,111,257,22485,13698,5.87725e+18,195.253,2198.49,36183,144,137,35044,33834,16770,15668,17336
11181,68,231,7060,4121,5.90088e+18,177.236,1359.9,11181,134,117,9359,7463,2980,3477,4026
63114,165,225,39005,24109,5.86994e+18,129.965,2646.69,63114,93,91,62889,62777,59392,60828,60753
35406,152,218,21792,13614,5.86937e+18,140.959,1799.05,35406,89,95,35154,35020,27534,28861,32304
10268,154,187,6374,3894,5.8702e+18,70.634,962.413,10268,74,75,10081,10053,9947,9959,9862
44459,214,265,27696,16763,5.88458e+18,217.109,2651.55,44459,178,170,44124,43808,36980,39106,39015
60722,226,231,37398,23324,5.86977e+18,134.046,2371.58,60722,97,105,60491,60491,60401,60423,60489
62247,50,270,38536,23711,5.8702e+18,181.902,2889.08,62247,119,119,58752,54026,16381,19615,18550
75663,112,209,46724,28939,5.87005e+18,125.445,2833.31,75663,90,92,75374,75188,49266,47593,56460
49999,186,195,30842,19157,5.87031e+18,116.184,2278.37,49999,83,84,49804,49800,49356,49656,49672
12299,151,208,7568,4731,5.86996e+18,83.7328,1081.87,12299,72,73,12091,12043,10531,11059,10057
24719,121,219,15298,9421,5.87032e+18,109.933,1504.87,24719,80,85,24461,24315,18152,17468,21382
60745,68,426,38162,22583,5.89213e+18,233.304,3828.85,60745,191,200,52785,44469,11594,17614,7737
50607,90,234,31185,19422,5.87011e+18,120.329,2211.34,50607,92,102,50116,49683,23401,23375,25762
23915,129,143,14821,9094,5.87072e+18,68.5411,1461.01,23915,75,75,23772,23772,23071,23437,22996
88767,144,280,54875,33892,5.87031e+18,208.5,3401.96,88767,112,120,88193,87501,52997,43847,58044
20323,241,247,12518,7805,5.87065e+18,93.3676,1492.85,20323,84,86,20076,20074,20018,20017,20027
49747,214,285,31015,18732,5.88191e+18,210.202,2833.66,49747,165,166,49403,49133,41786,43494,41681
2681,59,140,1660,1021,5.86791e+18,55.9754,509.292,2681,51,56,2517,2421,1518,1499,1322
47707,172,226,29520,18187,5.87008e+18,135.767,2075.26,47707,94,100,47469,47389,40665,43874,44632
22602,56,243,14008,8594,5.87383e+18,164.435,1608.15,22602,106,105,21297,20445,5146,7785,4670
80066,177,294,49438,30628,5.87004e+18,163.273,2935.24,80066,109,112,79756,79554,61611,66668,66973
64285,221,316,39607,24678,5.87246e+18,199.099,2986.12,64285,123,123,63969,63827,61230,61822,61124
46511,81,263,28825,17686,5.87324e+18,208.207,2350.48,46511,129,129,45087,43893,13513,17868,13307
66240,30,269,40998,25242,5.87093e+18,159.287,2630.38,66240,112,124,58104,49144,9318,16678,10346
39362,115,175,24317,15045,5.86982e+18,81.5106,1999.07,39362,83,84,39187,39118,31076,30246,30548
12699,11,249,7882,4817,5.8802e+18,142.99,1374.99,12699,107,108,6719,4104,1121,1520,837
16681,142,172,10312,6369,5.86991e+18,103.954,1183.1,16681,70,75,16509,16470,15525,16092,16231
36544,147,259,22644,13900,5.87028e+18,125.956,2186.34,36544,98,100,36192,35945,27331,24979,30082
90759,271,315,55972,34787,5.87319e+18,205.676,3516.74,90759,158,156,90444,90376,77221,84655,80940
77389,164,397,47948,29441,5.87355e+18,207.814,3625.79,77389,153,160,76564,75877,41600,41151,38902
24950,197,216,15434,9516,5.8701e+18,154.965,1539.02,24950,87,90,24734,24674,23110,24039,23632
95150,140,303,58764,36386,5.8707e+18,158.471,3328.54,95150,118,130,94605,94260,60778,60360,67163
18002,146,173,11096,6906,5.86949e+18,72.1459,1247.9,18002,77,78,17829,17804,17298,17565,17128
68663,251,285,42757,25906,5.88056e+18,228.121,3250.83,68663,181,174,68374,68243,62481,65138,66031
38516,22,327,23813,14703,5.87011e+18,156.676,2387.45,38516,103,101,28152,19787,5714,7766,5102
83373,272,282,51268,32105,5.87104e+18,154.878,2999.26,83373,117,127,83091,83089,82824,82990,82918
57243,66,217,35226,22017,5.8702e+18,133.985,2438.61,57243,89,95,56486,55879,18230,22068,23356
26767,206,397,16645,10122,5.8775e+18,196.368,2300.22,26767,130,136,26315,26120,15081,14613,10039
83682,72,263,51557,32125,5.87018e+18,131.939,3005.33,83682,98,108,82762,82018,25546,34021,38267
76416,72,270,47322,29094,5.87039e+18,243.167,3322.92,76416,137,141,73904,72070,23019,23623,26768
78344,13,285,48727,29617,5.87897e+18,225.253,3414.98,78344,182,185,47349,27554,7431,11016,4770
27638,89,153,17060,10578,5.86982e+18,89.7869,1572.03,27638,74,78,27429,27345,18440,17062,20150
48160,93,237,29725,18435,5.8699e+18,132.266,2253.94,48160,87,97,47764,47506,28799,27339,30733
35733,175,381,22126,13607,5.87159e+18,154.887,2458.64,35733,116,115,35271,35052,22852,22591,25205
20662,165,217,12787,7875,5.8703e+18,107.304,1383.18,20662,77,82,20445,20383,18164,19368,19468
17718,244,257,10980,6738,5.8732e+18,126.704,1470.77,17718,87,92,17461,17448,16754,17218,17401
56525,30,266,34738,21787,5.87202e+18,163.246,2453.31,56525,111,120,49621,42066,7197,13309,8949
45827,108,286,28436,17391,5.87943e+18,213.95,2691.5,45827,162,151,44217,42441,20239,20276,22283
11333,140,250,7021,4312,5.88434e+18,144.379,1311.52,11333,104,99,10931,10686,8031,7738,8086
96772,216,315,59894,36878,5.87273e+18,197.037,3640.34,96772,152,160,96350,96004,71137,76990,71398
3180,89,109,1960,1220,5.87029e+18,47.8805,457.745,3180,46,48,3071,3066,2777,2915,2973
59331,211,259,36465,22866,5.87156e+18,160.483,2467.99,59331,112,112,59066,58981,49563,55017,53475
63682,216,226,39188,24494,5.87016e+18,151.934,2432.68,63682,103,108,63455,63391,62461,63197,63187
87718,105,214,54071,33647,5.87007e+18,144.05,2978.5,87718,96,100,87297,86890,53332,50166,62307
11091,97,136,6845,4246,5.87007e+18,68.4059,950.719,11091,69,70,10955,10939,10668,10582,10405
24922,245,253,15593,9329,5.88934e+18,201.712,2012.45,24922,153,144,24669,24656,24600,24623,24663
75185,105,272,46441,28744,5.87463e+18,220.977,3168.47,75185,166,164,73252,71175,30416,32344,26919
7050,149,217,4410,2640,5.89683e+18,141.389,1045.86,7050,104,93,6753,6529,4994,5043,5203
66680,97,235,41078,25602,5.87006e+18,126.433,2552.35,66680,99,105,66177,65700,32916,32055,36161
45132,135,290,27910,17222,5.87166e+18,165.11,2331.02,45132,110,117,44643,44300,23123,22529,20882
69535,66,212,42935,26600,5.87013e+18,126.222,2722.81,69535,89,91,68781,67897,26033,28416,31157
43225,105,224,26576,16649,5.87045e+18,126.403,1987.04,43225,90,102,42871,42532,22604,20703,25059
59851,144,257,36999,22852,5.87021e+18,157.187,2744.86,59851,105,103,59429,59019,42962,38954,46139
93364,142,259,57729,35635,5.87008e+18,149.23,3366.83,93364,107,106,92920,92443,69447,66005,74247
55255,92,199,34062,21193,5.86998e+18,121.668,2345.98,55255,90,89,54877,54633,32443,30045,34024
7282,54,140,4500,2782,5.86993e+18,70.9723,755.715,7282,66,69,6958,6478,3222,2930,1262
40176,101,249,24737,15439,5.86986e+18,110.721,2041.89,40176,90,94,39825,39540,25251,26704,25636
98471,280,282,60698,37773,5.87264e+18,213.996,3451.21,98471,154,161,98189,98189,98124,98128,98189
3312,63,74,2068,1244,5.86818e+18,56.7089,433.583,3312,53,56,3229,3182,3021,3119,3144
91280,98,288,56256,35024,5.87016e+18,136.335,3157.82,91280,107,108,90678,90137,47245,47000,44855
61594,125,271,37907,23687,5.87071e+18,163.524,2558.83,61594,117,121,61037,60474,30357,30515,30781
49008,44,194,30262,18746,5.86955e+18,101.261,2272.28,49008,85,86,46537,42825,13386,18043,19153
11438,114,208,7084,4354,5.8718e+18,78.971,1033.18,11438,71,72,11220,11129,8788,8640,8295
82357,223,268,50987,31370,5.87162e+18,195.069,2996.09,82357,136,144,82058,81910,68574,76280,73744
18509,82,252,11511,6998,5.87877e+18,154.299,1601.29,18509,119,113,17468,16495,7335,7763,7150
60647,73,232,37259,23388,5.87058e+18,124.145,2394.79,60647,97,106,59839,59331,22424,24727,30278
46540,42,264,28807,17733,5.87255e+18,197.509,2295.68,46540,120,126,43389,40155,8447,13021,10573
62723,115,304,38684,24039,5.87437e+18,204.811,2998.89,62723,148,147,61473,60134,30446,31171,26585
42180,96,224,25964,16216,5.86995e+18,163.88,1987.67,42180,99,102,41654,41173,20711,21322,24366
33735,4,183,20872,12863,5.87033e+18,81.4012,1898.25,33735,81,80,7570,0,7,1141,744
53454,93,211,33034,20420,5.87031e+18,118.524,2398.95,53454,86,86,53135,52977,29937,27081,28460
75506,144,215,46600,28906,5.86983e+18,131.832,2804.36,75506,91,95,75262,75111,57899,53871,58827
79373,238,279,48838,30535,5.87397e+18,198.553,3130.34,79373,154,159,79053,78886,67332,73656,69652
98506,50,318,60943,37563,5.87275e+18,199.214,3703.89,98506,150,162,93330,88383,23066,32687,22726
53289,53,261,33426,19863,5.88959e+18,232.758,2982.1,53289,188,186,44854,38944,9482,15036,12742
16010,145,248,9866,6144,5.87363e+18,100.61,1374.05,16010,83,84,15741,15683,13824,13758,13640
41619,41,199,25742,15877,5.87013e+18,108.182,2084.89,41619,84,82,38730,34579,11461,14377,14245
90737,94,298,55962,34775,5.87051e+18,166.768,3275.11,90737,124,129,89721,88734,36660,41619,36798
71462,134,198,44124,27338,5.86985e+18,127.866,2701.59,71462,88,94,71238,71101,56398,57117,62689
27824,252,272,17214,10610,5.87606e+18,160.962,1994.75,27824,118,124,27552,27512,25431,26505,26396
72796,187,289,45803,26993,5.89574e+18,235.009,3638.63,72796,205,201,72088,71163,48922,50062,52110
32693,65,224,20093,12600,5.87077e+18,131.416,1744.08,32693,88,97,31987,31533,7418,11918,12249
71820,13,260,44275,27545,5.86996e+18,140.472,2756.72,71820,99,103,44416,26327,7884,8501,6586
1670,28,78,1036,634,5.87041e+18,37.8922,279.241,1670,40,41,1464,1243,599,614,482
6083,30,140,3729,2354,5.86791e+18,75.2869,683.476,6083,61,65,5401,4711,1618,1972,2040
26908,270,358,16647,10261,5.87012e+18,137.843,2049.92,26908,92,96,26550,26550,26503,26507,26436
5623,64,80,3460,2163,5.86808e+18,66.1569,582.917,5623,61,64,5502,5364,4764,5062,5193
88435,140,262,54690,33745,5.86994e+18,178.006,3330.07,88435,111,111,87950,87417,61965,57759,67648
8362,174,201,5180,3182,5.87156e+18,85.7379,876.264,8362,65,67,8161,8147,7833,7996,7956
45590,168,218,27987,17603,5.87079e+18,131.748,2015.45,45590,92,98,45356,45260,39367,42334,42633
23503,261,292,14660,8843,5.88377e+18,128.982,2072.25,23503,131,131,23211,23182,22300,22672,22237
13762,32,111,8484,5278,5.87008e+18,71.3297,957.451,13762,72,72,11840,8960,5066,5082,6179
97943,13,307,60565,37378,5.87135e+18,235.137,3457.63,97943,131,143,61078,36533,10051,12077,4858
84154,144,284,51768,32386,5.8709e+18,147.687,3069.83,84154,116,125,83691,83338,48025,40782,42963
25763,114,162,15936,9827,5.87015e+18,111.38,1455.22,25763,78,81,25583,25454,20886,20470,23219
18467,40,277,11566,6901,5.88766e+18,147.35,1842.35,18467,128,124,14938,11537,4439,5120,3199
84120,111,274,51765,32355,5.87051e+18,182.906,2972.18,84120,128,131,83228,82225,39883,39573,41797
60375,262,270,37363,23012,5.87033e+18,227.448,3025.09,60375,142,153,60101,60060,59981,60006,59652
32094,240,263,19769,12325,5.87155e+18,177.203,1907.6,32094,105,106,31831,31818,28298,30408,29851
42745,8,284,26676,16069,5.88276e+18,197.323,2665.08,42745,167,162,17736,0,2301,3888,1284
43837,132,200,27103,16734,5.87004e+18,109.201,2178.82,43837,87,86,43627,43551,35966,36751,36139
58553,187,259,36094,22459,5.87015e+18,128.571,2498.91,58553,94,98,58294,58209,50737,54044,54892
75537,184,301,46606,28931,5.87086e+18,168.989,3026.61,75537,114,120,75149,74938,62544,59957,63045
22237,97,150,13731,8506,5.86976e+18,68.0456,1405.89,22237,75,76,22087,22065,20077,19643,18769
13245,100,139,8190,5055,5.86884e+18,93.5629,1035.98,13245,66,66,13089,13029,10595,11115,11007
68991,156,237,42610,26381,5.87026e+18,126.627,2590.1,68991,97,108,68726,68594,50629,50164,61444
91783,245,301,56570,35213,5.87077e+18,172.068,3277.46,91783,119,127,91481,91371,83694,88188,85171
17966,41,147,11071,6895,5.86867e+18,91.4967,1218.4,17966,69,73,17078,15681,4943,6542,6074
83996,229,294,51869,32127,5.87008e+18,165.29,3024.97,83996,107,115,83702,83648,79203,81612,81452
64019,88,217,39437,24582,5.87016e+18,129.07,2576.72,64019,88,92,63571,63288,29547,27467,26781
79765,150,260,49152,30613,5.87057e+18,147.396,2893.13,79765,103,109,79467,79271,61410,61441,67995
98367,206,244,60810,37557,5.86998e+18,160.712,3283.91,98367,97,102,98123,98098,93573,95445,97323
24491,126,172,15071,9420,5.87009e+18,95.4057,1498.41,24491,77,79,24319,24257,22935,23514,23395
63908,73,301,39433,24475,5.87101e+18,151.132,2787.62,63908,110,109,62784,61958,22183,26230,26647
63978,215,315,39540,24438,5.87207e+18,203.368,2990.76,63978,121,121,63655,63505,59448,60451,59564
38509,282,426,24063,14446,5.88464e+18,181.359,3175.06,38509,159,157,38083,38026,32096,32244,25862
45728,36,221,28093,17635,5.87063e+18,158.025,2059.65,45728,97,106,42324,38599,8357,12513,11095
93872,215,230,57802,36070,5.87013e+18,141.732,3085.17,93872,99,106,93642,93642,93361,93437,93333
20946,117,247,13007,7939,5.87043e+18,121.565,1671.82,20946,89,94,20563,20313,12545,11738,13683
94450,205,325,58536,35914,5.87801e+18,219.904,4006.99,94450,185,188,93886,93334,68579,66135,62020
50588,122,224,31129,19459,5.87018e+18,155.38,2167.88,50588,100,107,50215,49863,29868,27562,28782
40509,66,250,25027,15482,5.86977e+18,149.291,2244.1,40509,98,101,39567,38684,12908,14849,15241
27676,18,174,16979,10697,5.87043e+18,107.939,1507.08,27676,77,86,20713,13932,3015,4535,3750
3759,11,75,2313,1446,5.86536e+18,63.0779,459.679,3759,52,55,1972,1220,449,456,584
12789,103,153,7902,4887,5.86847e+18,66.6135,1105.46,12789,71,69,12636,12619,10605,10358,8933
90444,251,285,56327,34117,5.87904e+18,237.624,3686.26,90444,197,192,90137,89986,79856,85229,85353
91038,36,302,56156,34882,5.87045e+18,168.038,3285.01,91038,117,125,83314,75176,16123,26724,19570
45258,95,252,27856,17402,5.86978e+18,122.948,2158,45258,95,99,44823,44434,23318,23194,22179
67844,120,198,41897,25947,5.87002e+18,130.866,2630.62,67844,88,94,67586,67390,48766,47577,54688
35159,140,257,21692,13467,5.87003e+18,118.67,2129.9,35159,93,96,34787,34522,22426,19251,23836
66759,150,411,41347,25412,5.88001e+18,211.127,3743.04,66759,178,180,65562,64274,33883,32996,25721
65416,248,274,40366,25050,5.87379e+18,215.532,2888.63,65416,142,152,65123,65026,56835,61658,60069
70666,113,258,43542,27124,5.87034e+18,143.568,2734.99,70666,100,106,70253,69846,41924,39077,44676
58834,90,238,36387,22447,5.87007e+18,139.795,2631.46,58834,94,95,58320,58084,34955,32480,36221
12722,118,125,7827,4895,5.8697e+18,60.2562,1014.69,12722,66,66,12597,12597,12476,12555,12582
2834,134,138,1750,1084,5.86849e+18,54.2449,506.321,2834,48,52,2696,2696,2680,2694,2685
12841,127,139,7935,4906,5.86932e+18,93.9678,1023.53,12841,66,66,12702,12690,12521,12645,12653
3194,55,70,1987,1207,5.87071e+18,57.774,415.757,3194,51,53,3097,2979,2641,2651,2973
30646,54,155,18849,11797,5.86949e+18,96.1711,1639.55,30646,75,82,30030,29114,11425,12438,13532
14944,130,421,9410,5534,5.89664e+18,161.67,1998.42,14944,137,137,14104,13180,6414,5828,3313
51350,46,260,31734,19616,5.87004e+18,175.372,2571.33,51350,101,103,48165,44265,11178,15943,15148
60939,97,303,38199,22740,5.89211e+18,222.411,3373.35,60939,190,195,56557,51178,23339,24978,18040
49210,183,194,30371,18839,5.87006e+18,100.725,2270.47,49210,85,86,49016,49012,48903,48976,48930
89855,33,277,55647,34208,5.87196e+18,192.605,3172.55,89855,144,144,80255,68079,11837,22817,12475
27957,278,308,17362,10595,5.8755e+18,123.054,2076.62,27957,113,109,27649,27625,26221,27033,26121
99775,132,397,61780,37995,5.8721e+18,179.237,4069.54,99775,149,146,98745,97650,67473,66169,70559
89359,81,222,55190,34169,5.87001e+18,139.203,3087.02,89359,94,96,88783,88492,41949,40712,49202
92712,276,328,57479,35233,5.87503e+18,206.977,3805.77,92712,162,159,92384,92290,88833,89739,88095
39423,82,258,24333,15090,5.87008e+18,124.06,2063.5,39423,91,89,38964,38665,18455,18586,21044
55003,70,272,34091,20912,5.87862e+18,191.399,2829.66,55003,162,160,51460,48240,12809,19613,16770
24901,35,178,15339,9562,5.87013e+18,81.4285,1592.32,24901,76,80,22489,19089,5896,7573,6880
77522,198,274,47946,29576,5.87621e+18,228.896,3259.64,77522,183,168,76993,76410,59347,64792,61423
5333,16,78,3281,2052,5.87109e+18,69.1937,566.514,5333,60,61,3362,1971,819,939,1246
27245,16,173,16884,10361,5.87039e+18,101.595,1632.09,27245,78,79,17620,10790,3151,4882,3093
83285,216,271,51519,31766,5.87016e+18,196.616,3325.92,83285,122,122,82960,82800,75312,79458,78875
90873,48,315,56044,34829,5.87216e+18,171.79,3513.23,90873,142,139,86217,81726,19423,29774,25525
51446,23,411,31949,19497,5.88081e+18,199.955,3461.67,51446,167,167,36042,24043,5963,10326,4778
71424,213,314,44099,27325,5.87249e+18,166.289,3197.6,71424,135,135,71060,70855,64154,64651,61933
26237,131,165,16229,10008,5.86981e+18,115.108,1476.9,26237,77,82,26071,25971,22769,24555,25117
68795,196,257,42545,26250,5.87033e+18,150.754,2924.55,68795,106,105,68491,68316,59522,64040,64235
70791,159,242,43516,27275,5.87032e+18,126.05,2637.45,70791,97,107,70522,70396,53743,56321,64228
62912,75,279,38906,24006,5.87018e+18,138.605,2822.07,62912,106,106,61928,61278,28392,29858,30968
91497,278,302,56444,35053,5.87052e+18,163.808,3270.61,91497,117,124,91195,91145,84895,88381,88122
90630,256,291,57093,33537,5.89753e+18,231.99,4054.22,90630,212,205,90328,90191,84541,86717,88200
25291,10,201,15665,9626,5.8701e+18,114.024,1713.74,25291,83,83,12091,8054,1970,2063,1358
63189,208,272,38996,24193,5.87347e+18,223.587,2851.37,63189,147,152,62799,62438,53243,56982,55173
22646,20,225,13996,8650,5.86927e+18,118.919,1667.35,22646,86,86,15677,10962,3345,4575,3627
72781,176,381,45051,27730,5.87096e+18,168.864,3241.22,72781,129,134,72270,71941,41794,41321,47855
24811,30,174,15232,9579,5.87037e+18,105.155,1431.81,24811,76,82,21965,18548,4479,6296,6880
61936,127,317,38792,23144,5.88879e+18,190.239,3468.95,61936,182,191,59868,57023,33852,33652,26956
65203,14,256,40165,25038,5.87056e+18,114.634,2641.91,65203,98,102,41470,24361,7190,8056,5554
68237,187,314,42144,26093,5.87268e+18,166.119,3146.76,68237,134,134,67812,67532,59169,58020,57408
45773,138,291,28205,17568,5.87101e+18,164.085,2358.46,45773,110,113,45292,45010,24734,25037,24692
19079,145,161,11731,7348,5.87034e+18,98.0712,1262.25,19079,74,75,18918,18902,18009,18434,18370
31368,106,259,19440,11928,5.86969e+18,146.72,2043.86,31368,94,99,30908,30614,16545,14292,17596
52052,2,227,32197,19855,5.87009e+18,120.766,2430.44,52052,89,88,4664,0,465,0,403
49901,19,198,30885,19016,5.86996e+18,105.171,2304.48,49901,85,84,34911,22415,7460,9199,7715
6513,84,146,4011,2502,5.86912e+18,65.6994,759.269,6513,61,64,6366,6319,5426,5193,5260
20042,151,158,12327,7715,5.86963e+18,97.122,1273.45,20042,71,77,19884,19873,19741,19781,19547
50779,106,295,31398,19381,5.8705e+18,139.31,2490.74,50779,97,103,50303,49927,32987,30786,37237
24939,287,409,15494,9445,5.87574e+18,165.629,2413.74,24939,126,114,24530,24496,23320,23119,21123
55763,34,273,34576,21187,5.87508e+18,210.969,2680.04,55763,148,151,48860,41418,8171,14142,9101
22466,8,177,13885,8581,5.86927e+18,82.9387,1486.01,22466,72,77,9721,0,1372,1338,371
81583,258,286,50587,30996,5.87918e+18,237.622,3553.41,81583,180,190,81275,81147,69838,76384,73013
90888,329,426,56681,34207,5.88178e+18,209.968,4628.54,90888,187,196,90462,90370,81176,82687,72719
54263,113,262,33602,20661,5.87123e+18,165.518,2403.22,54263,117,120,53645,52985,26622,25762,24413
15262,210,272,9476,5786,5.87341e+18,114.528,1444.18,15262,88,87,14990,14956,14626,14619,14426
77761,157,270,48154,29607,5.87012e+18,193.159,3222.08,77761,122,126,77187,76468,57270,51005,62079
79890,16,229,49249,30641,5.86999e+18,132.72,2813.54,79890,97,103,55104,36608,9589,10458,8373
82370,64,294,51776,30594,5.89454e+18,235.472,3871.71,82370,208,206,69966,57343,16173,24533,20506
74439,169,262,45904,28535,5.87007e+18,129.323,2817.81,74439,98,103,74169,74041,56785,52853,63867
19883,114,210,12308,7575,5.86984e+18,117.234,1548.11,19883,83,83,19632,19548,14682,14735,13931
49264,48,265,30609,18655,5.88153e+18,204.544,2733.08,49264,171,164,43222,37508,8795,14446,9261
35151,36,217,21754,13397,5.87057e+18,144.878,1794.79,35151,90,96,32435,29629,6468,10612,8995
42821,134,266,26330,16491,5.87154e+18,165.744,2159.93,42821,104,115,42349,41992,28160,26762,30216
58415,67,234,36009,22406,5.87009e+18,113.706,2392.6,58415,93,102,57596,56970,18408,25452,27241
79210,5246,11775,49939,29271,5.75241e+18,506.273,18030.9,79210,812,295,67435,67164,39788,42888,4124
9189,51,80,5653,3536,5.86856e+18,71.9066,737.747,9189,67,69,8852,8275,5496,4871,5286
16734,192,213,10369,6365,5.87072e+18,101.03,1255.7,16734,72,79,16521,16518,16411,16468,16463
13702,39,137,8472,5230,5.8692e+18,95.6824,1042.95,13702,68,68,12924,12006,3416,4925,3986
77567,162,286,48123,29444,5.87944e+18,240.939,3482.6,77567,177,190,76526,75438,47978,43927,44707
92758,245,306,57136,35622,5.87069e+18,159.094,3286.63,92758,119,127,92452,92359,80302,87262,81709
34435,126,259,21326,13109,5.87036e+18,145.914,2135.13,34435,99,100,34006,33697,21586,21043,24368
87200,114,294,53850,33350,5.87022e+18,164.752,3071.39,87200,109,116,86656,86103,46855,45349,61972
21881,63,150,13457,8424,5.86987e+18,79.9634,1385.69,21881,71,74,21614,21464,11163,11839,11860
34523,159,272,21830,12693,5.90164e+18,203.382,2442.13,34523,177,168,33797,32682,21333,21733,25655
44028,260,284,27484,16544,5.88266e+18,193.827,2701.11,44028,161,162,43744,43696,38922,41545,40682
47476,133,270,29411,18065,5.87015e+18,198.353,2573.2,47476,114,114,46892,46311,28749,25567,33722
75221,141,286,46602,28619,5.87779e+18,198.221,3361.63,75221,175,178,73981,72765,42968,42318,44466
39102,239,260,24394,14708,5.88584e+18,224.224,2499.06,39102,169,165,38828,38693,34936,37081,36296
65334,121,275,40273,25061,5.87651e+18,219.948,2935.35,65334,159,156,63955,62301,30836,28560,29938
76863,269,275,47356,29507,5.87501e+18,232.185,3136.53,76863,158,158,76588,76544,74878,75916,76140
39717,126,397,24635,15082,5.8748e+18,187.873,2776.37,39717,141,142,38733,37700,18976,18994,17120
49371,135,296,30415,18956,5.87101e+18,136.265,2436.85,49371,96,100,49022,48878,39893,43590,42260
29622,263,312,18320,11302,5.87144e+18,97.9036,2015.3,29622,87,90,29310,29305,29110,29146,28980
12232,133,153,7563,4669,5.86907e+18,85.5886,1004.57,12232,67,72,12079,12052,10412,11386,10715
86641,20,274,53521,33120,5.87501e+18,239.928,3400.07,86641,175,170,65350,48553,10070,18505,6618
72860,167,295,45632,27228,5.89095e+18,228.537,3622.97,72860,193,201,71764,70157,43607,42142,38169
46535,61,173,28778,17757,5.8694e+18,110.462,2105.62,46535,86,84,45853,44925,19985,20755,22827
60053,193,342,37190,22863,5.87584e+18,141.306,3276.59,60053,139,136,59695,59597,54921,54390,52219
16150,47,158,9929,6221,5.86985e+18,95.4477,1159.46,16150,71,75,15518,14989,4930,6272,7404
19072,233,253,11932,7140,5.88555e+18,204.941,1733.02,19072,136,132,18819,18746,18356,18587,18594
59418,24,281,36867,22551,5.87982e+18,200.475,3010.78,59418,175,175,45354,33216,7117,12746,4387
37670,1,198,23324,14346,5.87001e+18,108.859,1971.23,37670,83,81,0,0,0,0,0
3400,85,107,2074,1326,5.86747e+18,47.6471,473.454,3400,47,49,3293,3286,2970,3081,2989
76633,160,328,47558,29075,5.87744e+18,177.165,3647.06,76633,165,169,75878,75169,57695,58509,57308
1986,109,154,1238,748,5.87458e+18,44.7482,442.248,1986,50,45,1832,1817,1626,1631,1565
42477,75,178,26226,16251,5.8704e+18,98.6492,2045.43,42477,82,83,42179,42018,23561,21978,22060
49479,144,301,30562,18917,5.87095e+18,140.973,2478.8,49479,106,105,49049,48880,36066,36087,38282
96340,90,327,59719,36621,5.87545e+18,208.893,3922.99,96340,165,166,93808,90961,37461,41170,46866
68931,77,270,43112,25819,5.88552e+18,224.049,3331.61,68931,195,188,63144,57138,17158,23746,21053
59826,201,266,36763,23063,5.87097e+18,161.848,2494.91,59826,113,120,59515,59328,49977,54322,50752
53408,186,342,32901,20507,5.87081e+18,140.606,2676.23,53408,110,111,53024,52873,37928,33743,42234
70141,16,224,43390,26751,5.87001e+18,150.539,2800.93,70141,90,94,45411,27779,9168,10373,7345
24658,27,149,15222,9436,5.87016e+18,79.1686,1477.13,24658,76,76,20701,15539,5121,7394,6627
44805,118,385,27817,16988,5.87524e+18,234.865,2763.09,44805,137,148,43620,42422,15436,17460,13233
22762,44,282,14260,8502,5.889e+18,200.962,2013.58,22762,148,136,18349,14531,3823,5602,4354
10886,99,144,6735,4151,5.87092e+18,67.6043,984.842,10886,70,72,10742,10726,10026,9892,9524
66570,23,273,41383,25187,5.87742e+18,234.517,3053.72,66570,170,170,51666,39158,7557,14819,6767
4938,9,70,3071,1867,5.86878e+18,55.7169,496.687,4938,54,56,2360,0,393,542,826
25045,50,150,15407,9638,5.87023e+18,81.0912,1500.38,25045,74,76,24292,23114,8692,10009,10482
36743,112,229,22540,14203,5.8716e+18,157.482,1867.27,36743,97,100,36342,35947,20206,19119,20487
74350,205,268,46038,28312,5.87157e+18,197.558,2857.96,74350,130,142,73998,73690,59278,67001,63259
88074,163,230,54323,33751,5.87029e+18,154.452,3087.7,88074,93,100,87826,87694,67010,73135,69382
13641,171,243,8455,5186,5.87385e+18,136.922,1260.24,13641,86,89,13371,13265,11087,11736,11461
2949,56,62,1834,1115,5.86862e+18,44.0793,358.46,2949,46,46,2887,2863,2707,2814,2877
5890,48,77,3638,2252,5.86915e+18,66.9066,584.431,5890,62,62,5600,5226,3595,3349,4287
95114,300,302,58714,36400,5.8709e+18,200.808,3360.46,95114,123,131,94812,94812,94810,94811,94812
75588,88,294,46650,28938,5.87012e+18,163.476,2875.6,75588,108,112,74827,74155,27713,31827,35360
84162,152,288,51891,32271,5.87017e+18,147.342,3037.01,84162,106,109,83847,83625,51929,44633,42446
32853,58,258,20437,12416,5.87715e+18,199.057,2098.36,32853,138,133,30285,28384,7085,11344,9538
51295,97,381,31735,19560,5.87089e+18,161.871,2905.73,51295,120,114,50357,49683,25611,25776,26050
23028,56,216,14238,8790,5.86966e+18,127.967,1464.72,23028,86,85,22341,21794,6570,8915,8301
29090,10,193,18002,11088,5.87004e+18,100.688,1678.59,29090,79,78,14931,10180,2350,2620,2444
9259,30,145,5685,3574,5.86878e+18,84.3936,851.82,9259,64,65,8298,7264,2196,2859,2671
73420,145,304,45287,28133,5.87366e+18,190.457,3198.84,73420,149,149,72578,71987,42900,40111,37946
82623,185,302,50983,31640,5.87077e+18,174.364,3139.04,82623,116,122,82241,82021,70816,68601,73953
17766,16,219,10990,6776,5.8697e+18,96.5867,1297.06,17766,77,80,12713,8913,2018,3581,1731
4788,21,144,2954,1834,5.86726e+18,63.797,634.929,4788,55,57,3796,2945,758,1132,698
1829,63,94,1126,703,5.86392e+18,40.9131,341.583,1829,42,41,1735,1720,1404,1492,1417
33796,93,186,20860,12936,5.86948e+18,82.9575,1915.42,33796,81,85,33593,33544,25900,24830,24068
78597,190,285,48888,29709,5.87868e+18,225.892,3421.93,78597,181,183,77983,77311,54644,57226,59282
75566,63,307,47056,28510,5.8848e+18,241.748,3648.46,75566,196,185,67802,60366,14700,23566,15613
38966,107,239,24103,14863,5.86985e+18,120.741,2171.54,38966,90,93,38629,38492,27631,25669,25643
48066,184,309,29880,18186,5.88259e+18,214.348,2803.12,48066,171,169,47499,46896,30081,27564,24542
55760,25,262,34374,21386,5.87006e+18,123.026,2425.86,55760,95,97,46057,34570,8009,11008,5579
97808,142,342,60540,37268,5.87619e+18,209.975,4081.25,97808,173,166,96803,95516,58613,51221,65942
29834,85,261,18698,11136,5.89066e+18,214.833,2247.24,29834,163,155,27149,24110,10273,10474,11880
30876,76,173,19123,11753,5.87052e+18,98.1805,1738.33,30876,78,79,30647,30562,18075,18693,18527
38107,209,217,23583,14524,5.87023e+18,137.231,1852.5,38107,93,97,37890,37855,35986,37278,37700
80179,257,291,50344,29835,5.89326e+18,237.945,3793.18,80179,209,203,79879,79709,72320,75110,77039
81148,54,277,50049,31099,5.87046e+18,151.455,3007.48,81148,119,123,78724,76060,16431,25603,20508
88013,194,316,54298,33715,5.87316e+18,195.432,3505.82,88013,152,151,87489,87095,65849,60515,63029
83136,109,327,51564,31572,5.87696e+18,175.437,3754.52,83136,161,172,81236,79072,46047,44424,47441
79643,101,262,49114,30529,5.87015e+18,131.292,2918.94,79643,98,104,79160,78740,41147,43370,51015
82063,211,277,50759,31304,5.87083e+18,149.911,3014.54,82063,120,124,81778,81645,66431,74331,62214
34018,155,197,21037,12981,5.87036e+18,113.955,1895.54,34018,82,83,33821,33754,32546,32822,33144
33914,171,273,21008,12906,5.87314e+18,207.375,2030.22,33914,115,116,33520,33303,24536,26524,27657
95031,206,285,59349,35682,5.88414e+18,244.118,3969.93,95031,203,199,94484,93753,74358,80715,76591
81425,208,309,50463,30962,5.8732e+18,210.807,3305.7,81425,152,159,80996,80600,54999,57244,54006
83315,64,285,51907,31408,5.87951e+18,241.652,3563,83315,193,192,76974,71202,16851,27747,22371
83844,65,238,51781,32063,5.87031e+18,144.813,3078.37,83844,95,94,82790,81317,35127,39253,38989
53165,82,217,32773,20392,5.87017e+18,118.426,2374.81,53165,88,91,52718,52449,28204,28615,31482
16296,278,280,10130,6166,5.87668e+18,104.175,1600.95,16296,102,98,16016,16016,16015,16015,16011
4300,58,112,2654,1646,5.86675e+18,52.9186,582.144,4300,55,55,4173,4085,2848,2953,2835
48634,155,285,30221,18413,5.8761e+18,231.245,2617.71,48634,145,145,47944,47426,31338,29072,30003
86998,279,290,54532,32466,5.89125e+18,240.305,3937.06,86998,211,210,86708,86684,85160,85782,85647
43190,64,275,26600,16590,5.87596e+18,157.813,2380.08,43190,130,132,41150,39421,12642,18168,14697
32662,26,223,20055,12607,5.871e+18,159.585,1746.03,32662,94,100,28005,22568,4102,7719,6387
54648,219,274,33740,20908,5.87431e+18,211.578,2686.05,54648,140,148,54293,54035,45328,49324,44757
44616,126,197,27458,17158,5.87039e+18,123.878,2086.82,44616,89,93,44398,44260,37243,38927,39618
54678,43,203,33775,20903,5.86972e+18,122.281,2353.94,54678,87,88,51647,46884,13162,18656,19565
28365,17,173,17553,10812,5.87055e+18,89.786,1666.06,28365,79,81,18934,11421,3827,6107,4417
90664,80,302,55876,34788,5.87052e+18,160.726,3251.65,90664,118,127,89338,88305,32251,39051,40105
13664,169,376,8486,5178,5.87399e+18,136.269,1680.38,13664,98,97,13271,13136,10879,11082,10714
1443,25,71,891,552,5.85889e+18,53.2571,281.257,1443,42,42,1105,779,412,433,612
66307,185,397,41090,25217,5.87386e+18,215.373,3375.39,66307,149,160,65661,65148,36247,35384,36320
95867,57,215,59116,36751,5.87027e+18,138.389,3124.75,95867,95,102,94129,91655,27047,35298,35851
31958,211,271,19828,12130,5.87632e+18,184.126,2082.13,31958,128,126,31653,31511,25494,28511,23526
49223,113,226,30461,18762,5.87032e+18,125.671,2102.78,49223,91,100,48889,48563,28024,27660,38632
68397,213,268,42197,26200,5.86999e+18,143.708,2686.55,68397,102,103,68129,68040,64925,66676,66179
50403,210,260,31212,19191,5.87185e+18,194.113,2373.75,50403,126,129,50086,49890,41570,46321,44603
86580,94,215,53428,33152,5.87e+18,132.484,2989.8,86580,92,98,86120,85797,46749,45248,54207
2287,148,155,1403,884,5.87517e+18,46.7643,442.297,2287,47,48,2132,2130,2126,2128,2120
93698,135,228,57752,35946,5.86987e+18,141.154,3080.94,93698,99,103,93421,93146,68220,68295,80235
94489,177,307,58192,36297,5.87309e+18,204.618,3546.14,94489,161,159,93874,93274,61035,53233,53082
42831,210,330,26761,16070,5.88596e+18,148.706,2978.16,42831,156,155,42473,42361,34539,34475,30577
44767,223,258,27621,17146,5.86999e+18,123.062,2196.27,44767,89,90,44509,44481,43524,43983,44229
21507,166,238,13321,8186,5.87094e+18,75.9055,1480.06,21507,80,80,21269,21227,20061,20587,19659
9813,9,128,6039,3774,5.87011e+18,68.2961,846.746,9813,62,61,4814,0,967,724,843
28015,164,199,17309,10706,5.87009e+18,109.313,1797.5,28015,85,82,27816,27769,26416,27102,25922
93856,16,342,57937,35919,5.87039e+18,156.654,3470.13,93856,120,117,62259,39732,10301,14982,8724
75622,15,272,46811,28811,5.87151e+18,197.673,2882.04,75622,136,130,52294,33172,8006,13099,4845
33360,33,261,20629,12731,5.87542e+18,183.387,2089.06,33360,126,131,28676,24126,5233,9013,5962
70814,67,285,43597,27217,5.87042e+18,145.176,2820.85,70814,102,109,69716,68703,20105,29942,29328
41594,43,200,25736,15858,5.86988e+18,108.813,2109.25,41594,83,83,39009,35172,11378,14795,15808
83095,294,298,51292,31803,5.87053e+18,174.19,3144.85,83095,119,125,82797,82783,82354,82714,82473
15655,63,235,9893,5762,5.90271e+18,186.942,1617.78,15655,145,131,12738,9772,3749,4436,5274
46295,183,196,28570,17725,5.86994e+18,117.953,2128.57,46295,84,89,46099,46065,44379,45370,45010
27208,117,193,16849,10359,5.86993e+18,106.301,1634.34,27208,78,77,27002,26910,22453,24156,21602
87774,27,315,54162,33612,5.87241e+18,201.256,3477.03,87774,144,142,73130,56570,12149,21369,13788
96098,83,231,59235,36863,5.87002e+18,144.5,3143.45,96098,95,104,95363,94874,40927,41013,48330
4753,120,133,2936,1817,5.86744e+18,63.9323,636.509,4753,53,56,4620,4615,4393,4529,4485
15307,68,251,9484,5823,5.87233e+18,107.629,1363.15,15307,82,85,14742,14341,6786,7321,7188
30879,195,246,19533,11346,5.90322e+18,199.379,2282.99,30879,174,161,30561,30306,26068,26693,27783
11561,105,237,7167,4394,5.87509e+18,135.442,1177.41,11561,86,88,11173,10874,5775,5564,6047
70519,108,275,43424,27095,5.87463e+18,224.007,2986.5,70519,151,157,69055,67506,32992,31922,39772
2690,19,203,1707,983,5.89692e+18,137.818,646.678,2690,73,73,1364,537,193,326,173
8681,87,143,5354,3327,5.86961e+18,85.9475,816.925,8681,62,66,8507,8389,6010,5867,6976
12465,116,226,7799,4666,5.88772e+18,173.035,1367.34,12465,121,113,11793,11007,6686,6233,6952
12089,18,210,7471,4618,5.86948e+18,92.829,1056.37,12089,71,76,9279,6557,1404,2822,1709
5019,51,113,3094,1925,5.86714e+18,52.885,620.123,5019,57,57,4857,4665,2495,2603,2382
62420,226,317,39159,23261,5.89166e+18,213.96,3498.21,62420,190,198,62061,61863,46932,49303,44887
8760,36,248,5436,3324,5.88154e+18,131.582,1112.58,8760,89,82,7483,6432,1619,2586,1326
56392,184,199,34779,21613,5.87001e+18,125.079,2351.23,56392,86,91,56193,56153,54496,55696,55978
49177,222,260,30436,18741,5.86996e+18,178.313,2599.65,49177,111,111,48889,48753,45246,47264,47682
8334,89,112,5147,3187,5.86958e+18,54.4744,791.148,8334,61,61,8222,8222,7701,7927,7415
52490,39,266,32321,20169,5.87137e+18,197.47,2392.34,52490,118,122,48654,44707,8821,14287,11027
89838,240,262,55560,34278,5.87003e+18,168.164,3346.02,89838,110,112,89576,89508,88926,89312,89171
49643,238,262,31007,18636,5.88788e+18,225.548,2839.81,49643,187,177,49363,49202,44784,47002,47127
8681,28,144,5336,3345,5.86908e+18,84.6055,814.766,8681,63,64,7671,6492,1709,2556,2220
82096,139,278,50536,31560,5.87341e+18,200.169,3159.97,82096,153,144,81192,80331,44815,38187,41662
43195,209,274,26671,16524,5.87412e+18,171.849,2387.89,43195,128,131,42855,42647,35256,38091,33493
79051,20,285,49239,29812,5.87983e+18,236.2,3509.01,79051,185,182,56709,40569,8937,16293,6270
12097,19,206,7473,4624,5.8707e+18,89.2213,1042.57,12097,71,74,9494,6885,1640,3092,2185
99873,193,288,61630,38243,5.87004e+18,152.022,3288.02,99873,107,113,99583,99460,82781,89121,92283
83275,168,281,51354,31921,5.87277e+18,212.073,3210.22,83275,151,163,82611,81998,59190,52928,57679
87278,268,276,53765,33513,5.87058e+18,155.893,3035.31,87278,108,112,87002,87002,86921,86700,87002
38466,68,196,23777,14689,5.86971e+18,108.487,1997.91,38466,83,84,38045,37632,15139,15705,15982
13132,45,77,8082,5050,5.86991e+18,69.2705,864.421,13132,66,71,12510,11573,7400,6993,9151
3699,31,80,2277,1422,5.86809e+18,69.0835,476.398,3699,58,60,3075,2211,1174,1293,1679
15527,144,145,9618,5909,5.86911e+18,88.6849,1105.18,15527,67,71,15382,15382,15382,15382,15382
92965,179,217,57322,35643,5.87025e+18,137.433,3090.59,92965,92,101,92748,92668,83312,88426,90205
31828,18,315,19745,12083,5.87279e+18,112.715,2187.09,31828,100,95,21723,13233,3945,4249,3856
28551,99,286,17655,10896,5.87195e+18,129.736,1915.72,28551,103,102,28007,27595,15500,16122,14950
98215,23,291,61388,36827,5.88499e+18,231.61,4082.74,98215,205,199,69869,48055,9488,19274,8549
67992,94,270,42493,25499,5.88818e+18,228.445,3357,67992,194,191,63390,57941,25398,26326,29169
60777,136,279,37695,23082,5.87968e+18,234.673,3028.04,60777,169,166,59462,58229,32347,30821,34184
12137,19,229,7627,4510,5.88896e+18,168.834,1361.07,12137,122,111,7592,4388,1027,2100,1089
99076,91,342,61691,37385,5.88266e+18,194.959,4405.33,99076,187,198,94242,88156,38438,42841,43402
21100,89,126,12983,8117,5.8696e+18,67.4142,1323.41,21100,74,74,20974,20974,16409,16446,15034
79248,23,262,48839,30409,5.86994e+18,137.144,2874.67,79248,102,106,63851,47969,10865,15687,11947
74566,111,285,46490,28076,5.88143e+18,244.421,3466.75,74566,184,189,71888,68705,33152,32310,34392
91750,48,293,56656,35094,5.87016e+18,165.289,3127.85,91750,112,118,88480,85385,18695,28476,27659
93744,277,279,57868,35876,5.87004e+18,147.751,3391.19,93744,109,115,93465,93463,93464,93465,93070
12660,24,250,7871,4789,5.87079e+18,70.2615,1120.8,12660,73,78,9627,6554,2690,3558,3767
4915,38,226,3052,1863,5.87528e+18,73.0437,826.05,4915,69,69,4201,3553,1697,1808,1634
2655,91,140,1633,1022,5.86847e+18,92.8776,488.932,2655,56,54,2472,2381,1715,1717,1585
49081,225,426,30784,18297,5.88908e+18,201.278,3557.11,49081,177,182,48626,48527,33797,30755,22211
99574,23,316,61688,37886,5.87783e+18,230.484,3981.8,99574,194,193,76077,56444,11850,21524,6401
74156,145,285,46200,27956,5.88046e+18,233.924,3392.25,74156,184,181,72812,71410,39643,35126,39566
23525,201,281,14526,8999,5.87177e+18,102.957,1738.6,23525,95,97,23244,23169,20891,21640,20700
73866,307,316,45494,28372,5.87263e+18,191.65,3165.04,73866,128,128,73550,73537,73334,73471,73280
76585,84,288,47241,29344,5.87023e+18,147.696,2910.88,76585,104,107,75797,75182,27679,31683,31705
21023,158,162,12925,8098,5.87075e+18,96.9353,1324.32,21023,74,78,20861,20861,20599,20797,20825
43478,112,173,26848,16630,5.86987e+18,107.113,1986.44,43478,83,91,43261,43074,31295,28880,34441
51165,259,264,31900,19265,5.88064e+18,199.254,2763.61,51165,171,161,50901,50901,50003,50639,50644
26248,242,274,16179,10069,5.87226e+18,188.379,1775.26,26248,103,99,25974,25917,25846,25819,25820
91886,171,342,57114,34772,5.88057e+18,187.472,4183.91,91886,178,182,91180,90406,68433,68436,67686
21668,178,236,13397,8271,5.87084e+18,109.135,1440.55,21668,85,89,21432,21399,17952,19778,20172
81342,23,259,50267,31075,5.87031e+18,163.492,3121.37,81342,101,101,62053,43755,12064,16644,10554
13713,11,123,8512,5201,5.87035e+18,62.1476,1049.13,13713,66,68,7403,4747,1157,1784,1220
29646,45,186,18297,11349,5.87035e+18,85.1994,1793.56,29646,81,82,27968,25651,11010,11261,12050
91027,5,300,56239,34788,5.87091e+18,192.407,3246.09,91027,125,124,27136,0,543,4847,2691
81856,8,231,50580,31276,5.87022e+18,132.307,2958.15,81856,94,96,35099,0,5219,6565,3198
81486,159,228,50220,31266,5.87009e+18,143.646,2896.54,81486,96,98,81250,81114,69202,72424,73263
48194,4,185,29782,18412,5.86945e+18,113.247,2173.81,48194,84,86,10983,0,14,850,1547
45899,189,270,28551,17348,5.88286e+18,213.57,2673.32,45899,167,172,45417,44864,34007,35267,34230
13025,10,155,8011,5014,5.87024e+18,101.492,1041.31,13025,68,71,6953,4772,1369,1474,578
81992,170,273,50880,31112,5.87423e+18,232.252,3231.87,81992,164,166,81261,80533,53989,51756,55923
48208,179,288,29705,18503,5.87114e+18,156.504,2422.88,48208,113,115,47857,47657,34777,31847,29281
48383,184,269,30067,18316,5.87604e+18,182.781,2531.51,48383,148,139,47948,47507,34718,37682,35831
54248,121,307,33742,20506,5.88371e+18,216.725,3119.11,54248,172,170,52539,50245,25030,25289,28754
7864,74,148,4857,3007,5.87033e+18,69.2103,881.235,7864,68,69,7710,7637,6063,5985,5678
51024,76,272,31509,19515,5.87434e+18,224.17,2608.27,51024,144,150,48889,47069,11750,19375,13109
70034,172,352,43125,26909,5.87016e+18,171.488,2941.21,70034,109,116,69631,69460,39586,33345,46842
99626,241,248,61530,38096,5.87029e+18,164.927,3390.06,99626,102,103,99378,99378,99371,99374,99353
53788,2,182,33138,20650,5.87022e+18,118.609,2291.69,53788,83,88,4841,0,474,0,455
83614,23,300,51480,32134,5.87119e+18,192.279,3136.33,83614,116,126,67477,51240,10168,19063,10506
80455,248,274,49639,30816,5.87355e+18,234.739,3188.77,80455,158,163,80161,80001,71687,76600,77993
68136,187,237,41872,26264,5.87052e+18,132.284,2561.29,68136,98,109,67897,67816,58365,63830,63183
90229,78,323,56478,33751,5.88727e+18,217.765,4109.23,90229,201,208,82421,73818,26903,36551,25076
72009,159,274,45164,26845,5.89133e+18,221.267,3519.22,72009,199,194,70743,68977,45933,43515,48958
38039,41,220,23544,14495,5.87011e+18,126.401,1852.96,38039,90,96,36128,33598,8215,12567,13180
83988,176,278,51806,32182,5.87781e+18,229.079,3408.23,83988,185,179,83218,82343,55826,52023,56021
67367,92,273,41713,25654,5.8707e+18,159.873,2661.77,67367,118,122,66421,65509,25883,31472,33178
43654,241,397,27084,16570,5.87418e+18,189.221,2963.59,43654,142,142,43246,43128,34365,33160,29669
81320,89,275,50075,31245,5.87131e+18,190.2,2977.13,81320,136,134,79902,78471,25193,32968,28151
54266,219,265,33360,20906,5.87233e+18,194.023,2479.08,54266,130,128,53960,53789,45648,50235,48650
93507,218,244,57600,35907,5.86993e+18,142.605,3095.95,93507,102,105,93263,93263,90561,92840,92951
80288,15,232,49534,30754,5.87043e+18,134.286,2916.7,80288,91,95,51870,30315,9013,10184,5144
64377,71,241,39666,24711,5.87016e+18,116.122,2560.91,64377,96,101,63586,63004,19546,26871,31777
65014,266,327,40341,24673,5.87928e+18,189.721,3422.78,65014,166,175,64687,64600,57156,59071,54395
87623,297,325,54306,33317,5.87843e+18,224.372,3847.12,87623,178,190,87298,87260,78070,83370,79757
66985,5,270,41727,25258,5.8843e+18,222.38,3258.12,66985,190,182,18257,0,570,3486,923
28316,163,282,17638,10678,5.8845e+18,160.942,2216.89,28316,141,141,27819,27372,20441,19756,18098
30378,144,251,19137,11241,5.89861e+18,195.077,2265.93,30378,175,161,29413,27979,19340,19107,21047
6198,82,205,3831,2367,5.87041e+18,101.071,874.152,6198,68,72,5916,5786,3968,3656,3782
89339,89,229,55117,34222,5.87025e+18,140.145,3092.24,89339,92,96,88831,88555,45733,42723,52347
8307,45,148,5121,3186,5.86837e+18,68.4664,898.23,8307,68,70,7730,7027,2955,3084,3259
63538,68,225,39267,24271,5.87045e+18,129.151,2651.48,63538,93,91,62833,61824,28868,27901,30880
62559,77,286,39403,23156,5.89676e+18,230.094,3370.47,62559,197,194,54600,45430,15822,19102,20667
96224,135,315,59577,36647,5.87284e+18,200.415,3616.74,96224,152,160,95114,94127,54035,52477,51155
59831,154,317,37560,22271,5.89286e+18,220.543,3411.89,59831,190,198,58512,56637,31512,29008,23883
37989,51,250,23475,14514,5.86983e+18,134.191,2165.91,37989,97,99,36207,33682,10305,13158,11598
21073,158,254,13116,7957,5.87985e+18,178.223,1720.41,21073,126,118,20691,20400,14306,14024,13622
46284,20,258,28567,17717,5.87076e+18,130.842,2259.22,46284,92,95,34905,25604,5703,8039,5844
44259,247,381,27403,16856,5.87126e+18,142.704,2685.59,44259,119,117,43878,43771,34989,34667,34300
54875,23,196,33892,20983,5.87012e+18,114.956,2398.26,54875,84,86,42742,30711,8316,10787,7122
82360,102,302,50800,31560,5.8706e+18,165.395,3134.44,82360,115,121,81521,80743,39967,40924,43444
94049,195,234,58085,35964,5.86995e+18,160.187,3260.1,94049,98,99,93815,93742,90881,92481,92873
37998,162,258,23408,14590,5.87152e+18,176.05,2029.41,37998,108,111,37625,37413,27742,28800,30722
12054,218,236,7408,4646,5.87513e+18,113.091,1169.67,12054,85,82,11818,11802,11135,11446,11404
58300,60,270,36126,22174,5.87275e+18,196.756,2612.08,58300,135,136,55830,53958,11960,19890,14282
86561,29,282,53668,32893,5.87316e+18,207.461,3266.71,86561,152,156,74106,61681,10959,22115,11601
73894,14,314,45606,28288,5.87155e+18,191.694,3182.54,73894,129,125,46734,27640,8574,9728,6478
90472,152,235,55896,34576,5.87012e+18,159.674,3203.44,90472,99,96,90192,89879,73029,76848,77894
63379,69,279,39136,24243,5.87019e+18,151.7,2810.39,63379,102,112,62244,61367,17917,24261,25739
57384,66,199,35403,21981,5.87021e+18,117.267,2398.05,57384,85,91,56728,56173,22763,23810,25172
50071,91,190,30867,19204,5.86981e+18,115.909,2142.68,50071,87,95,49681,49326,26191,24979,28993
85816,31,249,53016,32800,5.87015e+18,155.13,3158.03,85816,98,101,73449,55986,16313,23612,19511
62944,100,280,39177,23767,5.88008e+18,197.435,3083.62,62944,170,172,60490,57872,26381,26910,27123
78877,231,273,48799,30078,5.87077e+18,163.054,2845.71,78877,120,129,78604,78538,67056,73875,72786
60142,208,226,37009,23133,5.87001e+18,154.784,2363.41,60142,102,109,59906,59841,56611,57690,57939
94633,110,286,58640,35993,5.87828e+18,232.785,3768.08,94633,192,192,91715,88372,41039,42926,36001
26031,70,245,16040,9991,5.86992e+18,92.9672,1671.24,26031,84,88,25562,25167,12478,15210,14103
8729,62,127,5367,3362,5.86971e+18,66.8038,810.977,8729,61,63,8569,8512,4506,4303,5496
52240,248,303,32770,19470,5.8929e+18,222.685,3135.31,52240,178,189,51925,51797,42643,44408,42293
69021,5,411,42820,26201,5.87786e+18,181.497,3866.41,69021,167,166,18396,0,196,3097,1283
78119,153,303,48103,30016,5.87062e+18,158.901,3034,78119,118,124,77642,77338,49175,48218,52329
7754,126,255,4791,2963,5.86842e+18,124.427,1046.69,7754,77,81,7420,7208,5363,4975,5806
77760,31,272,47792,29968,5.872e+18,194.653,2913.5,77760,136,138,68719,58566,8734,17197,12778
63527,149,207,39227,24300,5.8702e+18,111.749,2616.75,63527,89,90,63320,63231,54547,57965,55965
2683,49,167,1677,1006,5.87217e+18,55.054,539.366,2683,56,56,2437,2223,1465,1486,1653
96748,204,281,59585,37163,5.87093e+18,174.583,3220.05,96748,130,134,96399,96157,77521,86409,79025
57397,60,279,35472,21925,5.86988e+18,139.218,2723.95,57397,104,103,55821,53968,22713,23790,25131
3842,79,111,2359,1483,5.86732e+18,72.0927,519.961,3842,50,48,3717,3684,2969,3077,3140
99271,258,283,61186,38085,5.87219e+18,196.519,3466.16,99271,157,161,98988,98973,87791,93915,92002
68804,92,285,42425,26379,5.87021e+18,146.71,2775.45,68804,103,104,68198,67669,28264,31835,32648
12409,22,280,7721,4688,5.87991e+18,121.306,1479.11,12409,107,100,8432,5587,1743,2700,2265
71831,140,217,44324,27507,5.8701e+18,130.119,2721.07,71831,89,94,71590,71413,56980,54669,61422
72537,136,317,44884,27653,5.87351e+18,191.422,3270.46,72537,141,147,71645,70919,46943,46755,44676
20434,85,217,12634,7800,5.86965e+18,110.194,1378.16,20434,81,83,20091,19841,11942,11538,14289
60651,135,269,37284,23367,5.87175e+18,166.243,2543.53,60651,114,118,60177,59748,31974,27127,27330
38125,100,331,23448,14677,5.87071e+18,137.515,2121.33,38125,95,106,37586,37132,12819,14010,14129
98188,166,227,60595,37593,5.86995e+18,145.626,3220.49,98188,95,102,97957,97820,82936,90569,89452
35634,106,171,22040,13594,5.86994e+18,94.3374,1854.15,35634,82,82,35442,35402,28292,28060,24277
50067,106,189,30984,19083,5.86993e+18,110.598,2208.39,50067,83,84,49831,49740,34676,32926,35990
16519,91,156,10157,6362,5.86952e+18,90.8118,1162.94,16519,69,75,16322,16190,11960,11954,12717
29997,24,163,18439,11558,5.86922e+18,111.162,1562.21,29997,75,87,24872,18817,4827,6327,4706
49098,79,302,30310,18788,5.87389e+18,152.993,2664.35,49098,133,130,47518,46150,19478,24869,20982
88027,294,300,54168,33859,5.87118e+18,202.243,3216.49,88027,123,129,87727,87702,87067,87526,87320
93196,168,228,57457,35739,5.87009e+18,143.515,3082.33,93196,98,102,92965,92853,82435,85946,88990
36563,267,299,22979,13584,5.89518e+18,195.206,2662.62,36563,167,174,36264,36229,32231,33445,31965
5696,148,174,3537,2159,5.87218e+18,65.3423,737.326,5696,62,63,5522,5495,5237,5377,5071
99301,246,376,61344,37957,5.87055e+18,176.291,3773.75,99301,122,115,98925,98799,96129,96388,95687
23585,99,183,14561,9024,5.86952e+18,78.3409,1452.95,23585,78,77,23393,23304,19962,19433,19250
74096,86,298,45738,28358,5.87049e+18,148.974,2954.49,74096,111,118,73158,72341,32392,34358,40125
68979,153,328,42798,26181,5.87612e+18,165.949,3395.34,68979,147,150,68333,67698,52326,56010,55389
29058,136,268,17940,11118,5.87885e+18,172.913,2016.24,29058,126,128,28434,27852,15959,14598,14342
35262,136,162,21760,13502,5.87017e+18,92.4797,1791.33,35262,77,82,35100,35094,32483,33879,33301
70769,2,225,43736,27033,5.87014e+18,154.08,2823.86,70769,94,93,6313,0,600,0,162
60081,71,274,37077,23004,5.87375e+18,214.755,2767.25,60081,153,146,57573,55607,14619,22615,16764
83555,185,327,51826,31729,5.87682e+18,183.267,3754.63,83555,162,170,83038,82550,70478,69231,68325
19806,116,272,12261,7545,5.87582e+18,131.518,1690.68,19806,100,101,19298,18909,14219,15256,14197
30056,167,228,18553,11503,5.87024e+18,128.94,1901.48,30056,86,88,29828,29724,27478,28286,26975
86658,232,285,53397,33261,5.87017e+18,149.189,3099.06,86658,100,110,86373,86312,77889,82296,85028
10682,3,236,6645,4037,5.87619e+18,163.268,1179.35,10682,90,88,1806,0,19,135,21
87390,15,277,54163,33227,5.87357e+18,224.669,3299.97,87390,165,158,59624,37567,9323,15487,5607
23546,57,271,14671,8875,5.87686e+18,160.124,1865.82,23546,118,118,21797,20497,7881,9734,7249
28624,85,273,17853,10771,5.88519e+18,191.823,2208.12,28624,143,146,26597,24433,12448,13659,10384
86665,153,279,53564,33101,5.87e+18,177.266,3288.85,86665,112,107,86222,85808,66906,69290,72263
9339,132,202,5747,3592,5.87103e+18,92.5474,926.692,9339,70,72,9132,9045,7214,7441,8372
68844,192,307,42903,25941,5.88564e+18,227.329,3504.35,68844,192,184,68293,67718,48683,51524,50753
31535,181,197,19421,12114,5.87023e+18,119.641,1776.84,31535,84,84,31338,31305,30912,31121,31119
27891,148,181,17160,10731,5.86966e+18,112.264,1530.39,27891,80,85,27710,27664,25142,26667,26852
58129,226,273,36089,22040,5.87435e+18,209.765,2747.08,58129,143,148,57795,57614,49376,53509,51256
1280,78,154,792,488,5.88647e+18,61.2031,367.412,1280,48,45,1115,1045,706,652,644
80840,194,264,49858,30982,5.87002e+18,136.199,2917.21,80840,101,105,80576,80476,69240,73761,73587
27756,38,173,17204,10552,5.87056e+18,100.564,1643.76,27756,77,78,25398,22777,6494,8802,7399
48882,14,314,30166,18716,5.87134e+18,132.772,2545.2,48882,101,102,30447,17723,5770,5574,4193
29334,265,285,18142,11192,5.87561e+18,190.232,2076.69,29334,119,116,29049,29014,28856,28904,28565
35570,86,160,21874,13696,5.87024e+18,89.9098,1814.66,35570,78,81,35329,35213,21220,19556,24168
90039,262,282,55521,34518,5.87279e+18,208.708,3312.27,90039,152,161,89754,89707,83799,85385,87137
31415,137,173,19472,11943,5.87028e+18,100.591,1756.25,31415,79,79,31242,31198,27425,28909,27772
21239,59,252,13310,7929,5.88958e+18,161.394,1857.15,21239,143,132,18337,15783,4634,6815,5892
20894,215,279,13011,7883,5.87369e+18,83.9174,1693.37,20894,100,91,20615,20582,19546,19778,19030
63848,219,259,39277,24571,5.87083e+18,154.821,2530.9,63848,113,114,63589,63585,54108,59678,56836
87056,261,303,53700,33356,5.87062e+18,148.544,3213.87,87056,120,124,86753,86726,73645,81416,76403
49172,21,196,30399,18773,5.87029e+18,104.067,2279.75,49172,84,85,36685,26509,7168,9636,6665
7906,79,246,4908,2998,5.86918e+18,135.188,1079.11,7906,78,79,7446,7207,3747,3273,3178
63725,190,266,39225,24500,5.87049e+18,176.555,2586.65,63725,117,122,63388,63147,50341,55491,52460
41859,171,272,25841,16018,5.87421e+18,170.253,2346.4,41859,132,135,41412,41079,31839,29968,30650
94451,237,318,58216,36235,5.87056e+18,219.268,3389.57,94451,127,134,94107,94017,76286,86028,71269
78106,92,303,48185,29921,5.87098e+18,168.653,3076.11,78106,115,122,77139,76296,36101,37909,43462
75425,184,285,47083,28342,5.8832e+18,241.758,3521.94,75425,191,192,74727,73873,50756,51724,51229
83409,226,302,51567,31842,5.87087e+18,155.596,3116.3,83409,115,126,83096,83006,67723,75037,68779
62971,190,234,38728,24243,5.87042e+18,120.701,2491,62971,93,106,62737,62698,53311,58732,60255
75043,255,279,46755,28288,5.88079e+18,233.648,3407.83,75043,186,181,74754,74661,69593,72567,72550
29146,127,176,17963,11183,5.86969e+18,100.025,1665.06,29146,77,80,28970,28901,25862,25649,26407
85998,170,276,53016,32982,5.87268e+18,216.629,3250.33,85998,160,157,85315,84709,59018,55796,63742
17477,58,123,10857,6620,5.86964e+18,65.4666,1182.23,17477,69,71,17224,16832,9298,9365,7367
60319,129,203,37180,23139,5.86986e+18,123.135,2466.73,60319,90,94,60082,59945,45858,44195,51255
6360,155,230,3912,2448,5.87066e+18,79.9748,813.864,6360,66,64,6130,6128,4923,5107,3833
17897,125,142,11083,6814,5.87003e+18,74.5589,1243.46,17897,67,73,17755,17751,16600,17244,16839
54875,32,301,33839,21036,5.87081e+18,148.021,2613.76,54875,105,106,48311,39524,9832,12081,11789
91664,178,262,56465,35199,5.87043e+18,134.008,3111.99,91664,101,108,91393,91264,73720,72864,83140
3161,13,130,1956,1205,5.86893e+18,62.7808,521.236,3161,56,58,1741,1007,411,379,378
4742,19,108,2938,1804,5.86728e+18,47.7836,571.581,4742,52,51,3674,2558,878,1288,510
20937,120,148,12931,8006,5.86922e+18,71.1353,1407.7,20937,78,78,20789,20789,18834,19831,17922
99145,285,381,61300,37845,5.87086e+18,171.196,3705.62,99145,133,136,98764,98637,82640,88731,76707
43375,23,275,26731,16644,5.87705e+18,215.481,2418.54,43375,135,138,34131,26019,4660,9928,5688
37269,225,274,23033,14236,5.87485e+18,207.243,2244.39,37269,134,127,36974,36834,31941,34315,34514
36397,239,291,22429,13968,5.87073e+18,175.275,2144.15,36397,106,113,36106,36058,30389,33698,29063
4943,49,105,3052,1891,5.87114e+18,53.7224,593.913,4943,55,57,4757,4555,3335,3203,3683
97403,3,285,59987,37416,5.87007e+18,149.993,3250.32,97403,106,109,16741,0,199,923,1540
11454,44,135,7046,4408,5.87082e+18,80.5256,953.754,11454,63,66,11004,10467,4423,4857,4370
71958,284,285,44367,27591,5.87002e+18,134.346,2854.89,71958,98,104,71673,71673,71673,71673,71673
24654,249,264,15440,9214,5.8858e+18,155.793,2048.2,24654,140,139,24390,24377,23423,24027,23630
31450,246,260,19592,11858,5.88445e+18,193.614,2201.62,31450,154,149,31190,31167,30706,30987,31146
4786,18,74,2948,1838,5.8722e+18,62.4049,517.85,4786,56,59,3262,1958,848,1141,1433
17829,104,126,11041,6788,5.86908e+18,66.7272,1202.52,17829,69,73,17703,17703,15071,16338,15059
52111,107,228,32054,20057,5.87021e+18,123.052,2289.3,52111,88,94,51793,51515,32815,28738,33798
57411,20,209,35363,22048,5.86992e+18,128.803,2380.04,57411,89,94,43672,32138,7516,9907,7801
81743,80,327,50636,31107,5.87748e+18,195.626,3711.51,81743,175,179,78144,74620,25024,32014,27020
26666,118,280,16628,10038,5.88437e+18,160.072,2154.48,26666,143,139,25589,24340,14998,15182,11911
41843,312,342,25901,15942,5.87455e+18,114.02,2708.42,41843,117,114,41501,41495,41158,41266,40645
14478,66,133,8895,5583,5.87128e+18,81.2391,1058.01,14478,66,70,14270,14208,8372,7819,7452
65407,226,270,40828,24579,5.88319e+18,222.029,3188.43,65407,190,180,65074,64790,55592,59927,59890
60002,162,288,37711,22291,5.89429e+18,226.137,3278.76,60002,200,190,58895,57399,36175,35742,40727
89372,61,231,55084,34288,5.87007e+18,130.407,2987.45,89372,97,104,88010,86776,26665,34013,37871
93508,307,352,57605,35903,5.8702e+18,168.429,3364.44,93508,113,120,93156,93111,81327,86714,89397
29984,116,190,18430,11554,5.86978e+18,115.94,1593.25,29984,81,86,29759,29591,19942,18776,21685
22917,120,152,14207,8710,5.8709e+18,68.5046,1457.02,22917,74,77,22765,22764,20155,21569,18537
65150,179,220,40105,25045,5.87032e+18,127.947,2607.22,65150,89,97,64930,64909,58025,61935,59957
65331,175,285,40663,24668,5.87962e+18,204.794,3167.71,65331,168,174,64650,63866,44691,41493,41822
67097,50,266,41213,25884,5.87143e+18,173.037,2639.55,67097,119,125,64456,62230,13902,21483,14225
95517,295,426,59759,35758,5.88681e+18,242.568,4471.55,95517,206,214,95091,94998,66140,72055,48305
24991,45,153,15426,9565,5.86977e+18,91.5546,1481.65,24991,72,79,24088,23014,6846,9285,9258
8837,161,231,5497,3340,5.87114e+18,100.798,1026.16,8837,79,77,8591,8538,6875,7081,6799
61986,355,426,38398,23588,5.87244e+18,159.792,3447.24,61986,129,119,61560,61541,60697,60712,59967
66022,67,260,40676,25346,5.87e+18,129.727,2644.03,66022,99,102,65082,64340,21917,27736,26948
95840,216,279,58991,36849,5.87106e+18,185.026,3221.89,95840,141,140,95517,95264,78763,87890,82347
90348,41,397,55957,34391,5.87142e+18,185.888,3876.81,90348,134,128,82760,73268,17668,26027,18246
48615,16,200,30051,18564,5.86978e+18,119.042,2224.74,48615,86,85,31464,19162,6259,7442,5362
27292,80,256,16812,10480,5.87245e+18,128.548,1747.6,27292,98,102,26610,26087,10324,13384,12138
9356,51,76,5755,3601,5.86872e+18,68.1531,724.962,9356,63,67,9072,8522,6000,5670,7104
24880,87,146,15299,9581,5.87026e+18,99.535,1436.5,24880,74,78,24645,24500,16155,14931,18573
46575,52,342,28753,17822,5.87068e+18,153.469,2602.35,46575,112,103,44397,41604,12384,15615,14849
27864,87,158,17251,10613,5.86944e+18,73.3455,1619.78,27864,77,79,27706,27679,21278,19849,17953
1434,73,91,886,548,5.86474e+18,37.7824,306.181,1434,42,38,1343,1343,1222,1242,1222
52998,79,342,32661,20337,5.87073e+18,153.448,2704.49,52998,112,111,51931,51242,16530,20552,21032
4880,73,76,3010,1870,5.8702e+18,69.2111,535.425,4880,58,59,4801,4748,4486,4693,4801
15563,10,255,9623,5940,5.87014e+18,182.235,1491.75,15563,94,99,7182,4691,1076,1687,851
42629,87,200,26361,16268,5.87016e+18,110.787,2156.27,42629,88,86,42350,42261,26336,23874,25598
19307,110,217,11870,7437,5.87012e+18,106.039,1345.53,19307,78,82,19065,18899,14409,14986,16596
66242,297,298,40930,25312,5.87056e+18,193.788,2819.01,66242,112,116,65944,65944,65944,65944,65900
15646,142,154,9620,6026,5.86949e+18,97.5419,1125.72,15646,67,75,15492,15462,15240,15292,15434
20765,79,177,12833,7932,5.87031e+18,83.411,1427.11,20765,71,75,20538,20471,9811,9310,8384
11492,166,281,7106,4386,5.87552e+18,85.6335,1328.62,11492,84,79,11211,11196,10464,10462,10014
11217,13,150,6940,4277,5.86901e+18,77.3299,934.08,11217,64,67,7277,4410,1305,1830,1194
44813,45,249,27559,17254,5.8709e+18,123.515,2145.99,44813,95,97,42843,40814,11079,14956,12294
72407,192,271,45207,27200,5.8838e+18,219.194,3394.34,72407,197,184,71830,71083,53911,58530,56130
40742,129,194,25178,15564,5.86995e+18,104.263,2027.14,40742,84,85,40539,40485,34750,36995,34423
11870,112,132,7343,4527,5.86872e+18,69.9958,986.2,11870,66,67,11738,11725,10698,11170,10627
81796,187,218,50386,31410,5.87019e+18,127.719,2853.96,81796,95,103,81578,81544,75336,78937,80794
3223,72,169,1990,1233,5.87245e+18,67.372,565.949,3223,53,53,3017,2953,1618,1716,1784
42171,264,381,26089,16082,5.87143e+18,161.914,2665.67,42171,121,117,41790,41683,35236,36688,34474
63252,95,270,39136,24116,5.87009e+18,211.068,3021.97,63252,132,135,61722,60573,31014,26451,30807
68368,123,203,42122,26246,5.86998e+18,128.26,2597.45,68368,91,98,68109,67879,50456,50941,57289
90837,127,285,56718,34119,5.88375e+18,246.914,3858.5,90837,200,199,88190,84684,42984,39986,46624
45957,27,257,28388,17569,5.87033e+18,127.666,2419.21,45957,100,100,37286,26736,8164,10163,7832
28308,258,290,17465,10843,5.87087e+18,101.084,1909.19,28308,93,90,28018,27979,26915,27583,27067
44625,155,180,27543,17082,5.86996e+18,117.631,2089.05,44625,83,83,44445,44396,42095,43459,43815
35823,10,260,22260,13563,5.87578e+18,184.621,2152.79,35823,133,131,19410,13450,2845,4654,1117
28087,20,252,17300,10787,5.87187e+18,144.448,1754.19,28087,102,104,22071,16931,3505,6336,2231
58177,156,224,35785,22392,5.86988e+18,152.417,2309.89,58177,101,113,57891,57704,42430,48397,46868
49759,169,272,30921,18838,5.87762e+18,184.95,2625.76,49759,155,143,49205,48658,32956,31597,32482
52596,95,286,32589,20007,5.87786e+18,227.008,2822.34,52596,162,159,50576,48433,21062,22381,21720
54110,10,281,33740,20370,5.88124e+18,205.016,2916.7,54110,172,171,27271,17851,3710,6365,1827
6363,149,154,3918,2445,5.87082e+18,80.2876,709.512,6363,59,63,6209,6209,6160,6199,6193
99460,177,342,61601,37859,5.87717e+18,204.827,4186.61,99460,174,170,98893,98372,74184,80155,76176
23919,153,250,14789,9130,5.86933e+18,118.729,1776.62,23919,92,93,23618,23396,17965,16904,18747
7911,145,218,4921,2990,5.87237e+18,122.298,937.008,7911,74,72,7682,7644,6167,6769,5749
38640,230,397,23972,14668,5.87488e+18,181.011,2835.54,38640,141,137,38230,38099,31173,29862,27132
40641,46,279,25101,15540,5.87034e+18,117.965,2213.56,40641,89,98,38748,36814,8663,13263,10289
51576,84,211,31738,19838,5.86999e+18,124.262,2261.05,51576,88,93,51119,50802,27259,25930,28700
14684,233,240,9029,5655,5.87596e+18,134.071,1300.17,14684,89,91,14444,14443,14242,14396,14434
65596,73,235,40533,25063,5.87008e+18,132.138,2496.3,65596,99,108,64691,64065,21712,25748,26126
98964,271,315,61020,37944,5.87291e+18,198.816,3665.3,98964,159,158,98649,98574,84437,92424,87805
2602,21,127,1600,1002,5.87041e+18,55.907,437.216,2602,48,44,2137,1794,544,744,668
32455,86,217,20083,12372,5.87054e+18,124.811,1731.1,32455,88,93,32023,31675,16844,17363,20924
9363,181,264,5806,3557,5.87935e+18,79.1381,1187.05,9363,81,80,9099,9069,8478,8441,8161
82882,264,279,51286,31596,5.87659e+18,231.058,3408.45,82882,189,177,82602,82534,79069,80893,81866
31590,155,173,19548,12042,5.86965e+18,97.2675,1757.7,31590,81,80,31417,31381,30737,30920,31154
31678,108,158,19591,12087,5.87046e+18,91.7981,1693.57,31678,78,79,31503,31469,26004,27528,27733
85725,59,316,52912,32813,5.87282e+18,195.887,3500.2,85725,148,148,82331,79434,22764,30623,26541
69971,132,342,43111,26860,5.8705e+18,153.664,3041.49,69971,117,113,69409,68951,42559,39308,44187
73898,168,234,45667,28231,5.87043e+18,142.358,2701.48,73898,106,112,73615,73458,57809,64345,61660
63749,69,285,39732,24017,5.88096e+18,236.28,3172.12,63749,177,170,59156,54620,13609,21639,18261
97513,29,244,60282,37231,5.86999e+18,159.191,3258.47,97513,96,102,82710,63318,15425,25172,11151
17963,168,262,11213,6750,5.87961e+18,173.387,1657.11,17963,115,118,17598,17341,12300,12488,11854
66140,217,275,40744,25396,5.87452e+18,228.104,2911.82,66140,150,156,65770,65459,56155,60528,57050
33499,45,200,20745,12754,5.87051e+18,117.635,1901.79,33499,81,83,31660,29214,8150,11110,10202
17879,90,217,11063,6816,5.87127e+18,91.3474,1301.17,17879,78,79,17589,17376,10789,10714,11289
25948,150,217,16050,9898,5.87139e+18,166.745,1577.76,25948,87,94,25673,25538,18651,20454,19887
34107,162,293,21047,13060,5.87128e+18,122.154,2090.19,34107,94,93,33783,33713,30016,30220,30491
81824,8,230,50480,31344,5.87027e+18,128.513,2960.79,81824,94,97,35047,0,5223,6651,4440
65488,197,313,40569,24919,5.87356e+18,194.119,3092.51,65488,140,144,65035,64675,48324,45950,45145
99115,269,306,61204,37911,5.87076e+18,168.034,3400.21,99115,120,131,98809,98739,87665,94330,92859
3072,66,93,1894,1178,5.86626e+18,45.2376,419.473,3072,48,49,2979,2979,2227,2295,2145
19027,42,179,11733,7294,5.86927e+18,81.3355,1328.87,19027,77,77,17896,16386,7133,7944,8817
54291,84,227,33347,20944,5.87048e+18,157.041,2246.42,54291,102,106,53550,52885,21588,22676,23641
43640,13,222,26991,16649,5.87012e+18,113.622,2258.58,43640,87,87,24736,14378,4785,6042,4514
20511,21,219,12680,7831,5.87029e+18,110.296,1378.31,20511,77,83,16469,12891,2903,4940,3522
29284,42,224,18027,11257,5.87048e+18,164.447,1667.09,29284,92,92,27679,25941,6005,8052,10006
2830,69,134,1735,1095,5.86883e+18,56.5018,461.568,2830,48,47,2690,2609,1676,1705,1826
28382,50,173,17587,10795,5.8703e+18,103.284,1665.07,28382,78,79,27337,25601,8413,10029,9967
17902,249,253,11195,6707,5.88349e+18,192.356,1655.5,17902,127,125,17649,17648,17622,17628,17636
12526,8,249,7777,4749,5.88079e+18,140.721,1364.45,12526,107,106,5369,0,862,1194,581
80268,262,381,49667,30601,5.87098e+18,169.651,3400.49,80268,132,135,79887,79772,60982,65835,60447
23852,36,162,14755,9097,5.86945e+18,106.741,1408.41,23852,77,78,22063,20079,5475,8122,7191
57655,83,210,35653,22002,5.87004e+18,119.36,2478.53,57655,87,87,57288,57128,27316,26274,28441
86852,157,259,53686,33166,5.87008e+18,155.705,3268.07,86852,108,107,86454,86048,68188,63624,73123
76443,292,309,47386,29057,5.87334e+18,218.348,3151.54,76443,152,155,76134,76121,70984,74009,73720
10630,4,161,6544,4086,5.86993e+18,83.7648,963.068,10630,64,64,2502,0,6,168,345
49315,139,270,30680,18635,5.8827e+18,219.625,2765.34,49315,173,173,48070,46827,26398,24665,27452
85253,74,260,52506,32747,5.87055e+18,145.119,2977.02,85253,104,111,84216,83572,30591,34356,40209
75825,148,259,46918,28907,5.87003e+18,155.671,3029.99,75825,104,102,75414,74987,62577,62241,67826
53395,3,274,32971,20424,5.87444e+18,212.034,2661.13,53395,140,146,9053,0,94,443,333
25614,236,319,15909,9705,5.88002e+18,113.931,2128.47,25614,116,115,25295,25253,23535,23462,22151
11451,21,222,7073,4378,5.87127e+18,73.6329,1129.58,11451,78,73,8621,6441,1908,2794,2760
61359,90,299,37819,23540,5.87099e+18,159.275,2741.23,61359,110,115,60488,59725,26099,30768,30944
24929,53,186,15393,9536,5.87001e+18,85.7467,1666.12,24929,80,81,24056,22479,9991,10543,10492
9189,3,75,5712,3477,5.8702e+18,60.0707,695.216,9189,62,62,1609,0,87,116,333
45422,206,224,28128,17294,5.87018e+18,123.451,2017.47,45422,92,99,45198,45180,41799,43720,44314
97715,236,342,60659,37056,5.87957e+18,202.188,4282.11,97715,179,183,97364,97218,86690,87220,86346
80791,153,225,49898,30893,5.87018e+18,143.651,3008.14,80791,94,93,80542,80363,66172,69158,68841
70281,257,272,43366,26915,5.87363e+18,231.832,3001.67,70281,155,153,70000,69917,64370,67493,68661
7339,75,197,4518,2821,5.87002e+18,85.1656,824.627,7339,68,64,7074,6925,3975,4282,4495
12319,119,129,7643,4676,5.87047e+18,68.3091,964.941,12319,67,67,12190,12172,11615,12005,11762
49532,240,260,30608,18924,5.86985e+18,187.904,2527.59,49532,100,101,49272,49235,48425,48974,47730
37593,259,342,23223,14370,5.87017e+18,139.049,2372.05,37593,109,101,37251,37155,34932,35985,34634
33316,100,158,20609,12707,5.87071e+18,91.6818,1742.03,33316,78,80,33133,33095,25382,25774,26575
71545,279,426,44257,27288,5.87188e+18,156.383,3519.09,71545,124,115,71119,71116,70138,70117,68732
99576,218,289,61376,38200,5.86998e+18,139.304,3296.29,99576,108,111,99287,99253,82656,90751,84951
24491,352,376,15174,9317,5.87195e+18,134.102,2131.32,24491,109,102,24115,24084,23630,23906,23537
1829,24,75,1129,700,5.86275e+18,51.6949,328.346,1829,46,46,1442,1041,409,568,611
32222,24,272,19924,12298,5.87595e+18,177.705,2123.58,32222,123,130,25414,19129,4319,7681,4195
73981,139,259,45750,28231,5.87001e+18,145.97,3007.83,73981,103,102,73538,73130,57249,56785,61201
1171,50,82,720,451,5.86448e+18,35.2348,257.525,1171,36,33,1087,1074,802,771,748
6924,4,105,4249,2675,5.86851e+18,55.0347,687.672,6924,58,59,1580,0,20,201,319
24872,84,154,15309,9563,5.87025e+18,78.5257,1485.42,24872,72,75,24678,24607,16386,15626,16257
21697,91,162,13419,8278,5.86911e+18,101.352,1341.42,21697,74,79,21466,21314,14258,13960,15797
96494,45,264,59555,36939,5.87005e+18,141.866,3178.05,96494,104,111,92571,88000,19658,31057,29441
62115,206,381,38497,23618,5.87435e+18,220.481,3069.15,62115,147,152,61592,61240,34592,29845,22567
51449,274,285,32036,19413,5.87991e+18,222.075,2832.45,51449,163,159,51164,51134,50586,50959,50680
87250,107,288,53818,33432,5.87009e+18,149.555,3102.06,87250,105,108,86734,86260,48142,46958,57128
7379,19,115,4542,2837,5.87015e+18,55.2026,739.291,7379,59,59,5408,3562,1320,1612,1251
25987,104,257,16084,9903,5.87258e+18,140.775,1716.54,25987,97,99,25489,25123,14981,15435,16046
6344,59,135,3927,2417,5.86999e+18,68.6255,741.8,6344,63,65,6105,5817,4138,3975,4863
50180,44,216,30918,19262,5.86988e+18,120.74,2321.56,50180,88,92,47678,44293,13378,17706,17202
73501,215,294,45396,28105,5.87024e+18,166.408,2830.58,73501,108,109,73207,73093,65814,69724,67741
50113,189,274,30997,19116,5.87647e+18,222.841,2651.63,50113,155,146,49667,49309,37124,40745,35874
91708,53,301,56593,35115,5.87102e+18,165.278,3293.75,91708,118,126,88791,85543,21652,32095,29638
78812,242,273,48418,30394,5.87135e+18,159.174,2852.52,78812,122,127,78539,78490,67860,73780,73562
98025,6,314,60442,37583,5.87205e+18,198.404,3635.97,98025,148,139,34028,0,3615,6365,2455
38166,32,179,23573,14593,5.87023e+18,81.2978,1968.43,38166,82,83,33333,26084,9171,12170,11997
19581,36,236,12096,7485,5.87143e+18,116.318,1405.26,19581,89,91,17910,16384,3438,5402,4695
21239,8,250,13090,8149,5.87109e+18,143.474,1529.81,21239,92,100,9981,0,1724,2423,1141
93378,34,288,57506,35872,5.87035e+18,145.695,3186.34,93378,107,114,84376,70649,14464,23532,17981
67634,195,271,41853,25781,5.87197e+18,196.909,2735.67,67634,132,134,67262,66939,50287,58249,49277
72190,116,220,44566,27624,5.87001e+18,127.406,2816.02,72190,92,92,71907,71744,50035,47030,50378
83985,55,227,51850,32135,5.86973e+18,140.796,2995.4,83985,92,98,82118,79207,21110,29954,27066
52374,185,200,32282,20092,5.87015e+18,121.016,2289.3,52374,88,89,52174,52150,49966,51510,50278
10484,72,136,6475,4009,5.87061e+18,67.9388,928.992,10484,68,70,10335,10242,9257,9551,9522
35967,98,224,22104,13863,5.87044e+18,119.323,1812.78,35967,89,99,35603,35298,19531,18254,21075
18914,106,157,11683,7231,5.86955e+18,102.807,1250.81,18914,69,76,18735,18623,15197,15362,16963
15484,87,283,9596,5888,5.87386e+18,127.553,1498.35,15484,91,91,14944,14587,7833,8822,8268
96944,33,426,60643,36301,5.88657e+18,240.464,4501.21,96944,206,214,74735,55318,12209,21021,4444
71902,47,312,44396,27506,5.87369e+18,190.275,3225.78,71902,144,145,67295,62849,16026,23139,14907
31347,37,159,19382,11965,5.87018e+18,91.3717,1684.46,31347,76,78,28819,25552,8477,11230,10005
13313,82,175,8268,5045,5.86916e+18,82.8851,1136.83,13313,72,73,13124,13073,8383,7319,5590
64388,299,314,39762,24626,5.87271e+18,159.026,3066.29,64388,131,128,64074,64047,62810,63428,62841
30353,1648,3496,19156,11197,5.81288e+18,208.357,5794.44,30353,231,183,26857,26758,15317,16132,2552
61847,129,199,38147,23700,5.87006e+18,119.98,2495.34,61847,85,93,61616,61458,47790,45499,52737
52287,309,368,32346,19941,5.87111e+18,180.458,2635.84,52287,112,126,51919,51846,42514,48038,39572
14839,21,141,9118,5721,5.86968e+18,93.482,1086.36,14839,66,68,11711,8849,2514,2769,3362
70999,177,242,43721,27278,5.86996e+18,145.059,2621.89,70999,106,110,70717,70604,57416,63565,60438
60129,53,411,37310,22819,5.87956e+18,190.171,3663.69,60129,170,169,54015,48744,14589,18575,13039
83436,78,381,51581,31855,5.87097e+18,170.917,3335.27,83436,123,134,81853,80704,18540,29398,25946
37635,84,269,23245,14390,5.87435e+18,168.384,2246.72,37635,130,133,36231,34905,12852,17403,14251
52395,83,273,32555,19840,5.87753e+18,231.025,2714.64,52395,151,153,50120,47943,15781,19666,17828
34163,161,287,21067,13096,5.87074e+18,122.211,2068.18,34163,99,104,33824,33700,23452,22358,22067
90637,104,288,55867,34770,5.8701e+18,151.85,3155.57,90637,107,109,90055,89540,45717,47362,52851
66143,125,254,40720,25423,5.87017e+18,154.797,2534.52,66143,110,113,65697,65218,34717,33560,32839
22666,34,159,14021,8645,5.8705e+18,100.483,1351.5,22666,75,77,20774,17867,5037,7515,6054
70044,200,327,43432,26612,5.87557e+18,158.753,3425.05,70044,151,147,69653,69496,61001,60279,57412
95843,255,271,59299,36544,5.87016e+18,183.754,3532.53,95843,118,121,95572,95543,95420,95476,95484
25711,145,164,15830,9881,5.86969e+18,111.268,1484.72,25711,76,80,25547,25534,23195,24595,24543
22812,86,152,14083,8729,5.87039e+18,78.3614,1412.02,22812,72,75,22623,22558,15798,14437,16060
97196,135,301,59891,37305,5.87017e+18,153.938,3283.48,97196,109,110,96809,96502,50237,45403,49400
87990,15,281,54197,33793,5.87064e+18,155.483,3057.95,87990,118,129,59833,36216,11229,14107,7435
81281,229,276,50116,31165,5.87305e+18,200.67,3155.01,81281,146,153,80941,80731,69010,75378,70993
98943,294,312,60876,38067,5.87291e+18,207.476,3548.99,98943,163,158,98631,98616,93981,96804,94817
58581,252,259,36161,22420,5.87009e+18,139.353,2494.45,58581,97,99,58322,58318,58294,58255,58322
50559,63,290,31278,19281,5.87124e+18,173.463,2384.05,50559,110,115,49060,47915,10317,17054,11616
52785,202,217,32627,20158,5.87055e+18,112.76,2407.57,52785,89,85,52568,52560,52547,52540,52524
56836,8,184,35006,21830,5.86999e+18,119.626,2351.11,56836,83,90,24491,0,3976,4368,3331
19253,105,264,11940,7313,5.87896e+18,166.126,1704.87,19253,113,117,18458,17774,10670,10889,9291
79883,202,328,49534,30349,5.87607e+18,184.591,3646.24,79883,158,163,79464,79170,69901,69081,67772
55674,44,259,34363,21311,5.86986e+18,140.339,2439.88,55674,97,96,53080,49734,11981,18427,15372
15182,71,197,9381,5801,5.8695e+18,112.85,1345.06,15182,82,79,14865,14586,7189,7009,6970
14809,53,146,9109,5700,5.86976e+18,86.4488,1137.65,14809,67,68,14465,14010,5680,5964,6017
87763,127,285,54630,33133,5.87937e+18,240.206,3672.29,87763,186,194,85690,83166,44975,43558,44979
96099,130,278,59296,36803,5.87817e+18,220.008,3679.55,96099,192,181,94235,91950,47003,42395,48456
45160,27,279,27925,17235,5.87002e+18,149.533,2459.44,45160,104,98,36591,26370,7532,10232,7804
84019,245,268,52009,32010,5.87161e+18,193.486,3038.1,84019,139,144,83750,83689,74931,79933,81003
39157,324,342,24148,15009,5.87013e+18,154.997,2404.15,39157,108,106,38815,38808,38806,38565,38559
99071,60,232,61086,37985,5.87016e+18,140.196,3229.84,99071,94,103,97514,95670,28841,37268,38135
97200,152,302,59991,37209,5.87069e+18,200.374,3389.12,97200,125,131,96652,96260,59886,58920,57693
90181,182,295,55556,34625,5.87038e+18,158.83,3121.71,90181,110,115,89875,89708,69331,72240,71785
74904,262,285,46659,28245,5.88028e+18,231.908,3403.49,74904,184,181,74616,74514,69200,72221,73317
30986,8,162,19056,11930,5.87039e+18,112.197,1603.37,30986,77,83,13779,0,2179,2684,1430
33427,166,257,20672,12755,5.87032e+18,120.366,1933.3,33427,85,85,33170,33073,31326,31931,32086
32719,136,263,20158,12561,5.87086e+18,159.953,1921.72,32719,100,109,32303,32078,19827,19200,18733
88490,32,272,54660,33830,5.87487e+18,219.232,3434.46,88490,178,172,75672,63409,12225,22123,13971
84072,45,342,51915,32157,5.87048e+18,154.792,3323.07,84072,117,114,79349,73842,20940,27551,26701
23975,47,156,14791,9184,5.86999e+18,88.8609,1466.12,23975,76,74,23011,21800,10087,10328,9018
88545,228,279,54505,34040,5.8711e+18,187.752,3099.64,88545,138,140,88247,88121,74098,82351,79690
12941,15,250,8000,4941,5.88398e+18,175.506,1381.03,12941,111,103,8087,4644,1096,2164,1061
33464,129,186,20652,12812,5.87003e+18,82.901,1903.91,33464,81,85,33278,33250,29726,30259,29544
98017,337,342,60491,37526,5.8704e+18,152.02,3528.3,98017,120,117,97675,97675,97671,97674,97675
17927,209,219,11089,6838,5.87015e+18,103.869,1299.11,17927,73,81,17708,17708,17503,17620,17700
85103,49,252,52607,32496,5.87023e+18,146.542,3233.62,85103,107,107,81301,75780,23969,29666,30465
56235,106,259,34563,21672,5.87068e+18,123.26,2436.93,56235,89,100,55842,55507,25951,25114,22262
59642,147,217,36802,22840,5.8702e+18,111.472,2500.67,59642,88,91,59425,59323,49524,53240,49006
6272,30,108,3874,2398,5.8683e+18,54.7991,673.447,6272,58,59,5418,4315,2135,2417,2747
99658,90,279,61585,38073,5.87009e+18,174.238,3469.8,99658,110,111,98678,98057,44308,41753,43782
38205,238,257,23654,14551,5.8695e+18,127.019,2227.37,38205,98,97,37948,37890,37326,37713,37709
62602,61,257,38710,23892,5.87018e+18,147.735,2735.23,62602,97,100,61250,59741,14654,20257,20308
80228,69,230,49486,30742,5.87011e+18,135.542,2935.62,80228,94,98,79392,78442,29729,33980,36773
49178,14,235,30408,18770,5.87009e+18,121.857,2175.97,49178,92,100,32058,19448,5424,7187,4900
82235,200,291,51780,30455,5.89628e+18,235.034,3859.9,82235,208,204,81669,80918,60502,62920,66216
69484,91,208,42910,26574,5.87024e+18,119.72,2734.03,69484,89,90,69136,68973,39542,38666,40791
41295,72,171,25546,15749,5.87e+18,99.1302,1984.53,41295,79,81,41007,40731,20316,18767,22883
2285,54,109,1415,870,5.86778e+18,41.593,392.419,2285,46,44,2176,2135,1705,1767,1756
19426,126,131,12059,7367,5.87037e+18,67.6094,1266.32,19426,70,71,19295,19295,18736,19109,18960
2600,29,103,1599,1001,5.86832e+18,46.1846,412.245,2600,45,44,2335,2096,733,952,899
99525,360,397,61623,37902,5.87271e+18,200.461,4113.39,99525,154,160,99128,99065,91583,95954,91494
90625,51,232,55917,34708,5.86998e+18,134.863,3101.18,90625,93,98,88054,83833,24881,34055,30388
54083,73,234,33326,20757,5.87001e+18,116.442,2274.73,54083,92,102,53386,52970,19873,24318,26508
76017,245,257,47006,29011,5.87046e+18,150.11,3024.46,76017,106,104,75760,75702,75424,75383,72960
24166,75,177,14951,9215,5.8695e+18,81.6896,1570.93,24166,77,80,23922,23795,14667,14523,14845
41117,54,196,25394,15723,5.87063e+18,106.107,2011.22,41117,83,84,40183,38698,15707,17835,15521
64781,149,257,40050,24731,5.87024e+18,147.621,2792.18,64781,98,100,64420,64102,42534,35116,46812
22791,62,149,14043,8748,5.86962e+18,95.5934,1370.72,22791,72,76,22458,22306,10803,11172,13239
1344,58,60,818,526,5.87694e+18,42.9018,251.293,1344,38,39,1284,1275,1256,1280,1284
7601,33,180,4668,2933,5.87109e+18,81.2025,818.468,7601,63,63,6881,6067,1667,2359,1521
78814,27,216,48584,30230,5.86989e+18,132.938,2789.05,78814,95,104,66713,51264,12343,18605,13728
21271,176,225,13083,8188,5.87017e+18,102.598,1388.83,21271,82,85,21046,21026,18215,19836,19267
10613,27,178,6546,4067,5.87052e+18,75.1051,1032.82,10613,71,70,8781,6658,2385,3099,2964
96055,197,338,60041,36014,5.88607e+18,209.456,4324.62,96055,197,207,95393,94700,65516,63504,53920
43667,34,257,27016,16651,5.87e+18,146.826,2390.93,43667,100,98,38018,29701,9785,12443,10878
36240,231,262,22716,13524,5.89224e+18,211.424,2465.56,36240,173,161,35974,35848,33133,33756,34760
75555,37,272,46596,28959,5.87318e+18,218.287,3064.05,75555,151,157,68094,61278,11770,21041,14311
15875,35,127,9766,6109,5.87098e+18,68.8107,1066.57,15875,70,71,14254,12001,3456,5120,3376
70636,135,200,43602,27034,5.87012e+18,121.675,2706.79,70636,87,89,70410,70281,56511,57034,61773
93867,242,285,58569,35298,5.88292e+18,245.165,3889.24,93867,203,203,93530,93270,79885,86443,88216
62820,62,298,38728,24092,5.87085e+18,161.181,2784.26,62820,114,119,61219,59903,18398,23903,20250
23013,180,216,14233,8780,5.8704e+18,154.43,1487.06,23013,85,90,22786,22717,19875,21489,21522
78377,38,273,48503,29874,5.87101e+18,156.571,2844.29,78377,115,128,72945,67311,13441,22179,19403
98086,93,276,60492,37594,5.87331e+18,224.307,3496.72,98086,169,171,95578,93000,33791,40466,36257
26927,108,153,16620,10307,5.87032e+18,87.0602,1548.6,26927,74,77,26764,26676,21099,21979,23479
72340,114,275,44568,27772,5.87051e+18,159.678,2790.98,72340,119,122,71676,70928,33952,33260,32712
90442,228,318,56060,34382,5.87867e+18,238.155,3812.98,90442,191,190,90013,89668,66517,74454,64505
59871,116,269,37400,22471,5.88444e+18,218.749,3059.08,59871,186,181,57560,54693,26971,25232,29921
39276,116,194,24272,15004,5.8701e+18,108.054,2025.8,39276,83,85,39063,38958,27023,25620,26660
26266,251,386,16600,9666,5.9006e+18,196.562,2382.31,26266,167,165,25880,25866,17548,17565,12396
35604,144,258,22032,13572,5.87135e+18,153.43,1955.48,35604,106,107,35218,35026,25055,25077,27481
57954,79,223,35564,22390,5.87082e+18,149.874,2302.76,57954,101,107,57118,56474,23388,24404,25440
1932,73,80,1193,739,5.86864e+18,59.8395,344.015,1932,49,50,1852,1839,1779,1805,1788
25811,148,187,15958,9853,5.86988e+18,100.728,1575.07,25811,81,83,25624,25583,21037,23146,20477
3928,56,98,2413,1515,5.86841e+18,45.7918,513.606,3928,52,52,3830,3802,2569,2580,2343
12952,193,232,7979,4973,5.87372e+18,127.539,1212.45,12952,86,78,12720,12690,11335,12088,11418
96984,217,302,59815,37169,5.8706e+18,167.564,3368.06,96984,119,130,96650,96459,82928,89059,84754
6432,49,114,3965,2467,5.86879e+18,53.6676,701.611,6432,59,60,6223,5978,3899,3801,4112
28464,23,217,17478,10986,5.87009e+18,124.583,1607.31,28464,84,89,23546,18378,3632,6083,5793
58206,144,266,35778,22428,5.87154e+18,169.391,2482.49,58206,114,123,57733,57391,37359,33646,42451
69998,229,266,43099,26899,5.87105e+18,190.828,2720.58,69998,126,130,69717,69620,60890,66032,64441
61456,89,196,37966,23490,5.87011e+18,112.936,2543.71,61456,84,87,61137,61005,34445,32417,37894
34906,201,307,21554,13352,5.8747e+18,207.024,2311.81,34906,132,127,34541,34357,28185,30785,28849
30037,61,154,18499,11538,5.86974e+18,85.3241,1646.23,30037,75,79,29647,29309,13489,13913,14744
37200,13,179,22856,14344,5.87023e+18,117.431,1772.02,37200,83,89,23281,13764,3722,4417,3265
41430,410,426,25863,15567,5.88317e+18,166.506,3266.96,41430,157,156,41004,40987,40945,40953,39743
26301,33,173,16303,9998,5.87014e+18,101.985,1597.31,26301,77,77,23050,17565,5424,7723,6531
1789,49,67,1112,677,5.87324e+18,50.1733,300.233,1789,43,45,1698,1629,1382,1347,1637
64766,51,293,40084,24682,5.87076e+18,165.781,2684.24,64766,114,123,62345,60396,12623,19940,13508
7244,59,237,4490,2754,5.87587e+18,98.2813,991.187,7244,76,78,6694,6311,2488,3344,2794
10679,167,224,6653,4026,5.88524e+18,154.246,1228.47,10679,107,101,10394,10203,8317,8828,8465
25636,43,165,15762,9874,5.87028e+18,115.596,1464.95,25636,77,80,24510,23047,6262,8668,7863
38762,63,183,23877,14885,5.86965e+18,117.44,1834.89,38762,83,87,38135,37759,14469,15852,18267
33573,155,177,20755,12818,5.8703e+18,78.8705,1821.11,33573,78,81,33396,33393,32035,32818,31961
69592,254,260,42890,26702,5.87028e+18,126.933,2724.33,69592,97,105,69332,69329,69330,69331,68909
70947,168,260,43716,27231,5.87076e+18,137.019,2727.56,70947,99,104,70680,70541,58630,56703,65263
73303,167,232,45164,28139,5.87028e+18,135.382,2806.95,73303,92,97,73071,72994,59508,65828,62211
38869,308,315,24077,14792,5.8723e+18,120.877,2384.94,38869,102,100,38554,38550,38525,38541,38483
80580,282,317,49838,30742,5.87292e+18,192.604,3411.77,80580,143,153,80263,80198,71747,76496,73200
30823,3,163,18949,11874,5.87066e+18,111.008,1610.58,30823,76,84,5262,0,205,380,456
71721,14,300,44144,27577,5.8712e+18,188.911,2910.99,71721,113,118,46045,27192,7711,10196,7570
50746,146,312,31376,19370,5.87353e+18,156.794,2765.83,50746,130,130,50107,49687,36433,35733,35514
77496,188,228,47725,29771,5.87006e+18,135.666,2784.17,77496,98,104,77268,77242,73079,75282,76214
91066,63,303,56267,34799,5.87064e+18,158.457,3265.19,91066,117,128,89085,87464,25625,33975,27649
36875,74,164,22669,14206,5.8698e+18,115.092,1763.95,36875,82,90,36416,36169,18314,17629,21539
50353,74,306,31232,19121,5.8747e+18,205.737,2755.06,50353,137,143,48309,46619,16464,22607,16612
85788,116,284,52769,33019,5.87084e+18,146.152,3099.12,85788,116,125,85134,84424,42590,39818,38081
45839,169,226,28337,17502,5.87061e+18,162.864,2065.38,45839,98,106,45563,45397,35039,39819,38476
6742,45,108,4191,2551,5.8685e+18,54.6752,682.755,6742,57,59,6475,6157,3228,3082,2461
60362,83,235,37296,23066,5.87026e+18,120.618,2421.33,60362,95,105,59750,59282,25679,27011,34748
81536,199,411,50488,31048,5.87936e+18,241.195,4089.18,81536,180,192,80850,80259,47307,44879,38214
40687,52,266,25238,15449,5.87469e+18,208.924,2273,40687,125,126,38113,36455,8113,12935,7943
85857,63,342,53044,32813,5.87031e+18,183.419,3375.76,85857,118,110,84007,82019,25213,30418,29249
17559,13,261,11022,6537,5.89046e+18,171.887,1741.06,17559,135,133,9041,4447,1130,2115,793
38168,300,426,23964,14204,5.89174e+18,191.492,3161.25,38168,172,175,37742,37678,30523,30226,21326
23176,23,397,14373,8803,5.87567e+18,138.132,2229.7,23176,115,107,16603,11132,3654,5051,3831
90600,68,215,55870,34730,5.87003e+18,137.677,3048.28,90600,94,100,89644,88737,33804,36478,37742
99642,234,262,61588,38054,5.87018e+18,160.411,3505.93,99642,112,113,99379,99301,97331,98409,98630
50012,143,223,30708,19304,5.87101e+18,127.541,2113.78,50012,95,102,49757,49601,36984,34937,44800
28419,40,381,17599,10820,5.87249e+18,155.303,2229.09,28419,114,112,25742,23151,5285,7507,5762
51327,216,307,32078,19249,5.88892e+18,213.025,3113.27,51327,177,184,50979,50777,39875,40439,39018
20466,84,253,12735,7731,5.88301e+18,196.501,1764.29,20466,135,133,18971,17450,7919,8483,8313
3619,31,77,2230,1389,5.86625e+18,59.895,454.78,3619,54,55,3089,2364,1300,1404,1967
40443,13,262,25181,15262,5.87864e+18,203.874,2382.07,40443,150,149,24667,14587,3641,6217,2256
71965,57,315,44415,27550,5.87266e+18,160.212,3192.6,71965,136,136,69044,66416,20350,25867,21359
36969,132,273,22951,14018,5.87473e+18,210.966,2205.16,36969,128,126,36320,35718,21212,19902,22095
68079,177,200,42032,26047,5.87005e+18,123.977,2663.94,68079,87,89,67879,67868,65279,66315,66146
25331,69,247,15697,9634,5.87001e+18,143.246,1862.21,25331,94,93,24596,24006,10019,9319,9977
35842,71,173,22178,13664,5.86988e+18,95.4168,1865.27,35842,82,80,35560,35171,20747,21547,22015
50821,105,257,31433,19388,5.87016e+18,152.044,2463.22,50821,93,97,50323,50012,25069,21108,25329
52016,209,267,32662,19354,5.8919e+18,213.525,2959.72,52016,185,182,51668,51327,43324,45851,45890
80779,12,274,49717,31062,5.87021e+18,162.253,2877.34,80779,121,127,48948,30565,9220,8954,5180
41589,69,261,26023,15566,5.88545e+18,224.788,2581.78,41589,172,168,37413,33241,9127,13725,12590
12127,223,360,7518,4609,5.87299e+18,113.998,1458.51,12127,87,87,11767,11763,11618,11626,11504
30046,54,286,18663,11383,5.8806e+18,186.943,2244.26,30046,133,135,27107,24766,6560,9772,10246
87778,118,230,54070,33708,5.87024e+18,140.003,2994.35,87778,97,104,87432,87060,57588,53149,68429
61437,90,212,37824,23613,5.87028e+18,132.392,2473.41,61437,93,99,60965,60567,33174,32155,39671
79578,1108,1574,50121,29457,5.88611e+18,238.295,5185.33,79578,233,206,78004,77986,60752,64402,9733
3248,46,70,2020,1228,5.87205e+18,52.5,407.574,3248,50,53,3101,2939,2341,2285,2777
31626,92,178,19429,12197,5.87062e+18,122.892,1630.43,31626,83,91,31303,30982,18393,16638,19478
22272,137,257,13735,8537,5.87045e+18,101.64,1664.04,22272,80,86,21967,21847,12544,10787,13351
28234,134,177,17455,10779,5.8693e+18,81.8177,1696.42,28234,79,81,28057,28028,23330,25199,22967
14341,49,139,8828,5513,5.86974e+18,67.8551,1119.12,14341,65,68,13944,13432,6568,6923,6524
20957,25,150,12953,8004,5.86955e+18,82.6869,1367.54,20957,72,73,17088,12516,3339,4043,4095
43698,80,217,27053,16645,5.87001e+18,124.813,2223.15,43698,88,87,43339,43201,21985,21566,24261
78871,193,397,48853,30018,5.87339e+18,211.849,3678.52,78871,152,162,78248,77762,47281,45716,45616
52627,144,224,32538,20089,5.87029e+18,125.146,2442.59,52627,92,88,52391,52227,45025,46358,46611
52477,41,290,32463,20014,5.87108e+18,175.854,2448.6,52477,109,122,49252,45516,8797,14175,9373
74162,66,327,45983,28179,5.87529e+18,199.846,3472.56,74162,151,146,71159,68227,18270,27618,28625
3870,157,201,2388,1482,5.88423e+18,102.147,699.292,3870,66,66,3669,3639,3088,3333,2811
48942,138,188,30233,18709,5.87018e+18,108.889,2128.93,48942,87,92,48754,48671,39370,41896,43675
8977,100,129,5544,3433,5.86851e+18,67.7309,850.425,8977,61,61,8848,8829,8106,8350,8247
72525,176,274,44747,27778,5.87365e+18,222.555,3015.79,72525,145,154,71925,71355,50636,48744,54571
93139,180,279,57644,35495,5.87139e+18,187.836,3185.76,93139,136,145,92673,92244,63858,62779,71002
78574,50,279,48542,30032,5.87034e+18,167.627,3080.89,78574,104,111,75631,71702,17433,25981,24398
57179,49,275,35206,21973,5.87586e+18,216.134,2712.6,57179,144,140,53209,49994,10430,17314,12787
55412,153,298,34186,21226,5.87075e+18,132.159,2618.41,55412,106,110,55010,54868,42638,42283,44978
37115,172,236,22964,14151,5.87032e+18,123.896,2120.49,37115,91,89,36879,36791,34694,35566,35197
50041,82,189,30857,19184,5.86971e+18,109.82,2136.33,50041,86,93,49587,49236,25551,24732,30896
88165,210,285,54786,33379,5.87787e+18,222.737,3584.86,88165,186,185,87698,87176,67812,74891,72349
2306,27,62,1411,895,5.86701e+18,46.7086,325.969,2306,46,46,1939,1447,918,944,1188
84745,210,294,52250,32495,5.87039e+18,189.87,3060.61,84745,118,122,84428,84276,70285,78124,72398
89920,25,262,55392,34528,5.8703e+18,135.509,3082.82,89920,101,108,73968,55148,11845,19874,13699
45993,257,336,28381,17612,5.87021e+18,124.603,2439.31,45993,90,101,45657,45637,45434,45450,45298
1983,51,95,1211,772,5.87266e+18,42.0424,355.615,1983,40,40,1880,1844,1139,1145,1127
41680,61,224,25653,16027,5.87026e+18,162.918,1976.06,41680,99,102,40642,39913,10144,16153,14910
52498,161,381,32559,19939,5.8753e+18,230.289,2879.56,52498,144,152,51750,51239,23645,23081,14948
26689,91,156,16440,10249,5.86923e+18,98.3379,1528.35,26689,74,80,26462,26330,17830,16703,19633
22360,123,284,13900,8460,5.88151e+18,144.808,1959.59,22360,122,119,21709,21031,14959,15894,14566
66739,174,211,41107,25632,5.86993e+18,133.071,2569.07,66739,91,97,66528,66458,63065,65063,65825
8273,65,82,5101,3172,5.87011e+18,68.1796,698.816,8273,65,67,8148,7988,7000,7433,7631
54203,31,270,33581,20622,5.86991e+18,204.237,2722.48,54203,113,117,45143,32988,9765,13792,9465
85558,266,294,52849,32709,5.87043e+18,176.845,3050.21,85558,115,119,85264,85258,84111,84667,84796
46089,114,182,28403,17686,5.86999e+18,118.5,2130.87,46089,81,85,45865,45718,33331,33032,35049
82341,123,381,50902,31439,5.87093e+18,169.702,3291.56,82341,118,132,81587,80837,32716,32034,35545
12573,28,235,7928,4645,5.90075e+18,184.716,1451.63,12573,132,125,7934,4385,1456,2070,1803
68194,234,259,42045,26149,5.87009e+18,112.003,2695.9,68194,99,102,67935,67920,63658,65609,64966
23618,155,163,14529,9089,5.86912e+18,95.2253,1388.76,23618,74,80,23455,23455,23332,23372,23361
67109,115,200,41419,25690,5.87024e+18,122.079,2632.93,67109,87,89,66845,66661,46475,45110,51569
70236,122,290,44035,26201,5.89193e+18,236.088,3541.09,70236,204,198,67123,62603,29684,29075,34313
55846,192,259,34368,21478,5.87014e+18,121.3,2450.59,55846,93,105,55587,55551,44533,49513,43722
80547,107,273,49969,30578,5.87403e+18,234.323,3188.07,80547,162,162,78787,76906,36219,35203,39917
43610,373,376,26981,16629,5.87102e+18,150.143,2687.54,43610,113,106,43234,43231,43230,43230,43224
99301,46,228,61234,38067,5.87025e+18,141.074,3183.52,99301,98,104,95475,90948,22542,34020,32999
27887,205,257,17328,10559,5.87785e+18,175.78,1934.27,27887,132,126,27580,27385,23364,25126,23493
1958,68,99,1197,761,5.87369e+18,43.9683,356.826,1958,41,39,1859,1851,1469,1548,1439
88205,214,381,54561,33644,5.87085e+18,171.648,3615.97,88205,127,129,87789,87595,75595,73492,75700
89367,138,232,55124,34243,5.87019e+18,151.979,3093.51,89367,93,96,89083,88867,59817,56640,55350
30724,207,218,18910,11814,5.86943e+18,119.7,1660.52,30724,83,89,30506,30471,29448,29841,30024
32986,118,168,20397,12589,5.86918e+18,99.0344,1753.07,32986,77,79,32808,32768,27026,28333,28071
76435,7,285,47108,29327,5.87042e+18,134.642,2924.1,76435,101,107,29817,0,4111,5304,3111
67590,27,269,41812,25778,5.87111e+18,164.406,2647.12,67590,117,124,57944,46548,9123,16183,11739
57976,35,312,35829,22147,5.8745e+18,197.952,2925.38,57976,138,141,50973,43454,9020,15435,7600
49901,214,262,30920,18981,5.87117e+18,166.657,2314.15,49901,112,118,49636,49512,41472,46198,39384
22750,51,226,14069,8681,5.86971e+18,128.556,1696.95,22750,86,88,21516,19762,7361,8165,8804
94567,330,426,59180,35387,5.8872e+18,233.667,4579.73,94567,205,215,94141,94043,76625,80751,62847
93056,4,287,58127,34929,5.88412e+18,209.837,3909.72,93056,202,196,20307,0,34,2419,761
15283,149,157,9388,5895,5.87061e+18,90.1754,1122.21,15283,69,72,15126,15115,14818,14996,14889
19720,10,144,12189,7531,5.86953e+18,89.9052,1283.61,19720,71,72,10287,7023,1665,1900,1517
48154,167,211,29730,18424,5.87e+18,125.773,2192.82,48154,86,93,47943,47914,47156,47650,47017
44401,81,259,27392,17009,5.87015e+18,124.793,2192.32,44401,90,90,43910,43601,22738,21842,24103
87760,168,278,54174,33586,5.87912e+18,229.016,3539.26,87760,192,181,86827,85679,57561,51266,59066
23947,227,291,14886,9061,5.88057e+18,107.522,2004.39,23947,124,117,23656,23623,21963,21995,21450
56049,19,234,34648,21401,5.87052e+18,116.295,2329.15,56049,93,101,42225,28849,7078,13146,6999
96176,56,285,59185,36991,5.87285e+18,195.151,3387.09,96176,158,146,92137,89068,19127,30705,19422
98861,27,278,61140,37721,5.87092e+18,172.971,3255.38,98861,131,135,84523,67436,12130,24014,12876
63995,269,272,39482,24513,5.87353e+18,209.99,2860.01,63995,147,152,63723,63711,62804,63546,63092
9165,5,82,5650,3515,5.86908e+18,69.2853,738.661,9165,66,68,2517,0,53,381,592
24158,85,256,14849,9309,5.87321e+18,134.622,1665.59,24158,99,99,23533,23005,9057,10575,10648
39123,200,285,24390,14733,5.88084e+18,189.581,2519.74,39123,150,147,38779,38568,32309,33029,33113
30094,237,342,18569,11525,5.87069e+18,132.545,2140.02,30094,105,99,29752,29628,25540,27009,26507
87292,216,275,54007,33285,5.87076e+18,159.418,3005.01,87292,121,130,87000,86841,73565,81159,74491
9631,53,379,6025,3606,5.88393e+18,151.019,1493.1,9631,104,106,8080,7123,1883,2762,933
47450,43,195,29265,18185,5.86997e+18,97.9277,2221.78,47450,83,83,44983,41177,15404,18237,18198
44205,303,326,27445,16760,5.87891e+18,147.575,2866.11,44205,146,143,43879,43854,43221,43522,41974
22171,105,253,13637,8534,5.87246e+18,126.942,1582.79,22171,97,97,21712,21336,12866,12719,11470
35992,230,273,22319,13673,5.87343e+18,208.616,2154.56,35992,124,120,35702,35608,32224,34070,34286
48897,1239,4933,30801,18096,5.80426e+18,364.591,9061.42,48897,302,236,43964,42155,11724,21728,5768
70172,20,225,43361,26811,5.87016e+18,152.759,2802.82,70172,94,92,50652,36090,9667,12071,7794
88516,209,381,54759,33757,5.87079e+18,173.527,3527.63,88516,132,135,88086,87878,59183,54233,61524
24489,137,173,15179,9310,5.86987e+18,98.9236,1530.06,24489,75,77,24316,24281,22092,23119,22156
83808,128,285,51640,32168,5.87034e+18,144.283,3035.46,83808,105,106,83439,83080,45096,42441,46706
19430,146,147,11981,7449,5.86992e+18,89.3206,1276.43,19430,70,74,19283,19283,19235,19241,19282
10041,40,81,6184,3857,5.86947e+18,74.9288,778.222,10041,68,72,9243,8236,4482,4462,5254
84005,87,285,51658,32347,5.87141e+18,147.609,3115.18,84005,114,123,82944,81968,23475,32393,30320
42327,187,253,26228,16099,5.86982e+18,145.426,2313.78,42327,99,101,42042,41901,38137,39769,40355
29500,44,158,18247,11253,5.86947e+18,93.8688,1639.68,29500,77,77,28052,25780,9311,11564,10729
42409,77,172,26090,16319,5.86993e+18,108.299,1960.85,42409,81,88,41993,41768,20810,20057,24921
35121,92,295,21634,13487,5.87132e+18,130.677,2112.07,35121,99,100,34512,34049,18787,20723,18500
7342,25,82,4532,2810,5.87038e+18,72.2174,673.488,7342,65,68,5676,3851,1737,2116,2419
56575,33,266,34768,21807,5.87149e+18,169.988,2439.24,56575,115,119,50975,43588,7808,13696,9767
97945,229,338,61217,36728,5.88561e+18,216.279,4345.13,97945,201,207,97507,97211,70910,73591,63966
40891,142,196,25263,15628,5.87013e+18,120.072,2009.06,40891,83,85,40695,40591,36155,36370,38489
10691,143,218,6581,4110,5.87134e+18,108.553,1047.82,10691,79,74,10473,10385,8667,9130,9013
66601,259,298,41082,25519,5.87091e+18,157.976,2859.76,66601,115,121,66303,66231,61174,64144,61494
3577,138,262,2203,1374,5.86885e+18,87.0254,783.816,3577,65,61,3303,3233,2481,2378,2098
92869,41,281,57077,35792,5.87115e+18,150.803,3167.54,92869,120,128,87715,80851,15942,24640,20407
57027,118,261,35807,21220,5.89071e+18,229.743,3101.27,57027,192,189,54384,50786,26189,24398,30191
36582,181,221,22647,13935,5.87011e+18,114.206,1811.94,36582,85,93,36361,36333,31127,33882,31231
55905,40,260,34393,21512,5.86994e+18,128.168,2408.33,55905,96,100,52550,48049,10764,16720,12515
16998,114,182,10474,6524,5.86985e+18,86.7867,1334.35,16998,75,75,16816,16793,13252,13660,12134
7994,110,114,4972,3022,5.87057e+18,58.6427,716.649,7994,60,59,7880,7880,7705,7825,7880
20925,80,223,12979,7946,5.87069e+18,78.4989,1455.28,20925,78,80,20688,20655,13375,12669,11367
15652,181,238,9624,6028,5.87476e+18,137.577,1354.98,15652,98,92,15392,15284,13403,14316,14476
8685,13,155,5335,3350,5.86983e+18,83.4588,861.856,8685,66,65,5633,3383,1010,1334,1037
9752,71,147,6026,3726,5.86897e+18,81.0962,876.905,9752,65,64,9534,9426,4732,4479,3480
33440,67,189,20632,12808,5.87022e+18,92.602,1765.47,33440,82,84,32994,32600,20073,21940,22603
30771,99,294,18980,11791,5.87167e+18,118.491,2017.42,30771,98,100,30262,29954,20161,22012,19403
18985,147,235,12010,6975,5.90291e+18,190.772,1763.18,18985,153,141,18362,17473,12302,12248,14190
53414,189,200,33008,20406,5.86984e+18,114.12,2327.17,53414,87,86,53214,53214,53131,53162,53072
38247,132,299,23648,14599,5.87493e+18,152.922,2407.79,38247,129,129,37539,36879,23709,23402,20888
91938,147,325,56995,34943,5.87833e+18,223.863,3968.3,91938,177,191,90551,89189,53454,54168,49989
13033,57,80,8016,5017,5.86999e+18,69.1851,874.396,13033,70,72,12776,12332,9773,8923,10965
47385,82,243,29149,18236,5.87011e+18,164.577,2143.1,47385,103,105,46586,45928,15250,19682,16254
37603,46,310,23285,14318,5.87508e+18,142.614,2447.77,37603,121,121,34439,31112,11106,13551,9692
64276,51,274,39660,24616,5.87356e+18,208.157,2857.98,64276,142,149,60483,57763,13732,21421,18084
11394,138,224,7117,4277,5.88637e+18,170.082,1286.71,11394,112,108,10958,10549,7408,7139,8027
23279,4,150,14314,8965,5.8702e+18,79.7818,1430.64,23279,71,74,5335,0,38,512,803
7191,205,219,4438,2753,5.87759e+18,100.051,918.885,7191,74,76,6972,6970,6781,6885,6842
37673,184,212,23296,14377,5.86996e+18,123.763,2065.58,37673,85,82,37461,37442,36573,37060,36354
54695,174,264,33606,21089,5.87153e+18,185.445,2418.77,54695,122,123,54310,54030,39835,40581,43154
60616,126,304,37403,23213,5.87464e+18,199.815,2968.3,60616,147,148,59580,58446,33480,32369,28087
95173,92,426,59142,36031,5.87776e+18,178.809,4566.28,95173,166,169,92076,88560,44248,42553,47121
52805,173,197,32638,20167,5.87028e+18,117.591,2346.09,52805,84,88,52608,52592,50417,51738,51732
48458,209,211,29935,18523,5.86989e+18,121.191,2330.42,48458,88,90,48247,48247,48245,48247,48247
24585,105,174,15124,9461,5.86927e+18,103.336,1420.66,24585,74,82,24370,24227,16766,16296,17630
53986,71,309,33547,20439,5.88092e+18,185.51,3072.14,53986,168,172,50189,46519,18429,25415,17521
46566,10,273,28921,17645,5.87543e+18,215.017,2495.3,46566,145,142,24992,17244,3666,5787,1705
54332,122,260,33494,20838,5.87017e+18,131.377,2425.88,54332,93,94,54002,53749,38289,40360,43175
99941,250,285,62195,37746,5.87824e+18,233.986,3829.06,99941,198,194,99625,99470,86839,93268,93535
38162,125,181,23592,14570,5.87009e+18,118.171,1798.58,38162,85,89,37963,37806,28400,28755,31778
74479,196,282,45941,28538,5.87334e+18,218.335,3066.23,74479,152,154,74031,73573,52401,59212,50973
18304,84,143,11275,7029,5.86956e+18,92.3738,1229.41,18304,69,72,18099,18019,12272,11915,13454
23060,129,254,14176,8884,5.87362e+18,134.807,1626.35,23060,99,100,22687,22396,13352,12377,13108
68614,32,242,42448,26166,5.87007e+18,143.302,2829.92,68614,95,96,59069,44765,13352,18912,14769
74966,150,219,46312,28654,5.87033e+18,145.173,2892.84,74966,96,93,74722,74548,60862,64158,62620
21570,65,154,13279,8291,5.86979e+18,79.0413,1376.36,21570,70,74,21314,21171,11537,11907,12994
44789,124,275,27601,17188,5.87583e+18,192.629,2421.43,44789,134,134,43919,42985,24627,22797,28417
97903,286,306,60364,37539,5.87055e+18,152.7,3411.59,97903,120,124,97597,97583,92327,95344,93321
42554,17,257,26191,16363,5.87068e+18,171.323,2130.94,42554,109,113,31317,21817,5327,7824,3778
29000,202,279,17949,11051,5.87006e+18,121.551,2013.21,29000,99,96,28701,28604,25821,26666,27253
59679,270,304,36849,22830,5.87422e+18,200.857,2952.08,59679,146,147,59375,59340,51957,56186,53299
64514,101,203,39749,24765,5.86978e+18,129.366,2530.42,64514,91,96,64147,63857,38665,36635,45189
94989,199,262,58708,36281,5.87025e+18,152.567,3417.75,94989,110,110,94684,94539,86483,90592,91888
26011,131,246,15984,10027,5.87101e+18,121.858,1683.62,26011,90,93,25745,25601,16438,15262,15267
71340,55,272,44017,27323,5.87367e+18,232.472,3026.43,71340,157,157,67349,64492,14975,24220,16802
31536,32,173,19443,12093,5.86947e+18,105.094,1681.1,31536,78,84,28084,23123,6489,9568,9215
3288,47,207,2031,1257,5.87662e+18,56.1131,647.238,3288,56,57,2964,2742,1672,1592,1362
17843,147,249,11005,6838,5.87235e+18,140.822,1425.06,17843,93,94,17540,17405,11578,10385,9107
65859,216,271,40753,25106,5.87018e+18,194.011,2963.06,65859,110,115,65555,65436,56144,60990,60970
7678,58,76,4719,2959,5.8722e+18,67.2753,659.014,7678,62,62,7529,7312,5717,5528,6564
55958,110,208,34566,21392,5.87033e+18,115.863,2460.34,55958,88,88,55701,55552,36620,34089,34813
6536,210,221,4071,2465,5.87269e+18,99.6864,889.829,6536,76,73,6315,6315,6281,6299,6296
97138,52,282,59811,37327,5.87129e+18,190.7,3298.35,97138,143,150,93099,89978,18279,30382,18733
45303,381,426,28302,17001,5.88372e+18,181.021,3427.79,45303,162,164,44877,44837,42718,43567,40449
9809,58,231,6095,3714,5.87733e+18,157.805,1124.03,9809,86,80,9040,8501,2401,3442,2229
33068,195,327,20438,12630,5.87031e+18,136.273,2228.89,33068,100,97,32718,32584,30178,29855,30973
4188,25,142,2582,1606,5.86737e+18,61.3324,607.177,4188,56,54,3475,2737,958,1231,1046
22896,226,258,14181,8715,5.87086e+18,138.989,1627.78,22896,94,98,22638,22603,19730,21357,20141
60281,256,265,37103,23178,5.87106e+18,159.174,2522.19,60281,112,123,60016,60016,59006,59533,59634
88961,19,217,54855,34106,5.87014e+18,132.611,3044.06,88961,94,99,64713,42312,10954,15219,10150
32463,74,307,20267,12196,5.88575e+18,188.296,2493.03,32463,154,156,29673,26811,12061,15155,10667
16484,70,153,10210,6274,5.87011e+18,74.8568,1137.76,16484,69,73,16249,16124,10597,10519,10919
10764,107,220,6783,3981,5.89838e+18,176.29,1302.09,10764,123,112,9950,9042,5332,4931,6205
10025,107,236,6198,3827,5.87354e+18,137.107,1110.64,10025,83,84,9656,9380,5049,5211,5301
95195,123,285,58629,36566,5.8703e+18,149.41,3218.57,95195,106,109,94772,94337,54707,53336,67326
71816,32,228,44275,27541,5.8699e+18,133.089,2669.36,71816,95,98,64038,52989,12087,18178,17049
2563,48,97,1579,984,5.86285e+18,44.0187,402.576,2563,45,46,2455,2420,1266,1389,1262
40489,5,197,25047,15442,5.86976e+18,109.563,2054.3,40489,84,83,11188,0,174,1830,1731
47380,249,259,29206,18174,5.87014e+18,133.332,2260.79,47380,90,97,47121,47114,46447,46867,47117
6655,54,166,4102,2553,5.86731e+18,68.1427,792.242,6655,67,69,6312,5891,3925,3642,4506
30563,58,192,18898,11665,5.86969e+18,110.959,1772.96,30563,78,79,29969,29173,9943,11870,11867
91242,270,282,56409,34833,5.87088e+18,153.77,3149.47,91242,118,129,90960,90957,89524,90462,90550
69567,193,304,42849,26718,5.87379e+18,201.903,3099.18,69567,151,148,69083,68705,47212,43354,43831
33421,296,328,20884,12537,5.88506e+18,127.906,2599.98,33421,144,141,33093,33084,31604,31839,31058
40698,32,173,25143,15555,5.87008e+18,97.7883,1937.28,40698,81,86,36063,29229,8322,12040,11285
43298,158,215,26742,16556,5.86972e+18,124.625,2215.1,43298,87,87,43083,42957,40071,40580,40788
61876,64,304,38121,23755,5.87459e+18,211.033,2932.52,61876,151,147,58984,56525,13671,22056,14039
27161,201,260,16990,10171,5.88906e+18,214.751,2146.27,27161,152,154,26826,26576,22183,23631,22225
18610,26,168,11494,7116,5.86989e+18,84.3074,1371.18,18610,76,75,15303,11344,3339,4229,3902
38858,189,190,23992,14866,5.87024e+18,95.9548,1915.33,38858,83,85,38668,38668,38667,38668,38668
50799,238,273,31507,19292,5.874e+18,181.205,2541.1,50799,139,135,50505,50428,44419,47779,46757
71319,151,324,44196,27123,5.87831e+18,193.636,3473.46,71319,175,177,70264,69175,41186,41699,34709
16748,86,253,10435,6313,5.88433e+18,195.783,1612.33,16748,124,124,15524,14291,6490,6811,7437
59333,128,312,36849,22484,5.88046e+18,195.242,3200.03,59333,167,172,57821,55950,29938,30684,23954
16125,63,256,10059,6066,5.88126e+18,188.301,1545.7,16125,109,114,14680,13511,4359,6218,5185
24179,210,290,14929,9250,5.87266e+18,92.8293,1769.39,24179,89,89,23889,23841,22598,22955,22444
71686,219,298,44204,27482,5.87085e+18,154.125,2943.16,71686,115,120,71372,71250,61107,66180,59552
97863,104,294,61238,36625,5.88947e+18,242.105,4142,97863,213,210,92127,85405,35953,37723,38778
91261,64,279,56354,34907,5.8702e+18,155.291,3353.46,91261,111,115,89537,87788,29704,36625,36680
23858,113,214,14645,9213,5.87148e+18,134.288,1487.05,23858,84,85,23573,23339,15886,16189,18941
64762,141,304,39911,24851,5.87431e+18,202.642,3029.91,64762,148,149,63877,63277,34854,32813,29914
59604,81,426,37193,22411,5.88328e+18,187.379,3880,59604,172,177,55542,51005,21489,22178,19327
1103,9,52,673,430,5.86545e+18,40.1088,215.53,1103,37,35,505,0,107,161,226
73220,61,219,45234,27986,5.87009e+18,147.42,2859.9,73220,96,93,71986,70395,26119,29028,29077
17969,107,255,11054,6915,5.87208e+18,140.013,1457.06,17969,93,97,17523,17130,8651,8474,7528
83756,136,285,52205,31551,5.88141e+18,241.252,3615.29,83756,194,193,81861,79690,42315,38391,46401
39339,232,400,24464,14875,5.88615e+18,227.853,2882.24,39339,167,171,38910,38751,24413,21958,11861
29152,20,159,17989,11163,5.87042e+18,81.614,1655.81,29152,75,79,21489,15425,4110,6042,4823
26070,2,175,16077,9993,5.87001e+18,83.5604,1628.86,26070,79,79,2329,0,218,0,101
50096,15,327,31106,18990,5.87897e+18,144.632,3009.88,50096,142,147,30406,16527,4635,6904,4241
64124,290,295,40175,23949,5.89135e+18,213.467,3414.26,64124,192,196,63829,63825,63548,63726,63529
38264,71,191,23602,14662,5.87028e+18,100.243,1946.34,38264,84,88,37824,37552,21039,22269,23219
83976,51,342,52149,31827,5.87986e+18,205.821,4006.66,83976,175,171,75959,68730,15954,24536,23465
50481,16,263,31087,19394,5.87068e+18,166.652,2326.25,50481,111,116,35491,24546,6558,9969,5439
25944,117,256,16077,9867,5.87139e+18,139.722,1712.61,25944,97,98,25519,25143,17448,18699,19988
66231,121,213,40810,25421,5.87018e+18,127.281,2574.07,66231,93,98,65959,65691,47458,47096,48344
55468,74,196,34235,21233,5.87011e+18,114.597,2398.6,55468,84,88,55077,54829,27676,27010,28947
33502,152,196,20618,12884,5.87001e+18,105.391,1840.95,33502,81,88,33306,33261,27979,30822,27773
23231,99,259,14358,8873,5.87003e+18,173.597,1829.77,23231,104,109,22442,21833,12962,11435,13310
58901,161,285,36684,22217,5.8795e+18,225.878,3023.47,58901,172,166,58092,57287,37347,35835,41282
87193,102,214,53892,33301,5.87017e+18,131.996,3017.92,87193,93,95,86809,86506,50743,48271,56957
2993,145,200,1882,1111,5.89063e+18,131.647,663.363,2993,77,67,2763,2671,2167,2204,2322
13907,25,261,8742,5165,5.896e+18,178.739,1564.47,13907,133,126,8782,4938,1389,2327,523
24005,21,237,14729,9276,5.87078e+18,109.506,1524.17,24005,91,90,19283,15105,2582,5395,2159
46850,154,261,28778,18072,5.87171e+18,164.597,2226.72,46850,111,115,46432,46194,32852,32502,34968
50715,272,311,31358,19357,5.87395e+18,164.207,2767.54,50715,132,133,50404,50338,45620,48127,46235
22793,47,260,14127,8666,5.86953e+18,167.477,1769.71,22793,93,95,21065,19236,5144,6422,5654
56672,96,285,35255,21417,5.87946e+18,219.648,2936.34,56672,170,158,54428,52050,21534,22320,22153
18556,116,140,11517,7039,5.8688e+18,71.2982,1251.94,18556,69,72,18416,18404,16181,17288,15512
86924,268,277,53509,33415,5.87077e+18,190.16,3083.85,86924,135,136,86647,86647,86534,86591,86584
12654,43,153,7826,4828,5.86993e+18,79.5401,1022.11,12654,68,69,12079,11370,4189,5064,5313
63061,149,342,38941,24120,5.87254e+18,193.623,3108.38,63061,129,120,62574,62237,40763,37572,39376
96957,180,306,59910,37047,5.87081e+18,160.522,3361.12,96957,119,128,96548,96303,70330,64110,72098
17342,95,171,10646,6696,5.86972e+18,100.979,1203.84,17342,71,78,17125,16961,12084,11125,14152
16298,42,145,10059,6239,5.8709e+18,83.5004,1180.63,16298,70,72,15509,14332,4836,6280,6760
47946,239,264,29685,18261,5.87085e+18,170.34,2264.35,47946,114,117,47682,47629,43010,45607,46192
95236,12,397,58973,36263,5.8727e+18,202.971,4049.01,95236,151,160,53722,32944,9533,11086,6298
34421,119,220,21178,13243,5.86989e+18,123.825,1769.37,34421,87,92,34139,33915,21615,20627,26586
4909,155,190,3041,1868,5.87067e+18,65.1823,677.896,4909,57,57,4719,4719,4131,4460,4077
14356,41,133,8896,5460,5.86932e+18,80.4994,1051.12,14356,65,65,13692,12657,4967,5745,4735
75311,74,290,47151,28160,5.89022e+18,232.612,3655.07,75311,204,198,67237,58416,15981,24274,21619
40276,91,257,24799,15477,5.87141e+18,170.317,2083.1,40276,107,110,39494,38746,17294,18700,22843
8466,217,245,5260,3206,5.86855e+18,174.896,1147.17,8466,97,99,8220,8192,8029,8006,8049
68680,171,266,42201,26479,5.8716e+18,190.992,2695.08,68680,125,124,68245,67936,48401,45902,52224
4468,80,101,2742,1726,5.86918e+18,46.7681,550.2,4468,52,52,4367,4367,3987,4167,3840
11730,105,179,7237,4493,5.87034e+18,78.8713,1079.82,11730,71,71,11551,11490,9275,8809,8607
48017,3,287,30143,17874,5.89282e+18,219.055,2939.41,48017,188,177,6696,0,6,463,453
7466,27,126,4620,2846,5.86961e+18,61.9743,736.997,7466,59,60,6470,5192,1821,2301,2398
43436,252,312,26856,16580,5.87497e+18,151.187,2596.18,43436,129,126,43124,43038,39178,40673,37957
41470,64,209,25650,15820,5.8701e+18,108.124,2166,41470,86,85,40810,39811,22819,23314,24711
16287,17,161,10072,6215,5.87026e+18,101.495,1174.64,16287,71,77,11735,7834,1956,3406,2761
11287,238,263,6983,4304,5.87055e+18,181.71,1310.91,11287,99,109,11024,10990,10623,10754,10586
91755,98,286,56859,34896,5.87815e+18,248.151,3715.88,91755,182,193,88446,84923,34838,37639,38114
42429,32,296,26148,16281,5.87137e+18,138.231,2286.95,42429,94,95,37223,29943,7627,8398,8488
31992,35,262,19912,12080,5.88287e+18,210.724,2218.61,31992,154,151,25765,20446,4614,7829,4591
28323,235,257,17525,10798,5.87256e+18,137.647,1772.11,28323,97,100,28066,28022,26012,27144,27590
78890,3613,4052,49710,29180,5.85887e+18,241.177,8200.09,78890,280,224,74838,74838,62068,67005,15029
66798,116,397,41358,25440,5.87274e+18,183.406,3504.15,66798,144,140,65677,64585,38522,37343,33857
72233,31,273,44832,27401,5.87411e+18,234.359,3044.64,72233,159,157,62181,52355,9361,18606,10537
27857,66,156,17201,10656,5.87058e+18,92.5394,1558.51,27857,76,80,27524,27330,13209,13252,14638
27784,228,253,17210,10574,5.87102e+18,167.759,1757.47,27784,99,101,27531,27484,26649,27215,27050
44603,55,197,27538,17065,5.87044e+18,111.355,2104.56,44603,85,88,43648,42251,15787,18600,16381
87733,28,261,54250,33483,5.87009e+18,173.359,3277.24,87733,108,105,72495,53404,14813,21475,14593
67134,168,257,41534,25600,5.87028e+18,152.208,2878.59,67134,106,104,66774,66498,51714,48198,55295
22711,135,274,14025,8686,5.87444e+18,168,1738.47,22711,100,100,22307,22087,15315,14985,15177
3707,56,128,2279,1428,5.8665e+18,59.0019,520.114,3707,51,50,3550,3469,1653,1694,1804
2584,15,104,1586,998,5.86862e+18,45.1161,429.65,2584,46,46,1793,1107,413,505,584
99800,160,426,61794,38006,5.87305e+18,179.957,4361.23,99800,150,137,99189,98609,78274,82658,80374
42905,56,265,26510,16395,5.87509e+18,186.793,2373.72,42905,142,138,39953,37912,8692,14503,11270
14062,30,200,8699,5363,5.87018e+18,95.4238,1156.23,14062,71,76,12325,10386,2921,4328,3690
89179,39,284,55730,33449,5.8853e+18,215.835,3839.4,89179,203,198,73323,59216,12928,21311,14733
12760,19,82,7866,4894,5.86974e+18,72.1795,875.334,12760,70,70,8852,5528,2270,3115,3230
27207,12,174,16846,10361,5.87014e+18,104.627,1490.19,27207,78,83,16555,10457,2754,3843,2743
22381,207,282,13971,8410,5.88553e+18,150.522,2013.32,22381,131,135,22082,21990,18860,18960,17262
61488,28,251,38052,23436,5.87094e+18,152.984,2421.36,61488,108,113,53408,43752,7859,15796,3607
82296,240,288,50755,31541,5.87001e+18,145.62,3028.52,82296,104,107,82008,81978,77809,78134,80869
42339,167,220,26036,16303,5.87022e+18,135.054,1954.55,42339,91,99,42104,42000,35732,38487,39516
93798,28,227,57958,35840,5.87009e+18,139.991,3158.72,93798,93,99,78762,59483,15124,23405,15487
14920,55,154,9151,5769,5.87082e+18,95.7366,1097.84,14920,68,71,14553,14237,6782,7022,7272
56278,64,222,34792,21486,5.86975e+18,138.012,2445.49,56278,87,88,55509,54544,18165,21205,19335
34738,126,173,21431,13307,5.8696e+18,101.139,1759.4,34738,80,84,34555,34469,27914,30893,28681
40700,19,253,25012,15688,5.87121e+18,158.558,2038.35,40700,107,105,31446,22129,4178,8110,1534
59817,126,258,36903,22914,5.86978e+18,141.214,2503.81,59817,97,102,59500,59224,41639,41697,46159
51663,186,411,32081,19582,5.88129e+18,194.429,3431.59,51663,169,169,51030,50557,31076,31348,26536
94147,208,307,58632,35515,5.88479e+18,248.795,4048.77,94147,205,198,93582,92885,71246,76712,75817
50178,94,285,31269,18909,5.88104e+18,193.928,2840.29,50178,167,166,47845,45120,21503,22604,22749
21860,73,219,13409,8451,5.8706e+18,121.966,1421.61,21860,81,83,21402,21124,9929,9741,10224
14572,214,229,9167,5405,5.89059e+18,178.031,1492.73,14572,129,120,14340,14306,13520,13975,14151
31426,89,257,19317,12109,5.87178e+18,156.49,1861.29,31426,101,100,30752,30177,14509,14313,15268
41993,232,323,25952,16041,5.87129e+18,127.504,2338.23,41993,96,100,41670,41648,41430,41389,41117
33311,6569,13185,21177,12134,5.47132e+18,929.805,17026.1,33311,824,303,20126,19792,11549,11861,5563
81580,63,285,50269,31311,5.87032e+18,146.003,2989.89,81580,107,111,80177,79041,18834,30203,27162
2857,142,175,1757,1100,5.87197e+18,72.0756,560.535,2857,53,54,2682,2648,2305,2504,2180
96467,33,316,59462,37005,5.87309e+18,199.913,3638.67,96467,152,155,84886,70209,13507,24934,14448
47851,39,257,29524,18327,5.87041e+18,122.41,2266.28,47851,91,91,44741,40879,10325,15345,13839
58119,118,279,36011,22108,5.87797e+18,235.527,2920.2,58119,163,165,56476,54604,26936,26421,28852
79278,237,426,49445,29833,5.88244e+18,205.903,4377.4,79278,186,191,78813,78634,60980,57950,47497
79856,201,217,49256,30600,5.8703e+18,136.137,2870.49,79856,91,98,79639,79634,78188,79187,79292
47357,230,267,29357,18000,5.87342e+18,207.193,2378,47357,129,131,47078,46954,40935,44395,44656
2275,103,192,1427,848,5.88529e+18,93.7407,542.953,2275,56,52,2073,1975,1501,1607,1455
44252,200,275,27294,16958,5.87657e+18,217.452,2442.94,44252,143,138,43878,43601,35460,38687,35679
33008,309,411,20548,12460,5.88662e+18,218.668,2788.53,33008,160,164,32597,32518,26539,28041,19883
43858,84,180,27047,16811,5.86988e+18,119.237,2050.82,43858,83,88,43497,43274,24228,22317,27327
3976,88,102,2461,1515,5.86584e+18,46.758,520.478,3976,51,51,3874,3874,3630,3769,3714
65266,339,397,40451,24815,5.87315e+18,181.896,3428.07,65266,148,146,64869,64773,58444,61758,56376
29588,130,245,18312,11276,5.87029e+18,118.993,1806.87,29588,82,83,29338,29223,25104,26701,25362
82423,280,285,51288,31135,5.87838e+18,246.869,3541.55,82423,177,186,82138,82107,79344,81158,81093
30356,10,260,18662,11694,5.8731e+18,139.167,1842.55,30356,103,102,16498,11430,2517,3707,1542
87583,10,249,54134,33449,5.87024e+18,153.388,3189.09,87583,97,101,42817,28548,7437,8412,5484
51303,148,285,31961,19342,5.88111e+18,201.89,2863.36,51303,167,166,50383,49432,32388,31802,34213
44086,142,260,27284,16802,5.8702e+18,189.816,2474.89,44086,111,109,43542,42956,31584,28134,34717
2315,199,201,1460,855,5.87748e+18,73.378,566.995,2315,57,57,2114,2114,2113,2114,2112
92302,143,281,56841,35461,5.87071e+18,167.626,3139.56,92302,123,131,91740,91326,52868,49265,58054
87012,198,397,53903,33109,5.87313e+18,216.142,3650.14,87012,152,165,86413,85937,46700,42763,42057
95521,276,381,59048,36473,5.8706e+18,175.515,3751.54,95521,122,119,95140,95040,92409,92764,91170
21131,186,214,12959,8172,5.87114e+18,117.776,1397.75,21131,78,80,20917,20870,19737,20422,20551
73177,126,288,45140,28037,5.87005e+18,135.871,2875.12,73177,104,105,72815,72476,42681,41341,40833
39506,121,222,24411,15095,5.86988e+18,119.314,2162.11,39506,89,88,39230,39101,30600,30929,30368
51576,165,302,31846,19730,5.87402e+18,149.46,2719.89,51576,133,130,51079,50717,35049,31762,31230
4210,84,197,2677,1533,5.90368e+18,138.328,795.601,4210,91,83,3613,2951,1848,1750,2148
99904,131,286,61877,38027,5.87771e+18,229.845,3842.14,99904,197,188,97863,95457,47207,46234,46860
89249,233,234,54971,34278,5.87014e+18,130.507,3004.85,89249,99,105,89015,89015,89015,89015,89012
85298,96,252,52742,32556,5.87006e+18,147.901,3239.2,85298,109,107,84611,84174,48655,43467,50044
52888,252,255,32490,20398,5.8714e+18,162.67,2343.16,52888,114,110,52633,52633,52631,52631,52633
49632,86,297,30669,18963,5.87111e+18,136.316,2466.78,49632,96,101,49011,48568,25855,25511,32171
82141,234,294,50727,31414,5.87027e+18,172.466,2972.11,82141,113,117,81847,81813,80221,80936,80819
57745,11,210,35706,22039,5.87009e+18,115.229,2490.88,57745,88,88,30568,19348,5330,5638,3362
49870,64,266,30643,19227,5.87254e+18,191.288,2374.3,49870,124,125,48113,46738,11804,18314,18667
32383,28,262,19952,12431,5.87216e+18,148.701,1898.92,32383,99,108,27615,22217,5929,8476,6850
55826,91,411,34671,21155,5.87634e+18,161.178,3486.35,55826,153,145,53931,51876,29035,28812,27266
68383,156,225,42233,26150,5.87004e+18,127.868,2742.4,68383,90,90,68156,68053,57807,61815,60087
60085,168,214,37070,23015,5.86977e+18,119.507,2511.16,60085,90,92,59871,59829,52631,56400,52293
96015,42,282,59030,36985,5.87083e+18,154.53,3224.63,96015,121,130,90965,84556,16345,26568,19853
35215,155,272,21750,13465,5.87493e+18,166.094,2187.11,35215,127,127,34723,34401,26502,25044,25639
11748,157,182,7252,4496,5.86922e+18,86.4002,1142.48,11748,72,75,11566,11547,10985,11296,10804
19965,140,246,12563,7402,5.896e+18,193.931,1809.44,19965,150,145,19207,18324,12055,11384,12844
86562,19,317,53553,33009,5.87296e+18,193.07,3494.83,86562,149,155,64137,43861,10464,15771,6094
17810,133,270,11218,6592,5.90047e+18,165.746,1847.68,17810,150,141,17040,16045,9543,9392,7643
1578,66,82,967,611,5.85804e+18,36.6667,298.818,1578,37,36,1496,1491,1352,1426,1342
38407,157,217,23773,14634,5.87033e+18,110.199,2098.96,38407,86,87,38190,38064,35498,36461,35448
25699,25,162,15927,9772,5.86939e+18,93.0678,1438.27,25699,73,79,21421,16219,4992,6599,5941
94955,230,283,58373,36582,5.87204e+18,192.232,3276.83,94955,148,146,94653,94519,79976,88212,84478
28965,154,308,17977,10988,5.87388e+18,124.433,2129.48,28965,111,104,28539,28334,23661,23345,21869
47631,186,188,29422,18209,5.87006e+18,117.555,2070.75,47631,88,94,47443,47443,47442,47443,47443
32825,96,156,20260,12565,5.86954e+18,89.7487,1734.26,32825,76,81,32626,32548,22253,21360,24659
84280,218,236,52088,32192,5.87013e+18,143.849,3086.57,84280,94,99,84044,84029,83971,84006,83889
79837,81,274,49459,30378,5.87275e+18,199.512,3055.81,79837,147,145,77765,75930,20418,29739,24019
64833,105,211,40035,24798,5.87001e+18,110.121,2641.62,64833,86,87,64556,64392,43112,39623,40514
89957,381,397,55707,34250,5.87228e+18,174.805,3915.16,89957,150,147,89560,89534,88017,89038,87678
75760,114,411,46898,28862,5.87865e+18,209.358,3967.18,75760,180,180,73532,71008,27205,32383,24125
9671,322,397,6027,3644,5.88212e+18,142.357,1582.73,9671,106,100,9274,9229,8249,8345,7497
76897,145,270,47261,29636,5.87148e+18,198.874,2903.77,76897,135,139,76226,75697,45521,38992,46504
60586,182,264,37215,23371,5.87121e+18,170.047,2525.13,60586,119,124,60241,60003,45094,48057,48457
56954,229,234,35133,21821,5.8699e+18,116.398,2350.71,56954,93,99,56720,56720,56343,56574,56535
68495,218,269,42396,26099,5.87114e+18,162.342,2661.84,68495,116,127,68214,68065,57558,63911,59911
95569,8,307,59525,36044,5.88485e+18,246.012,4082.64,95569,203,200,38353,0,5483,7730,3452
90618,24,342,56334,34284,5.88071e+18,188.598,4163.98,90618,178,182,66659,45220,11078,16300,11364
72939,36,274,44949,27990,5.87195e+18,205.834,2905.83,72939,141,149,65976,59411,10814,18920,8241
44657,104,307,28000,16657,5.89094e+18,169.959,2975,44657,172,176,42088,39020,23602,23018,17198
31418,129,172,19326,12092,5.87055e+18,104.033,1681.31,31418,77,84,31242,31186,25386,28313,25650
94278,242,301,58196,36082,5.87075e+18,167.361,3325.27,94278,119,128,93969,93865,82896,88918,83978
89623,161,316,55297,34326,5.87292e+18,193.051,3558.06,89623,144,148,88965,88482,68001,65545,68147
69684,151,270,43385,26299,5.8837e+18,218.185,3316.29,69684,191,182,68360,66648,42272,39424,44148
54187,146,196,33445,20742,5.86986e+18,98.8292,2389.02,54187,84,88,53991,53932,46004,49589,48087
42075,93,260,25902,16173,5.87086e+18,137.979,2112.57,42075,103,108,41403,40797,20234,21130,24326
80383,62,262,49557,30826,5.8702e+18,146.493,2905.96,80383,103,109,78968,77889,23606,30145,32474
35856,246,255,22159,13697,5.86982e+18,116.403,1967.64,35856,89,87,35601,35595,35275,35451,35601
64530,181,258,39776,24754,5.87053e+18,143.829,2628.11,64530,99,105,64272,64142,57643,58782,61501
66860,91,342,41224,25636,5.87041e+18,148.516,3002.03,66860,115,111,65963,65287,29120,30686,31665
95888,215,411,59394,36494,5.87695e+18,188.082,4384.26,95888,179,181,95361,95012,71925,68577,60844
16779,124,130,10352,6427,5.86886e+18,68.336,1133.01,16779,70,73,16649,16649,16486,16637,16638
92347,171,317,57081,35266,5.87282e+18,196.36,3609.6,92347,151,155,91707,91175,69076,66229,67743
65506,240,276,40644,24862,5.87405e+18,204.256,2890.16,65506,146,148,65213,65094,55117,61084,56688
44077,139,262,27806,16271,5.8979e+18,210.099,2752.63,44077,188,179,42568,40345,24991,22389,27572
39588,69,268,24454,15134,5.87469e+18,161.072,2268.22,39588,130,133,37753,36058,9977,15296,12170
15569,24,245,9625,5944,5.87063e+18,177.167,1479.61,15569,93,99,11423,7658,2343,3116,2680
65095,94,203,40151,24944,5.87016e+18,125.325,2585.95,65095,90,93,64711,64454,34952,32424,39217
66936,266,381,41419,25517,5.87122e+18,176.308,3126.26,66936,126,134,66555,66440,50300,54551,48368
35767,66,279,22146,13621,5.87041e+18,131.56,2176.98,35767,98,103,34794,34138,10785,13439,13485
4425,120,214,2771,1654,5.88492e+18,132.475,808.602,4425,81,78,4126,3856,2766,2538,2742
46958,116,264,29256,17702,5.87915e+18,202.777,2602.46,46958,164,151,45444,43617,21674,20471,22531
71667,129,273,44378,27289,5.87107e+18,159.277,2731,71667,120,124,71089,70551,37885,36871,45000
53542,33,273,33181,20361,5.87403e+18,198.094,2596.8,53542,142,137,46877,39572,7823,14138,6604
96752,106,282,59829,36923,5.87069e+18,150.881,3246.28,96752,121,130,95920,95029,45456,46239,57198
3628,144,203,2278,1350,5.89704e+18,112.911,719.048,3628,78,70,3403,3310,2740,2726,2791
58625,145,285,36542,22083,5.88034e+18,205.448,3022.26,58625,172,171,57503,56379,32951,30338,29623
96102,91,411,59431,36671,5.87712e+18,196.716,4361.16,96102,181,181,92745,89025,31168,38252,29020
5932,130,135,3635,2297,5.86947e+18,70.4282,665.526,5932,57,59,5797,5794,5764,5791,5797
5568,84,121,3439,2129,5.86871e+18,65.8172,645.774,5568,55,59,5440,5407,4176,4184,4110
57719,39,261,36198,21521,5.88966e+18,229.734,3097.87,57719,189,186,45243,34139,8562,13329,10851
11126,96,180,6869,4257,5.8706e+18,86.6529,1109.1,11126,73,74,10937,10901,7854,7248,6553
45358,153,285,28247,17111,5.87955e+18,213.766,2682.77,45358,158,152,44600,43849,28303,25964,29997
50280,20,304,31018,19262,5.87527e+18,208.33,2737.34,50280,143,143,37438,27290,5223,10020,3742
84563,79,271,52363,32200,5.87147e+18,186.621,3028.68,84563,132,141,82822,81391,20706,31403,27807
30446,136,273,18784,11662,5.87762e+18,174.954,2061.58,30446,127,128,29798,29218,17680,16873,16606
88297,85,294,55489,32808,5.89472e+18,243.855,4023.01,88297,211,210,79397,68716,24346,28707,28247
39588,65,287,24865,14723,5.89403e+18,211.885,2696.32,39588,177,176,33639,27533,8517,12223,10380
57142,207,211,35354,21788,5.86994e+18,121.195,2463.3,57142,86,89,56931,56931,56927,56931,56931
90789,16,301,55888,34901,5.87092e+18,206.114,3267.43,90789,126,127,63256,43072,9795,13228,6609
14283,70,126,8844,5439,5.86967e+18,60.3025,1073.91,14283,65,69,14156,14094,10254,9933,9149
29523,107,216,18271,11252,5.87023e+18,127.2,1641.77,29523,85,89,29217,28955,17718,17141,23388
50056,181,266,30985,19071,5.88294e+18,202.84,2751.58,50056,173,158,49536,48921,36349,37840,38757
35520,15,260,22200,13320,5.88858e+18,208.997,2400.16,35520,170,159,20302,10640,2797,5205,2270
11046,72,149,6775,4271,5.87135e+18,78.365,934.734,11046,64,68,10831,10713,5578,5004,5355
62992,158,271,39007,23985,5.8708e+18,160.963,2578.54,62992,118,122,62607,62331,40691,35295,36262
48941,161,217,30134,18807,5.87011e+18,124.706,2273.52,48941,87,91,48724,48660,40439,44741,41294
29740,2,155,18370,11370,5.86962e+18,92.5222,1624.53,29740,74,81,2729,0,302,0,266
41186,269,296,25404,15782,5.87136e+18,120.214,2276.42,41186,94,94,40890,40863,39809,40431,40281
27496,54,293,17077,10419,5.87575e+18,101.174,2014.68,27496,114,109,25752,23984,13992,14730,15178
26745,75,217,16433,10312,5.87093e+18,125.026,1562.71,26745,84,90,26240,25907,12208,12400,16805
72213,50,215,44572,27641,5.86989e+18,121.561,2748.61,72213,91,95,69965,66634,20148,26466,25788
44289,121,197,27260,17029,5.86996e+18,124.339,2079.85,44289,88,93,44062,43901,35714,37564,38005
28632,42,297,17854,10778,5.8843e+18,148.13,2307.63,28632,146,140,23800,19121,7402,8954,7126
65440,218,268,40202,25238,5.87136e+18,158.622,2609.74,65440,117,123,65161,65074,54941,60849,57086
55562,49,286,34982,20580,5.89601e+18,230.434,3178.89,55562,193,189,43427,31935,9066,12944,11731
35952,45,173,22241,13711,5.87036e+18,94.8534,1867.15,35952,80,80,34111,31642,12101,13755,15071
40963,293,301,25286,15677,5.87135e+18,129.706,2310.3,40963,98,99,40662,40662,40507,40631,40583
81336,41,279,50290,31046,5.87089e+18,150.073,2984.08,81336,114,125,76699,70604,14638,22419,17753
30147,84,263,18720,11427,5.88125e+18,204.521,2104.15,30147,145,145,28258,26394,10655,12378,12485
13744,121,134,8432,5312,5.86969e+18,69.7912,1013.98,13744,67,67,13610,13586,12963,13224,13107
27472,90,217,16962,10510,5.86996e+18,125.069,1800.44,27472,85,86,27152,27030,15490,13827,14187
86251,119,273,52977,33274,5.87149e+18,178.491,2994.88,86251,130,132,85469,84583,42902,39592,44381
10605,42,127,6547,4058,5.86825e+18,68.7317,881.119,10605,70,69,9815,8720,5362,4951,6641
45429,148,275,28030,17399,5.87774e+18,233.715,2534.12,45429,145,150,44692,44119,26981,22712,27201
34641,204,310,21466,13175,5.87372e+18,122.964,2322.42,34641,113,107,34317,34251,31365,31415,30026
28341,11,261,17768,10573,5.88926e+18,208.029,2171.07,28341,160,150,13555,7526,1640,2949,1343
47769,25,279,30164,17605,5.89999e+18,220.201,2895.09,47769,190,184,28279,13824,4523,7150,4594
21926,103,261,13741,8185,5.88796e+18,192.624,1908.46,21926,150,132,20646,19245,9441,8986,9805
90715,142,411,56151,34564,5.8793e+18,234.018,4261.25,90715,186,194,89037,87408,42725,42387,33233
71222,237,271,44347,26875,5.88415e+18,219.593,3358.81,71222,196,185,70920,70733,62468,66808,66515
83118,162,281,51096,32022,5.87137e+18,154.359,2989.05,83118,117,126,82704,82439,56181,48856,55427
61718,29,269,38065,23653,5.87314e+18,200.028,2745.41,61718,143,139,52698,43859,8340,14424,6063
18485,2,148,11414,7071,5.86965e+18,82.2202,1260.25,18485,70,73,1669,0,170,0,161
98625,207,273,61252,37373,5.87506e+18,241.571,3607.47,98625,179,181,98099,97410,77473,86079,80257
72549,181,202,44721,27828,5.86991e+18,124.422,2677.07,72549,89,98,72347,72291,67967,70579,71915
67408,114,275,41483,25925,5.87523e+18,201.807,2900.77,67408,145,146,66135,64786,33011,31029,34354
74334,76,273,45753,28581,5.87096e+18,165.299,2772.06,74334,117,128,72928,71856,20497,29593,28582
18680,76,143,11513,7167,5.87053e+18,75.2891,1272.01,18680,68,72,18508,18478,11259,10519,12480
36873,163,173,22727,14146,5.86953e+18,114.91,1811.46,36873,81,87,36700,36691,36332,36526,36661
67090,22,269,41293,25797,5.871e+18,158.229,2640.17,67090,112,126,53828,41889,9295,13430,7004
66252,242,342,41027,25225,5.8763e+18,155.635,3441.95,66252,146,143,65910,65838,61963,62226,59841
42609,205,216,26353,16256,5.86991e+18,162.158,1989.45,42609,97,101,42382,42320,39781,41318,41335
18412,47,213,11331,7081,5.87014e+18,100.364,1281.63,18412,76,83,17678,17194,4657,6555,7085
65394,243,298,40400,24994,5.87071e+18,149.098,2808.37,65394,108,113,65096,65000,61879,63589,61052
7860,126,199,4879,2981,5.86998e+18,79.1883,887.901,7860,70,73,7661,7622,5206,4610,3557
8956,96,220,5510,3446,5.87161e+18,121.549,990.854,8956,81,76,8634,8381,4507,4449,4232
51041,112,273,31704,19337,5.876e+18,234.81,2651.93,51041,151,151,49676,48276,23691,22175,23704
5378,42,76,3304,2074,5.86846e+18,63.4474,546.679,5378,57,58,5059,4595,2820,2634,3574
12162,74,80,7570,4592,5.86915e+18,68.9278,838.353,12162,67,68,12082,12069,12052,12060,12075
1702,3,83,1043,659,5.8678e+18,35.1116,310.34,1702,40,40,300,0,3,13,35
96925,155,230,59729,37196,5.8702e+18,139.712,3143.07,96925,97,105,96682,96504,78991,78000,86274
31932,77,261,19621,12311,5.87157e+18,131.871,1875.23,31932,100,107,31163,30625,10884,14563,15351
72093,42,381,44607,27486,5.87108e+18,169.138,3238.83,72093,129,134,67315,61833,14007,20160,14996
82111,114,303,50707,31404,5.87092e+18,160.547,3129.18,82111,115,128,81398,80683,46379,48649,48686
78052,71,216,48122,29930,5.87014e+18,140.367,2834.67,78052,94,98,77263,76613,30200,31767,35575
97768,158,279,60430,37338,5.87005e+18,149.491,3438.07,97768,109,111,97363,96973,79232,76217,85031
93669,167,286,58047,35622,5.87817e+18,255.008,3761.28,93669,188,193,92626,91422,58124,53152,56583
97441,233,242,60134,37307,5.87021e+18,153.611,3293.21,97441,97,96,97199,97199,97194,97196,97196
11694,26,128,7223,4471,5.86956e+18,67.7065,948.985,11694,68,70,9325,6597,2972,3627,4432
32514,122,155,20104,12410,5.86999e+18,91.0608,1706.57,32514,75,81,32355,32294,27550,29737,29864
32962,123,312,20417,12545,5.87406e+18,124.267,2271.65,32962,105,102,32459,32063,25613,27322,25699
95550,222,381,59071,36479,5.87056e+18,181.272,3746.52,95550,126,121,95152,94996,89043,87814,88722
58191,49,290,35968,22223,5.87114e+18,144.231,2622.05,58191,111,118,55677,53291,17040,21317,19001
78278,107,269,48398,29880,5.87079e+18,144.451,2881.01,78278,115,114,77652,76921,35886,34156,29565
56943,144,326,35370,21573,5.8797e+18,178.372,3238.1,56943,157,167,55962,55021,38334,39413,35424
37480,184,285,23332,14148,5.88052e+18,188.711,2452.25,37480,150,142,37082,36810,28569,30516,30695
35858,163,249,22025,13833,5.87054e+18,135.502,1899.58,35858,87,95,35609,35525,24406,23126,19793
86794,75,301,53458,33336,5.871e+18,191.997,3188.74,86794,120,121,85361,84346,26195,34132,39348
83028,4,306,51217,31811,5.87052e+18,154.27,3131.95,83028,119,124,19617,0,8,1838,1492
13385,159,226,8238,5147,5.86992e+18,116.869,1165.53,13385,83,81,13159,13100,11198,11965,11525
51048,201,245,31588,19460,5.87078e+18,159.56,2221.76,51048,109,110,50787,50699,42550,47411,44776
29714,179,261,18631,11083,5.88875e+18,217.776,2222.3,29714,154,154,29232,28702,20455,21087,20314
67707,90,307,42302,25405,5.88844e+18,226.648,3536.29,67707,185,196,62947,57002,21505,25416,25090
93162,107,295,57399,35763,5.8703e+18,161.245,3156.5,93162,112,119,92543,91889,46725,47703,63358
20960,229,242,12927,8033,5.87248e+18,156.731,1528.48,20960,98,100,20718,20696,19584,20223,20538
39625,383,397,24554,15071,5.873e+18,161.509,2754.19,39625,120,111,39228,39209,39166,39201,39013
11829,23,80,7272,4557,5.86971e+18,69.8867,834.012,11829,69,72,8966,6254,2563,3495,4050
55400,175,231,34077,21323,5.87e+18,155.866,2267.09,55400,104,107,55127,55011,45236,49954,47591
77893,279,285,48445,29448,5.879e+18,224.733,3407.43,77893,181,185,77608,77583,75400,76923,77015
91912,131,262,56617,35295,5.87037e+18,145.697,3099.62,91912,105,111,91546,91224,60714,62277,68657
59352,18,317,37221,22131,5.89114e+18,208.76,3421.82,59352,186,194,34449,17125,4878,8789,3938
16830,192,262,10480,6350,5.87273e+18,74.2193,1401.25,16830,87,84,16568,16557,16246,16240,16057
34926,177,220,21486,13440,5.87032e+18,131.167,1791.88,34926,87,93,34706,34640,29900,32568,31537
54640,138,266,33588,21052,5.87185e+18,166.581,2417.28,54640,112,120,54156,53765,32295,28883,34384
65266,43,266,40178,25088,5.87109e+18,184.117,2628.19,65266,118,127,61695,57655,11598,18507,14994
36726,53,246,22619,14107,5.8709e+18,115.474,1962.35,36726,93,95,35579,34267,12058,15042,15904
39816,56,290,24620,15196,5.87137e+18,166.439,2238.85,39816,106,112,38231,36903,11331,15289,12936
95353,21,426,59493,35860,5.88255e+18,211.042,4748.04,95353,187,199,63173,41100,10747,16628,9162
50600,127,411,31415,19185,5.88034e+18,196.896,3428.48,50600,166,165,49192,47510,26487,26172,23059
93553,43,282,57495,36058,5.87107e+18,167.252,3158.86,93553,124,135,88915,83539,16114,27176,22256
88283,251,281,54585,33698,5.87097e+18,150.566,3113.97,88283,115,130,88002,87984,78076,83799,82195
36295,66,327,22423,13872,5.87074e+18,164.333,2327.65,36295,103,99,35223,34274,12759,13704,13399
6241,90,134,3851,2390,5.86903e+18,64.4304,722.904,6241,58,57,6107,6068,4930,5098,4571
62733,192,326,38792,23941,5.87161e+18,190.772,2900.99,62733,113,115,62376,62288,51471,57176,53923
52729,285,321,32775,19954,5.881e+18,169.658,3117.91,52729,160,164,52408,52360,47962,50143,48215
2141,179,182,1327,814,5.86765e+18,69.3975,499.263,2141,51,53,1959,1959,1957,1959,1959
9548,18,76,5879,3669,5.86938e+18,71.3165,742.223,9548,65,66,6495,4000,1540,2268,2531
80147,25,307,49405,30742,5.87332e+18,206.732,3319.97,80147,154,156,65376,50192,9728,19311,8830
71777,138,281,44528,27249,5.87955e+18,202.139,3287.07,71777,187,177,70330,68858,37549,35676,41579
69037,7,259,42554,26483,5.87013e+18,138.264,2695.17,69037,99,106,27295,0,3790,4288,2321
80259,225,259,49440,30819,5.87021e+18,141.911,2898.71,80259,102,107,80000,79950,73542,77175,79193
10759,50,205,6615,4144,5.86904e+18,89.302,986.128,10759,71,74,10272,10042,3294,4579,4558
24104,122,275,14873,9231,5.87155e+18,82.6751,1696.76,24104,95,90,23777,23598,19872,19908,19504
32230,152,262,19994,12236,5.87998e+18,201.63,2161.69,32230,147,143,31572,30951,20367,18527,19998
79166,12,271,49348,29818,5.8854e+18,224.822,3581.16,79166,202,193,42007,23345,6092,9362,3605
15512,29,215,9518,5994,5.87128e+18,95.1315,1201.58,15512,74,78,13530,11245,2729,4277,2649
32623,269,286,20122,12501,5.87096e+18,121.499,2020.9,32623,103,105,32337,32324,30912,31583,31837
94383,220,282,58022,36361,5.87107e+18,165.665,3190.09,94383,124,133,94079,93990,80032,87906,82253
74855,116,301,46230,28625,5.8709e+18,158.383,3013.39,74855,113,123,74179,73576,43625,45883,47618
76543,79,216,47181,29362,5.87024e+18,130.186,2779.54,76543,91,100,75894,75507,33123,32669,38617
64479,147,300,39726,24753,5.87134e+18,150.414,2796.56,64479,106,112,64061,63873,49429,51622,51412
13772,44,164,8512,5260,5.87004e+18,86.2627,1045.58,13772,71,70,13232,12699,3718,4740,5824
60647,61,270,37929,22718,5.88473e+18,221.699,3106.29,60647,192,181,53814,47752,11959,19227,14693
10379,87,153,6406,3973,5.87057e+18,84.3675,933.452,10379,65,69,10194,10080,6238,5770,5692
49156,189,296,30275,18881,5.87137e+18,135.647,2457.83,49156,96,103,48860,48774,47595,47759,47252
62331,130,286,38662,23669,5.87945e+18,227.459,3105.26,62331,176,168,60839,59129,30156,29510,31169
70804,65,269,43495,27309,5.87238e+18,194.247,2786.97,70804,132,135,68653,66975,16237,25304,22120
50239,154,199,31010,19229,5.87019e+18,113.416,2248.31,50239,85,90,50040,49958,44319,46504,45005
13940,53,137,8632,5308,5.8691e+18,67.9519,1080.07,13940,66,68,13649,13162,6001,5949,5410
17721,107,211,10967,6754,5.87012e+18,94.3017,1258.77,17721,76,78,17483,17306,10865,9958,13492
86037,33,292,52966,33071,5.87035e+18,146.968,3057.94,86037,102,111,77202,63257,12389,21650,15238
21313,257,260,13322,7991,5.8876e+18,196.293,1878.93,21313,142,138,21053,21040,21040,21041,20963
73460,214,227,45362,28098,5.86991e+18,137.586,2807.41,73460,93,97,73233,73228,73153,73172,73197
84635,7,295,52210,32425,5.87024e+18,166.832,3037.5,84635,111,115,33941,0,4710,5761,2714
53183,132,285,33150,20033,5.88151e+18,208.174,2924.05,53183,163,172,51842,50313,29545,29026,29633
42516,85,273,26392,16124,5.87563e+18,218.968,2401.67,42516,137,141,40918,39427,13455,16824,15415
8301,60,127,5107,3194,5.86912e+18,64.2923,788.427,8301,60,59,8140,8053,4142,4167,4166
23007,25,164,14135,8872,5.86987e+18,97.6385,1376.35,23007,74,81,19231,14663,4171,5070,5122
67192,322,411,41609,25583,5.87991e+18,209.963,3746.89,67192,178,180,66781,66680,56147,59866,46406
21883,14,142,13489,8394,5.87011e+18,71.6986,1384.05,21883,70,72,13519,7817,2295,3281,2023
16850,198,242,10435,6415,5.87245e+18,140.049,1375.41,16850,96,94,16593,16523,14305,15634,15127
81636,77,227,50400,31236,5.87003e+18,135.52,2955.02,81636,93,98,81001,80684,32417,33948,36204
26964,56,158,16654,10310,5.86955e+18,97.3376,1572.03,26964,78,79,26420,25446,11855,12028,10837
2734,76,85,1688,1046,5.8681e+18,63.9247,418.595,2734,50,58,2649,2644,2536,2592,2630
58318,143,266,35851,22467,5.87254e+18,187.323,2560.72,58318,130,128,57712,57321,35412,30927,37851
29100,268,297,17995,11105,5.87147e+18,124.733,1950.85,29100,98,96,28803,28779,27340,28187,27632
58977,248,279,36424,22553,5.87049e+18,154.588,2663.27,58977,96,104,58698,58647,53984,54915,53422
62566,23,249,38408,24158,5.87125e+18,152.721,2451.95,62566,110,112,51458,40089,6556,14453,6133
84232,157,217,52047,32185,5.87007e+18,130.407,2983.34,84232,92,97,84003,83863,68125,75233,71564
36733,54,226,22719,14014,5.87017e+18,123.859,1840.27,36733,86,93,35732,34694,9577,13780,15026
96177,199,271,59315,36862,5.87029e+18,148.994,3165.79,96177,110,113,95906,95787,85267,89367,90541
7677,127,234,4733,2944,5.87597e+18,128.248,982.751,7677,80,74,7390,7236,5241,5496,5128
71344,250,262,43975,27369,5.86993e+18,111.9,2776.69,71344,97,102,71082,71080,70326,70773,70391
1437,9,66,887,550,5.86193e+18,49.6381,272.462,1437,41,41,625,0,96,159,238
14712,69,79,9130,5582,5.86979e+18,69.7601,934.635,14712,69,73,14603,14387,13533,13989,14138
77416,212,215,47734,29682,5.87025e+18,140.332,2823.09,77416,93,98,77201,77195,77198,77113,77201
76276,77,259,47062,29214,5.87031e+18,145.89,2838.29,76276,100,107,75405,74832,28649,34106,38341
50773,124,257,31327,19446,5.87033e+18,123.971,2321.01,50773,91,92,50471,50283,38120,40316,42431
83366,176,215,51363,32003,5.87e+18,141.504,2914.75,83366,94,101,83151,83064,75270,79433,81527
12853,234,243,7928,4925,5.87319e+18,142.939,1236.46,12853,85,88,12610,12610,12583,12588,12602
70730,179,273,43896,26834,5.87597e+18,227.547,3083.97,70730,163,169,70083,69388,47180,46759,48010
98384,153,286,61159,37225,5.88201e+18,249.005,3963.64,98384,200,204,96714,94700,57150,52232,57615
35769,21,257,22153,13616,5.87331e+18,150.133,2042.24,35769,113,112,28184,21984,4219,7861,2458
88702,60,306,54826,33876,5.87083e+18,162.564,3218.25,88702,119,128,86547,84674,22207,30626,28563
58932,154,269,36352,22580,5.8735e+18,205.426,2710,58932,146,141,58288,57759,36929,33094,35390
2378,52,75,1469,909,5.86688e+18,57.3507,372.62,2378,51,51,2253,2090,1715,1675,2050
37403,33,248,23015,14388,5.87024e+18,107.137,1979.64,37403,90,90,33341,27205,9794,11962,11288
83406,281,286,51320,32086,5.87085e+18,149.341,3102.72,83406,117,123,83120,83120,83113,83119,83107
76171,130,303,47106,29065,5.87085e+18,159.178,2995.66,76171,116,126,75576,75029,44851,43985,48476
2094,45,71,1293,801,5.86005e+18,54.723,335.394,2094,48,48,1949,1822,1240,1197,1329
8909,50,113,5511,3398,5.86816e+18,56.5496,823.722,8909,62,65,8681,8348,5465,5311,5579
63635,192,328,39432,24203,5.87463e+18,160.648,3155.8,63635,131,127,63288,63199,59799,59551,58559
5389,76,81,3297,2092,5.87004e+18,53.3476,527.836,5389,56,57,5308,5308,5261,5288,5300
70250,295,301,43251,26999,5.87087e+18,186.284,2888.69,70250,109,112,69949,69940,69597,69800,69838
35608,134,266,21908,13700,5.87225e+18,166.192,2001.47,35608,101,112,35146,34817,21771,19933,23479
90420,20,276,55759,34661,5.87292e+18,222.338,3342.96,90420,165,163,69572,52484,11036,19421,8700
29331,131,256,18077,11254,5.87201e+18,145.956,1797.7,29331,98,100,28927,28629,20885,21234,22502
55987,218,259,34520,21467,5.87015e+18,129.18,2450.76,55987,93,98,55728,55672,51161,53878,53558
21219,9,156,13058,8161,5.86974e+18,71.7371,1342.48,21219,75,77,9846,0,1598,2026,2466
20966,100,197,12953,8013,5.86929e+18,102.745,1566.76,20966,83,81,20727,20677,15361,14714,14183
93652,64,284,58041,35611,5.87289e+18,203.37,3387.42,93652,155,160,90200,87374,20745,32607,24504
89274,77,328,55349,33925,5.87469e+18,204.643,3707.41,89274,159,147,86640,84095,28489,33892,35244
55892,177,258,34529,21363,5.87031e+18,138.944,2442.53,55892,94,96,55634,55522,52580,52889,54368
57430,227,242,35473,21957,5.87035e+18,116.785,2406.32,57430,93,101,57188,57188,56307,56865,56176
4641,638,3549,2953,1688,5.49771e+18,55.0442,3814.47,4641,334,69,1092,965,393,441,285
79830,79,232,49237,30593,5.87013e+18,133.142,2928.05,79830,93,98,79217,78890,36197,37118,41379
37806,223,228,23385,14421,5.8698e+18,117.755,2119.8,37806,88,89,37578,37578,37571,37577,37578
8761,188,239,5380,3381,5.87179e+18,88.2559,1028.27,8761,68,73,8522,8500,7424,8006,7101
83479,28,281,51746,31733,5.87307e+18,210.172,3214.45,83479,151,161,70759,57444,10995,19688,8016
51907,56,270,32328,19579,5.88444e+18,225.823,2860.24,51907,182,176,45693,41002,9972,16909,12367
22934,102,246,14164,8770,5.87087e+18,87.0206,1564.05,22934,86,84,22667,22506,16501,16289,16091
91309,102,260,56247,35062,5.87038e+18,145.001,3076.41,91309,106,112,90735,90143,49716,47637,60970
2415,49,67,1488,927,5.86852e+18,54.4306,348.039,2415,47,48,2318,2256,1855,1803,1902
63409,135,187,39039,24370,5.87007e+18,118.476,2496.44,63409,86,91,63199,63113,53161,55530,56657
20449,23,253,12679,7770,5.87085e+18,129.367,1528.92,20449,88,91,16541,12698,3151,4656,4201
79538,59,315,49094,30444,5.87114e+18,198.688,3200.1,79538,126,125,77283,75187,17830,26890,19942
16327,114,126,10043,6284,5.87137e+18,67.0037,1126.48,16327,69,71,16201,16201,15223,15684,15038
3917,163,202,2464,1453,5.88799e+18,103.664,735.219,3917,75,69,3711,3674,3235,3420,3314
28778,20,279,17807,10971,5.86969e+18,138.622,2000.23,28778,95,101,21062,15375,4005,5743,3433
36904,104,261,22672,14232,5.87172e+18,133.951,1994.15,36904,103,109,36364,35896,21037,21490,23129
97694,17,297,60177,37517,5.87042e+18,163.003,3243.62,97694,114,120,69832,46252,11596,14867,10172
86306,4,224,53354,32952,5.87007e+18,147.366,3081.55,86306,92,97,19553,0,4,2477,2223
19358,14,175,11931,7427,5.8708e+18,83.9911,1369.37,19358,75,74,12196,7105,1970,2264,1401
88964,84,294,54942,34022,5.86999e+18,163.27,3095.75,88964,109,116,88023,87239,33605,38820,44947
67113,16,213,41364,25749,5.87002e+18,126.791,2582.08,67113,94,99,45999,30173,8141,9145,6274
29261,123,156,18064,11197,5.87004e+18,94.9096,1599.24,29261,78,80,29103,29039,25317,27240,26664
65511,182,269,40325,25186,5.87096e+18,166.006,2617.02,65511,114,125,65162,64929,47972,50505,50851
55991,180,185,34580,21411,5.87016e+18,111.639,2355.01,55991,84,90,55806,55802,55468,55532,55800
16986,56,252,10468,6518,5.8708e+18,117.564,1414.71,16986,81,85,16280,15810,6267,7604,7813
29929,76,426,18653,11276,5.8806e+18,169.899,2777.47,29929,141,136,27719,25625,11126,10731,9124
84384,163,317,52192,32192,5.87315e+18,193.49,3475.15,84384,145,155,83694,83180,60562,58640,58446
27027,116,272,17063,9964,5.90195e+18,202.747,2178.22,27027,167,158,25219,22768,11348,10883,14885
99600,90,307,62103,37497,5.88598e+18,244.359,4182.21,99600,212,201,93146,85174,28418,36444,32720
75230,235,301,46405,28825,5.8709e+18,159.277,3003.54,75230,113,122,74928,74833,66941,70555,67143
24031,221,253,14886,9145,5.87083e+18,134.287,1633.43,24031,93,93,23778,23722,22672,23352,23111
48707,98,300,30039,18668,5.87109e+18,134.785,2479.57,48707,102,103,48091,47619,27795,27115,27455
38784,100,342,23941,14843,5.87003e+18,138.889,2399.44,38784,109,101,38128,37690,20876,19963,20214
47329,64,189,29182,18147,5.86955e+18,110.003,2075.31,47329,84,91,46659,46163,17790,20214,21509
73544,198,273,45616,27928,5.87374e+18,218.513,3028.25,73544,151,155,73092,72660,56006,61615,59898
46747,180,296,28826,17921,5.87116e+18,122.469,2413.26,46747,104,108,46403,46279,37868,36149,36556
37248,95,288,22947,14301,5.87109e+18,177.078,2107.71,37248,108,113,36520,35862,12630,15906,10558
53363,120,315,33004,20359,5.87203e+18,146.123,2762.72,53363,115,112,52793,52233,37727,40401,42190
17654,182,219,10922,6732,5.87038e+18,108.23,1291.85,17654,74,81,17435,17405,16913,17236,17256
8713,18,151,5415,3298,5.86925e+18,61.9282,870.852,8713,64,65,6158,3924,1145,1940,1025
45369,20,226,28055,17314,5.86984e+18,128.827,2025.91,45369,89,97,35517,26939,5789,9918,6800
61145,218,222,37811,23334,5.87001e+18,137.038,2579.09,61145,88,89,60923,60920,60919,60923,60923
82837,159,285,51064,31773,5.87024e+18,134.988,3022.81,82837,104,111,82534,82356,59618,53255,56051
91212,226,273,56670,34542,5.87522e+18,242.488,3493.86,91212,178,180,90816,90431,75112,83317,80731
62860,176,385,38958,23902,5.8741e+18,219.97,3113.64,62860,148,154,62184,61660,29349,28535,20309
37922,231,260,23780,14142,5.89073e+18,218.524,2526.58,37922,173,172,37644,37522,34588,35850,36319
89231,214,282,55014,34217,5.87287e+18,204.984,3308.32,89231,154,160,88834,88459,72120,79634,71927
67005,210,307,41746,25259,5.88562e+18,223.49,3463.47,67005,189,186,66597,66251,49866,53081,53230
48185,132,237,29625,18560,5.87033e+18,125.213,2166.05,48185,89,98,47919,47741,29907,25774,25484
1535,54,70,945,590,5.86145e+18,37.7785,264.448,1535,40,38,1465,1465,1226,1292,1212
96707,254,263,59557,37150,5.8702e+18,144.518,3167.54,96707,104,112,96444,96439,95763,96208,96404
56359,2,197,34746,21613,5.87017e+18,121.681,2402.98,56359,85,86,5074,0,470,0,368
27812,246,342,17159,10653,5.87022e+18,133.521,2052.85,27812,103,99,27470,27348,23967,25153,24279
67273,105,237,41357,25916,5.87057e+18,120.008,2571.88,67273,95,108,66863,66455,36551,35629,48337
60289,267,270,37109,23180,5.87395e+18,202.335,2718.9,60289,146,135,60019,60019,60017,60017,60019
40633,134,177,25116,15517,5.87021e+18,115.035,1859.54,40633,83,90,40452,40360,33319,34447,37184
74224,206,262,45773,28451,5.87016e+18,130.667,2803.42,74224,99,103,73962,73875,64512,69442,66675
50744,68,223,31132,19612,5.87129e+18,154.744,2160.36,50744,102,109,49716,48913,15570,18806,20006
49833,124,381,30845,18988,5.87123e+18,182.488,2653.56,49833,114,126,49126,48482,20929,20385,21246
95762,279,285,59614,36148,5.87839e+18,229.593,3781.34,95762,192,192,95477,95471,93101,94722,94702
78440,119,296,48303,30137,5.87062e+18,150.783,2993.88,78440,118,123,77807,77152,42331,43030,40320
84469,71,282,52097,32372,5.87043e+18,148.575,3094.46,84469,119,124,82986,81936,19828,30030,29198
86935,262,307,54187,32748,5.88547e+18,238.082,3914.29,86935,207,195,86623,86487,80748,81447,84124
11693,238,258,7228,4465,5.87016e+18,131.054,1286.03,11693,81,89,11435,11409,11399,11413,10879
37623,168,272,23790,13833,5.90204e+18,206.213,2547.45,37623,182,177,37011,36043,24268,24931,29843
28059,113,255,17352,10707,5.87003e+18,102.806,1726.71,28059,87,85,27778,27636,22148,22096,23539
49887,123,275,30751,19136,5.87666e+18,188.234,2592.84,49887,146,139,48850,47618,24349,22368,24509
38775,17,178,23884,14891,5.8703e+18,78.8407,1970.76,38775,79,83,26298,16183,5036,5934,5529
74610,148,260,46006,28604,5.87011e+18,138.373,2805.04,74610,99,104,74314,74122,56709,58172,62713
21716,86,235,13724,7992,5.90288e+18,192.477,1890.75,21716,159,148,19138,15886,7992,7363,9380
81014,113,220,49975,31039,5.87021e+18,131.007,2912.36,81014,90,97,80684,80390,51434,48710,58892
44390,22,257,27484,16906,5.86999e+18,146.306,2402.14,44390,100,100,32921,23317,6924,8828,5373
16723,99,140,10289,6434,5.8691e+18,90.4455,1143.98,16723,66,72,16564,16488,12784,13314,14004
55202,163,208,34097,21105,5.87008e+18,118.513,2443.03,55202,87,89,54994,54944,49667,52584,50565
81373,10,293,50257,31116,5.8703e+18,159.344,2975.53,81373,107,111,43015,29626,7410,8685,5476
94497,78,286,58864,35633,5.885e+18,211.173,3970.58,94497,205,195,87166,79063,23829,33156,29169
26612,72,153,16428,10184,5.87021e+18,86.8875,1543.01,26612,73,77,26355,26238,14165,13751,16095
5040,67,136,3126,1914,5.86816e+18,63.2123,662.293,5040,63,64,4885,4789,4177,4265,4248
6337,14,117,3921,2416,5.87183e+18,65.359,681.023,6337,58,56,4216,2587,875,1176,986
29116,133,155,17910,11206,5.86995e+18,95.983,1591.79,29116,75,81,28961,28953,27340,28296,28280
51483,31,261,32267,19216,5.88887e+18,232.298,2925.86,51483,182,179,38066,27626,6220,11160,7083
91812,35,226,56722,35090,5.87018e+18,155.438,3176.26,91812,95,99,82339,68968,16655,26530,20503
21184,133,145,13025,8159,5.87062e+18,99.4416,1305.66,21184,72,78,21039,21036,20264,20796,20830
76711,184,286,47606,29105,5.88012e+18,239.624,3443.38,76711,187,182,75997,75075,52272,55642,56307
81362,219,313,50180,31182,5.87333e+18,193.501,3369.69,81362,150,149,80958,80681,61397,66883,56965
26778,93,249,16492,10286,5.87189e+18,149.58,1720.52,26778,105,104,26086,25457,12000,12480,12837
9013,17,244,5643,3370,5.88477e+18,146.089,1168.58,9013,102,100,5664,3441,829,1573,143
4702,3,134,2887,1815,5.86759e+18,59.6661,589.909,4702,52,55,825,0,28,78,95
27027,192,219,16729,10298,5.87054e+18,117.306,1570.5,27027,82,88,26808,26788,23619,25506,25302
90425,162,307,56311,34114,5.88442e+18,246.655,3974.9,90425,198,202,89175,87663,54016,49117,57096
56523,40,296,34785,21738,5.87102e+18,155.17,2553.56,56523,98,105,53009,48296,11005,17900,15031
23136,186,272,14306,8830,5.87631e+18,135.379,1818.08,23136,109,110,22807,22681,18845,19232,18231
52802,227,272,32602,20200,5.87391e+18,203.84,2631.53,52802,141,146,52494,52324,44497,48994,43181
35316,162,199,21847,13469,5.86959e+18,113.609,1940.47,35316,83,83,35117,35058,33840,34585,34451
22259,38,159,13661,8598,5.87003e+18,102.226,1339.07,22259,74,79,20943,19464,5067,7072,5674
76517,260,262,47143,29374,5.87014e+18,146.558,2839.51,76517,101,106,76255,76255,76254,76254,76255
61827,223,303,38769,23058,5.89206e+18,225.631,3383.25,61827,191,197,61457,61217,46117,48570,43185
13161,40,126,8106,5055,5.87007e+18,60.0866,1033.58,13161,66,66,12416,11228,5035,5562,5359
68007,34,277,42374,25633,5.88111e+18,231.957,3237.26,68007,184,173,56290,44939,9010,15903,8163
89915,247,282,55744,34171,5.87309e+18,206.175,3323.87,89915,153,159,89625,89549,75852,83959,81155
86149,48,288,53107,33042,5.87008e+18,140.815,3080.65,86149,107,108,82989,79587,19872,27064,23407
6716,21,141,4165,2551,5.86874e+18,63.7061,790.469,6716,63,64,4886,3495,1190,1487,1186
31860,187,249,19670,12190,5.86972e+18,136.441,1969.29,31860,88,91,31611,31531,25513,28460,23426
90358,293,397,55968,34390,5.87225e+18,176.549,3912.17,90358,146,140,89961,89863,85506,86805,81625
33560,92,274,20737,12823,5.87494e+18,194.562,2144.08,33560,119,124,32448,31343,14722,14812,15465
82801,279,285,51497,31304,5.879e+18,229.293,3504,82801,186,185,82516,82491,80211,81802,81902
42343,117,171,26191,16152,5.86985e+18,98.4559,2016.09,42343,79,81,42156,42100,33244,33113,36499
68648,296,342,42304,26344,5.87052e+18,143.51,2998.75,68648,114,112,68306,68254,60911,65109,64513
42230,24,199,26106,16124,5.87015e+18,107.517,2095.57,42230,85,84,32788,22829,7046,10917,7321
41174,213,260,25435,15739,5.86987e+18,147.843,2306.11,41174,95,100,40914,40850,35121,38268,38607
79962,199,274,49326,30636,5.87005e+18,159.165,2907.31,79962,109,111,79688,79567,72387,75747,75637
60440,24,385,37461,22979,5.87427e+18,222.866,3067.72,60440,146,154,48755,37510,6817,13806,3640
68038,262,285,42428,25610,5.88118e+18,236.663,3287.73,68038,186,174,67749,67670,65946,66973,67208
32010,180,220,19687,12323,5.86994e+18,120.043,1714.03,32010,86,90,31790,31765,26922,29660,28128
6592,15,190,4057,2535,5.87162e+18,75.6523,814.435,6592,64,67,4525,2839,839,1304,855
5984,42,114,3683,2301,5.87172e+18,54.5438,680.145,5984,57,60,5666,5217,2842,2774,3037
89817,253,309,55263,34554,5.87205e+18,229.75,3322.87,89817,125,134,89508,89397,82371,86261,85351
26368,112,182,16258,10110,5.86951e+18,78.5073,1543.76,26368,80,80,26180,26105,22504,21888,21818
95437,260,320,58772,36665,5.87255e+18,239.695,3586.53,95437,149,142,95115,94952,89645,91964,91487
56679,76,274,34987,21692,5.87398e+18,216.19,2703.75,56679,151,145,54401,52445,14760,22187,20256
66710,74,272,41151,25559,5.87322e+18,206.459,2889.8,66710,153,152,64267,62219,16908,26080,24358
98178,89,317,60657,37521,5.87286e+18,193.085,3697.68,98178,150,156,96159,94200,37897,44190,44762
5170,101,231,3185,1985,5.87705e+18,84.9884,823.711,5170,66,64,4884,4773,3990,4013,4037
83113,50,285,51753,31360,5.87921e+18,235.373,3575.94,83113,185,191,75015,67835,16510,24263,18829
11855,146,231,7361,4494,5.87671e+18,157.783,1220.55,11855,91,85,11562,11446,8213,8678,7197
42182,214,252,25963,16219,5.87013e+18,126.079,2102.22,42182,95,97,41930,41904,36582,39709,38401
15635,27,123,9698,5937,5.86936e+18,65.8689,1085.56,15635,70,70,12851,9368,3061,4395,1827
75417,78,333,46456,28961,5.8705e+18,170.848,2952.25,75417,108,109,74391,73738,15622,26581,19222
12535,68,76,7784,4751,5.86987e+18,66.9813,835.041,12535,63,68,12435,12331,11304,11909,12106
28958,29,156,17878,11080,5.86986e+18,95.1606,1592.96,28958,77,80,25117,20146,5329,8128,6816
39507,163,193,24411,15096,5.87055e+18,106.67,2044.14,39507,84,83,39314,39304,37219,38571,37012
11663,195,249,7245,4418,5.88105e+18,157.628,1320.71,11663,103,100,11398,11291,10167,10340,10059
61008,26,217,37580,23428,5.87047e+18,130.165,2532.08,61008,89,96,50388,37503,9806,14231,10623
89053,113,307,55088,33965,5.87105e+18,228.787,3292.18,89053,122,139,88202,87385,42348,40657,43284
61103,54,187,37629,23474,5.87033e+18,119.845,2468.98,61103,85,89,59722,57136,17338,22162,23661
37487,63,264,23046,14441,5.87213e+18,164.329,2045.81,37487,105,114,36340,35512,11593,14675,13422
50315,165,179,31015,19300,5.86962e+18,106.673,2193.09,50315,85,94,50136,50136,49432,49819,49423
84933,36,281,52220,32713,5.87124e+18,151.409,3044.27,84933,115,126,78043,70497,11964,22278,15076
56753,220,229,34905,21848,5.87027e+18,156.091,2296.12,56753,103,112,56524,56524,56178,56448,56316
39273,45,257,24182,15091,5.87146e+18,191.712,2076.71,39273,109,111,37004,35041,7450,12154,11363
10952,397,581,6875,4077,5.86786e+18,164.836,1672.54,10952,144,126,10371,10370,7663,7880,3293
74506,225,290,46715,27791,5.89166e+18,233.721,3635.57,74506,206,199,74148,73817,60789,63157,65477
19543,162,248,12086,7457,5.87337e+18,144.676,1471.16,19543,94,101,19235,19091,13901,13921,15343
18109,10,149,11180,6929,5.86913e+18,83.8219,1270.94,18109,70,75,9366,6355,1573,1513,1568
82639,204,227,51019,31620,5.87014e+18,135.687,2977.59,82639,92,98,82412,82403,79626,80730,81690
3382,28,137,2071,1311,5.87025e+18,58.8616,505.583,3382,51,51,2974,2626,806,1084,1165
50916,174,272,31441,19475,5.87955e+18,191.394,2682.54,50916,163,148,50364,49725,35108,34267,37269
39595,222,263,24426,15169,5.87819e+18,196.211,2304.53,39595,145,137,39303,39129,34086,36754,36769
21436,72,162,13261,8175,5.87048e+18,101.784,1333.24,21436,75,78,21118,20964,11339,11046,12335
9129,183,249,5687,3442,5.88182e+18,137.063,1204.77,9129,99,95,8853,8768,7356,7406,6903
82797,167,277,51588,31209,5.88439e+18,219.229,3656.26,82797,198,192,81720,80129,54451,51645,58500
72590,79,200,44815,27775,5.87012e+18,124.344,2721.98,72590,85,94,72113,71896,34374,33104,40079
27974,95,256,17195,10779,5.87242e+18,130.332,1781.09,27974,98,103,27425,26958,11852,12523,11670
91579,281,316,56485,35094,5.87279e+18,204.217,3538.11,91579,144,144,91263,91171,85353,88610,85937
74052,259,269,45679,28373,5.87007e+18,151.093,2800.38,74052,105,107,73783,73783,73166,73555,73751
93466,71,285,58200,35266,5.8786e+18,235.505,3755.1,93466,187,194,87902,82655,22818,34071,28031
93320,225,381,57707,35613,5.87081e+18,176.227,3683.33,93320,132,132,92924,92774,77116,72599,75701
70801,45,300,43582,27219,5.8713e+18,195.081,2915.93,70801,115,120,67350,63537,15962,22964,22321
18169,3,257,11300,6869,5.87847e+18,178.552,1613.06,18169,112,113,3002,0,41,200,200
67799,208,303,41847,25952,5.87121e+18,168.901,2897.92,67799,110,117,67458,67293,58441,60811,60308
6739,52,125,4159,2580,5.87069e+18,56.6894,741.303,6739,58,60,6532,6337,4194,4219,4538
57688,149,270,35773,21915,5.87413e+18,207.022,2693.67,57688,148,139,57002,56437,34299,30248,30652
54520,244,400,33762,20758,5.882e+18,216.635,3200.77,54520,174,175,54101,54018,34448,31701,20015
31482,117,169,19352,12130,5.87042e+18,101.963,1672.21,31482,78,85,31298,31181,24219,24383,23608
6701,39,242,4224,2477,5.89299e+18,163.098,1058.36,6701,114,101,4429,2563,963,1091,1409
16250,248,260,10050,6200,5.86973e+18,165.129,1518.35,16250,90,94,15990,15961,15962,15974,15752
28375,152,156,17518,10857,5.86982e+18,93.3787,1578.43,28375,77,80,28219,28219,27962,28159,28219
29184,86,258,17977,11207,5.87239e+18,173.179,1800.06,29184,103,102,28497,27933,12203,13226,14821
96593,78,275,59496,37097,5.87588e+18,237.097,3554.05,96593,174,182,92916,89661,23324,35561,29966
49941,126,309,31052,18889,5.88187e+18,210.596,2952.86,49941,170,174,48396,46474,22657,23454,15837
15714,28,214,9707,6007,5.87009e+18,121.155,1386.52,15714,79,79,12589,8755,2662,3914,2175
65412,226,257,40314,25098,5.87048e+18,131.46,2616.03,65412,99,102,65155,65107,57969,62193,63410
47376,72,381,29330,18046,5.87171e+18,177.128,2708.59,47376,121,125,45908,44874,13467,18691,16787
29371,40,262,18199,11172,5.8718e+18,177.913,1841.97,29371,102,109,27146,24697,4856,7937,5106
88228,64,274,54361,33867,5.87186e+18,199.925,3210.95,88228,151,151,85142,82632,18968,30216,22715
37180,137,251,22885,14295,5.86988e+18,127.801,1967.36,37180,92,93,36910,36754,22023,20314,22074
62173,231,274,38448,23725,5.87607e+18,231.297,2926.52,62173,165,164,61844,61617,51937,57271,55544
59788,60,215,36918,22870,5.87027e+18,130.904,2495.56,59788,89,93,58802,57703,16800,21379,20111
32904,109,195,20302,12602,5.87007e+18,95.8425,1795.79,32904,80,81,32692,32588,25707,26675,27163
2305,20,131,1415,890,5.86461e+18,55.7787,425.566,2305,45,44,1874,1516,361,570,560
42700,164,197,26370,16330,5.8704e+18,109.044,2057.37,42700,84,87,42503,42436,38481,40825,39330
77740,95,426,48184,29556,5.87429e+18,163.07,3953.14,77740,145,137,76030,74376,43414,40403,46285
21292,185,187,13093,8199,5.8702e+18,107.926,1441.48,21292,78,81,21105,21103,21104,21105,21095
17068,205,243,10517,6551,5.87149e+18,150.279,1391.76,17068,87,97,16813,16732,14374,15731,15597
5762,102,147,3548,2214,5.86831e+18,78.6532,700.012,5762,63,62,5615,5561,4170,4200,3841
66134,143,262,40760,25374,5.87004e+18,133.193,2650.37,66134,98,101,65833,65646,50257,49738,55461
97541,97,289,60170,37371,5.87038e+18,142.641,3253.9,97541,106,112,96894,96318,45802,50399,55836
64044,220,381,39627,24417,5.87111e+18,177.754,3078.56,64044,124,132,63643,63520,45043,39689,44298
1774,38,97,1085,689,5.86562e+18,47.1026,333.841,1774,38,39,1628,1575,752,830,874
23333,203,270,14434,8899,5.87006e+18,187.929,1845.85,23333,104,108,23008,22853,19829,20555,21134
97685,97,282,60547,37138,5.8729e+18,204.785,3439.55,97685,153,162,95779,93874,38667,43780,43729
62561,144,269,38505,24056,5.87101e+18,163.165,2562.91,62561,112,124,62094,61760,38335,35935,41429
91420,71,306,56467,34953,5.87086e+18,159.756,3277.86,91420,117,129,89821,88610,28184,36003,34809
18641,145,274,11511,7130,5.87457e+18,129.916,1565.49,18641,91,91,18342,18263,15691,16568,16535
63882,198,220,39467,24415,5.86984e+18,134.601,2649.83,63882,92,92,63662,63649,63168,63318,63534
24362,91,173,15115,9247,5.8701e+18,87.6155,1534.79,24362,78,79,24177,24130,17491,15735,14326
2099,70,146,1285,814,5.87819e+18,75.1263,439.633,2099,49,49,1913,1820,1020,1076,1035
31958,119,257,19872,12086,5.87836e+18,203.717,2092.46,31958,142,137,30992,29851,15863,14878,16705
82925,35,279,51239,31686,5.87027e+18,168.425,3179.41,82925,106,113,74428,63058,14779,23299,15121
11237,13,203,6899,4338,5.86938e+18,87.7797,1035.63,11237,69,70,7018,4163,1089,1824,895
49040,88,267,30787,18253,5.89428e+18,215.445,2905.29,49040,190,183,44495,38807,17126,17641,20001
54165,231,381,33537,20628,5.87143e+18,181.372,2825.41,54165,121,129,53775,53665,37665,33341,36442
28989,89,155,17834,11155,5.87006e+18,94.7139,1609.18,28989,75,81,28763,28658,18321,16778,20063
22238,52,145,13672,8566,5.86993e+18,100.599,1345.18,22238,72,78,21706,21126,8668,8838,9684
55041,32,228,33853,21188,5.87022e+18,121.496,2341.62,55041,88,96,48940,40251,9946,15377,14062
84726,119,220,52310,32416,5.86998e+18,149.517,3060.72,84726,94,97,84406,84179,58025,54089,65585
18017,120,189,11069,6948,5.87052e+18,109.956,1267.32,18017,70,75,17819,17746,11438,10600,8238
31563,157,272,19608,11955,5.87645e+18,160.799,2094.61,31563,128,125,31080,30792,22759,21450,21577
86094,311,392,53247,32847,5.88066e+18,247.649,3831.75,86094,194,190,85702,85651,69359,76111,59787
39043,275,283,24416,14627,5.88414e+18,193.614,2570.14,39043,160,159,38760,38750,38016,38438,38352
53611,242,281,33305,20306,5.88102e+18,206.631,2908.11,53611,173,174,53320,53241,46143,50008,47414
72419,43,277,44882,27537,5.87337e+18,204.119,3017.35,72419,149,153,67077,61624,13417,21123,14375
11381,6,74,7084,4297,5.86949e+18,69.196,803.639,11381,66,68,3740,0,216,495,745
23305,84,159,14467,8838,5.86962e+18,72.6762,1472.84,23305,76,78,23146,23117,15513,14917,13326
70944,168,212,43708,27236,5.87013e+18,133.833,2657.1,70944,93,97,70732,70650,65213,67185,69052
17133,46,145,10547,6586,5.86907e+18,70.2848,1141.29,17133,76,76,16260,15126,9310,8712,10879
34232,156,342,21115,13117,5.87051e+18,148.665,2245.97,34232,106,105,33803,33559,21567,20707,24867
13829,160,189,8538,5291,5.86925e+18,87.6723,1260.89,13829,77,79,13640,13615,13025,13289,12794
39637,46,307,24636,15001,5.88169e+18,161.741,2663.73,39637,148,152,34599,29715,12953,14329,14047
60812,163,244,37413,23399,5.86983e+18,152.198,2388.29,60812,105,110,60513,60333,42423,42232,48687
53251,190,314,32929,20322,5.8733e+18,155.158,2844.44,53251,130,132,52837,52604,44952,43671,42112
24396,92,219,14980,9416,5.87077e+18,132.386,1516.43,24396,86,90,24023,23709,11233,10897,11838
58495,281,285,36426,22069,5.88002e+18,231.501,3017.44,58495,171,167,58210,58196,57484,57953,58052
99184,269,302,61182,38002,5.87059e+18,174.72,3400.51,99184,122,129,98882,98810,90311,95393,93980
86292,79,274,53308,32984,5.87469e+18,219.228,3372.91,86292,179,168,82937,79847,22001,33266,30538
90435,124,227,55821,34614,5.86978e+18,141.625,3096.91,90435,94,100,90118,89829,60699,55370,69461
99629,96,279,61523,38106,5.87013e+18,165.469,3492.08,99629,112,116,98743,98146,46883,43067,44778
70803,137,327,43904,26899,5.87568e+18,158.444,3436.57,70803,152,147,69940,69119,49812,53727,50677
89774,168,303,55355,34419,5.87102e+18,173.68,3250.83,89774,122,126,89343,89058,69739,69480,73854
76595,88,294,47202,29393,5.87037e+18,168.41,2911.55,76595,106,114,75800,75103,29047,32036,35201
42986,158,266,26473,16513,5.8715e+18,165.88,2163.41,42986,106,114,42596,42343,29429,26275,30607
80529,92,215,49737,30792,5.87009e+18,130.137,2911.56,80529,91,97,80095,79830,44025,40826,50487
53563,205,266,32918,20645,5.8725e+18,189.317,2445.11,53563,125,127,53226,52986,43960,48657,45886
25318,131,219,15668,9650,5.8701e+18,117.791,1530.55,25318,80,87,25081,24929,17756,16462,16226
44467,11,279,27478,16989,5.8699e+18,146.157,2445.84,44467,102,98,22870,14389,4004,4352,3560
27803,148,165,17206,10597,5.8697e+18,112.329,1510.81,27803,77,82,27638,27594,25729,26814,27060
5011,82,107,3071,1940,5.86961e+18,52.0255,571.246,5011,54,54,4904,4904,4131,4397,4043
32506,132,219,20100,12406,5.87056e+18,131.337,1726.03,32506,84,95,32245,32045,23638,21516,28076
64206,156,215,39572,24634,5.87005e+18,133.614,2590.7,64206,89,95,63987,63857,54988,58203,58616
54070,234,270,33460,20610,5.87005e+18,211.801,2790.08,54070,128,128,53755,53549,49996,52058,51473
27044,114,267,16823,10221,5.87759e+18,183.024,1947.24,27044,129,126,26189,25304,12169,11889,12077
10615,82,123,6580,4035,5.86892e+18,59.041,925.753,10615,64,66,10492,10491,8042,7851,7466
99214,137,322,61177,38037,5.87071e+18,197.394,3499.69,99214,128,131,98587,98092,51868,51925,50736
66006,114,211,40760,25246,5.86994e+18,109.573,2665.65,66006,86,87,65754,65608,46168,42725,44356
95289,242,426,59262,36027,5.879e+18,180.853,4628.72,95289,177,180,94858,94757,82542,81277,71942
17115,113,162,10525,6590,5.86967e+18,105.557,1206.17,17115,69,73,16941,16839,12430,12249,12624
93224,62,328,57815,35409,5.8768e+18,223.229,3940.02,93224,175,175,88063,83544,18624,31737,26111
15727,64,138,9674,6053,5.86999e+18,68.72,1162.97,15727,68,68,15545,15465,8493,8331,7910
19703,114,297,12339,7364,5.89255e+18,140.611,2004.55,19703,142,134,18669,17490,11392,11622,8572
79402,257,313,48981,30421,5.87335e+18,195.517,3359.65,79402,149,152,79081,78980,68902,73766,66970
17946,151,248,11043,6903,5.87583e+18,171.93,1489.08,17946,107,102,17586,17378,12086,11677,11163
34858,100,179,21477,13381,5.87024e+18,114.669,1840.84,34858,78,81,34622,34485,22680,22063,24324
77049,44,266,47435,29614,5.87121e+18,192.71,2884.19,77049,135,132,72923,68550,12951,21515,12795
87770,103,303,54061,33709,5.87047e+18,158.302,3193.25,87770,118,124,86922,86114,39972,45208,45508
48458,23,264,29799,18659,5.87286e+18,192.641,2345.1,48458,125,123,39562,31019,5423,11074,5387
33897,120,194,20958,12939,5.86967e+18,123.678,1717.25,33897,87,89,33671,33495,23244,21309,23900
92537,84,277,57534,35003,5.87855e+18,225.669,3666.2,92537,191,184,88273,83768,26636,34011,30666
58905,306,307,36626,22279,5.88261e+18,230.106,3206.93,58905,179,173,58598,58598,58596,58596,58598
17061,100,128,10605,6456,5.86984e+18,67.1385,1150.76,17061,71,71,16933,16933,14013,15461,13368
36025,111,332,22234,13791,5.87044e+18,103.62,2159.01,36025,84,93,35664,35465,26653,27545,28554
72259,216,327,44787,27472,5.8758e+18,166.302,3460.36,72259,154,148,71919,71807,65470,65543,62928
78662,155,289,48480,30182,5.87057e+18,131.285,2960.39,78662,101,106,78360,78184,56739,50517,51862
79961,45,215,49356,30605,5.8702e+18,125.495,2920.9,79961,89,91,76216,71159,18457,26219,25216
18094,128,231,11379,6715,5.89254e+18,172.369,1698.04,18094,139,132,17345,16304,11008,10176,11381
89729,82,276,55257,34472,5.8706e+18,168.082,3067.26,89729,126,128,88315,87116,24975,36019,34338
56949,247,290,35231,21718,5.87107e+18,168.841,2558.97,56949,113,121,56659,56621,46835,52609,45652
85551,45,303,52871,32680,5.87078e+18,160.181,3157,85551,116,128,81528,77248,16817,24801,20618
48311,181,256,29770,18541,5.86998e+18,126.659,2243.62,48311,95,96,48055,48006,35667,41363,34055
46966,249,298,29006,17960,5.87085e+18,134.013,2435.23,46966,101,102,46668,46606,45039,45829,44841
64940,225,286,40264,24676,5.87911e+18,224.995,3158.22,64940,173,170,64590,64319,53450,57325,57234
84738,7,281,52536,32202,5.87336e+18,203.787,3234.62,84738,153,158,34670,0,4854,6978,3421
74773,169,328,46360,28413,5.87574e+18,169.398,3499.72,74773,152,152,74259,73804,61918,62227,62028
43936,148,268,27138,16798,5.87476e+18,183.387,2395.98,43936,145,141,43288,42750,26966,24060,28638
48297,97,269,29776,18521,5.87578e+18,215.741,2524.55,48297,146,137,46881,45421,19315,20023,16505
87442,105,328,54213,33229,5.87513e+18,194.614,3721.88,87442,156,156,85811,84033,42715,42532,53202
2749,93,171,1700,1049,5.87126e+18,65.7075,551.565,2749,53,56,2578,2539,1875,1692,1390
30920,35,245,19136,11784,5.87053e+18,112.792,1846.6,30920,82,85,27812,23633,6522,9635,7997
29989,44,267,18658,11331,5.87656e+18,171.244,2039.85,29989,129,127,26994,24176,6775,9315,7529
68451,291,327,42379,26072,5.87302e+18,194.239,3176.8,68451,127,125,68124,68072,67536,67626,67152
94562,161,274,58444,36118,5.8756e+18,241.779,3575,94562,188,177,93519,92472,60180,53948,58099
16462,78,180,10179,6283,5.86962e+18,88.3526,1302.82,16462,73,75,16255,16189,8746,8000,5944
64176,142,312,39645,24531,5.87429e+18,194.034,3049.45,64176,144,143,63350,62849,38521,37627,36633
82129,305,521,51722,30407,5.89457e+18,232.606,4149.74,82129,216,204,81608,81602,53571,58244,38942
65222,139,207,40249,24973,5.8699e+18,126.306,2649.98,65222,89,91,65011,64852,52626,56406,56303
35726,75,180,22010,13716,5.8699e+18,103.008,1879.81,35726,80,83,35432,35322,18175,17256,17622
66595,15,237,41136,25459,5.87031e+18,126.596,2550.06,66595,97,105,44937,27572,7224,9730,6986
42510,54,227,26109,16401,5.87059e+18,121.015,1960.95,42510,91,95,41428,40243,12011,16933,18006
84176,222,274,51981,32195,5.87466e+18,236.241,3320.16,84176,171,164,83782,83434,69708,76930,71675
64392,136,286,40562,23830,5.89708e+18,229.221,3421.32,64392,197,195,62083,58615,34089,30594,36938
26144,183,261,16367,9777,5.88853e+18,207.108,2071.87,26144,154,143,25751,25331,19488,20447,21131
2947,42,74,1817,1130,5.87547e+18,56.4371,410.695,2947,51,55,2733,2445,1679,1540,2074
61505,6,217,37941,23564,5.87028e+18,122.591,2541.59,61505,88,93,20773,0,1861,3066,2216
49483,184,264,30666,18817,5.87096e+18,161.898,2294.73,49483,111,116,49151,48946,35443,38591,36048
21152,173,177,13108,8044,5.86959e+18,81.3488,1425.24,21152,71,75,20975,20975,20585,20823,20852
42460,166,261,26461,15999,5.88112e+18,207.231,2497.6,42460,160,160,41832,41125,28389,27609,29513
11319,38,74,7052,4267,5.86905e+18,67.46,797.16,11319,65,67,10407,9350,5320,5256,6413
15735,99,158,9719,6016,5.86862e+18,72.8058,1201.88,15735,71,76,15577,15511,12783,12240,12476
24733,148,191,15194,9539,5.8701e+18,120.067,1458.93,24733,79,83,24542,24486,20762,22470,22194
34073,55,175,21073,13000,5.8694e+18,95.3353,1824.25,34073,82,81,33241,31754,14452,15126,15481
33972,12,261,21310,12662,5.88915e+18,207.973,2350.81,33972,171,157,17377,9377,2291,4040,1566
3029,23,144,1891,1138,5.87165e+18,92.1294,519.563,3029,57,55,2372,1926,465,742,841
41223,191,282,25461,15762,5.87467e+18,184.038,2349.59,41223,128,134,40854,40598,30845,33823,28456
65765,201,275,40728,25037,5.8721e+18,207.551,2764.17,65765,136,138,65393,65021,51621,57180,51739
12670,99,149,7809,4861,5.8701e+18,74.1657,986.85,12670,71,76,12521,12501,12389,12387,12361
69836,204,285,43562,26274,5.88262e+18,236.759,3359.69,69836,190,181,69366,68838,55300,60222,57119
23478,119,185,14437,9041,5.86934e+18,119.131,1411.24,23478,80,82,23270,23137,16466,15566,17458
17880,71,171,10973,6907,5.87052e+18,101.129,1214.65,17880,70,77,17563,17388,8942,8570,9367
60468,137,271,37699,22769,5.88076e+18,218.405,3026.08,60468,179,173,59029,57367,32419,29882,35152
32911,137,258,20385,12526,5.87215e+18,174.465,1908.1,32911,103,112,32477,32155,21469,20746,25475
21589,106,146,13266,8323,5.87034e+18,102.686,1319.88,21589,72,76,21419,21316,17488,18442,18973
40334,29,211,24920,15414,5.87012e+18,131.093,2019.59,40334,81,87,34602,27292,6520,9413,8293
42265,159,296,26041,16224,5.87111e+18,126.976,2302.22,42265,101,97,41940,41866,38623,38486,38977
49932,65,197,30854,19078,5.87e+18,119.095,2281.59,49932,84,88,49361,48711,19362,20906,20030
38287,144,244,23629,14658,5.87034e+18,119.649,2037.02,38287,87,89,38043,37957,35408,36141,35636
64094,165,266,39457,24637,5.87133e+18,190.221,2607.06,64094,123,126,63642,63289,44093,41544,45139
69406,35,279,42848,26558,5.8704e+18,154.297,2944.74,69406,107,113,62129,52408,12592,19557,13396
86103,277,281,53246,32857,5.87082e+18,145.448,3106.4,86103,114,127,85822,85822,85794,85798,85808
80769,14,307,50356,30413,5.88603e+18,234.816,3798.23,80769,194,197,45475,23557,6901,10547,3809
18180,91,140,11207,6973,5.86983e+18,75.5979,1253.42,18180,71,70,18027,18001,13307,12990,13828
98981,63,285,61011,37970,5.87256e+18,197.19,3466.78,98981,157,159,95425,92575,22182,35285,25283
35155,192,275,21678,13477,5.87649e+18,172.525,2199.13,35155,129,132,34786,34556,27427,28604,26877
44037,19,285,27388,16649,5.87858e+18,223.769,2594.83,44037,154,143,31456,20875,4603,8601,3984
90780,104,298,56037,34743,5.87077e+18,201.665,3293.05,90780,125,129,89869,88996,40189,40392,43135
25269,24,153,15626,9643,5.8698e+18,88.6094,1499.12,25269,72,79,20418,14856,3945,5803,4594
58815,55,315,36365,22450,5.87196e+18,156.642,2859.91,58815,115,113,56697,54446,16092,21832,23474
53256,96,217,32916,20340,5.87008e+18,113.445,2419.02,53256,89,86,52953,52833,37002,33966,35826
36103,50,273,22398,13705,5.87467e+18,192.859,2195.16,36103,126,124,33611,31598,8076,11841,11888
82318,201,285,51219,31099,5.87871e+18,230.82,3494.64,82318,187,180,81782,81148,60614,65862,65134
75958,247,285,47292,28666,5.88017e+18,234.413,3402.07,75958,182,183,75653,75509,67957,71333,72190
8233,136,146,5045,3188,5.8684e+18,60.8162,802.563,8233,62,63,8087,8078,7964,7995,7887
45102,237,270,27859,17243,5.87482e+18,210.376,2442.04,45102,139,135,44828,44743,39970,42625,41870
12236,113,240,7542,4694,5.87034e+18,84.8128,1148.02,12236,68,73,11996,11964,11030,11416,11357
77913,102,426,48419,29494,5.87719e+18,166.193,4154.13,77913,161,159,75825,73575,43360,40161,38761
60776,104,301,37480,23296,5.87126e+18,151.175,2730.11,60776,109,109,60130,59574,33614,32456,33766
52155,330,381,32280,19875,5.87095e+18,179.406,2909.75,52155,122,127,51774,51690,46437,49572,47039
65231,117,242,40116,25115,5.8703e+18,120.202,2552.16,65231,95,102,64883,64556,38334,35339,49979
74673,265,291,46985,27688,5.89574e+18,236.166,3683.49,74673,205,202,74380,74275,70770,72590,73390
18326,129,264,11371,6955,5.87989e+18,179.503,1678.78,18326,116,121,17725,17136,10020,9758,8591
98953,45,215,61026,37927,5.86999e+18,137.103,3176.08,98953,96,103,94820,89544,21648,33510,31317
65315,85,281,40502,24813,5.87917e+18,198.214,3125.94,65315,175,176,62022,58465,19169,25916,25166
77354,152,214,47699,29655,5.8702e+18,142.723,2818.41,77354,94,96,77126,76960,65341,68802,72293
84455,17,295,52091,32364,5.87023e+18,167.752,3033.02,84455,111,113,60601,40322,9834,13724,7004
78856,204,276,48631,30225,5.87265e+18,198.367,3120.1,78856,149,156,78420,78020,62938,68599,60127
29042,45,187,17934,11108,5.87005e+18,96.4779,1664.69,29042,81,84,27705,26167,9623,11439,11209
12275,131,198,7604,4671,5.86886e+18,81.4501,1080.36,12275,69,68,12077,12001,10492,10571,10896
86467,112,270,53536,32931,5.87006e+18,236.764,3524.17,86467,142,147,84918,83494,42038,36053,45525
51243,194,226,31527,19716,5.86963e+18,126.852,2142.28,51243,92,102,51017,50974,44466,48311,49735
11181,30,126,6876,4305,5.87006e+18,60.4642,950.117,11181,65,65,9667,7670,2769,3593,2927
4504,51,110,2789,1715,5.86826e+18,54.4516,569.279,4504,52,50,4364,4312,2335,2305,2233
55472,194,230,34310,21162,5.87033e+18,136.044,2520.12,55472,91,90,55242,55178,54385,54733,54198
14320,126,146,8831,5489,5.87011e+18,71.1655,1060.61,14320,72,74,14174,14156,13953,14088,13919
7949,114,156,4883,3066,5.8676e+18,69.1986,858.837,7949,63,60,7793,7755,5959,5637,5163
93465,183,281,57551,35914,5.87065e+18,168.053,3154.58,93465,124,134,93079,92815,66678,69517,75268
39580,240,260,24447,15133,5.86971e+18,149.429,2255.51,39580,95,99,39320,39297,39184,39248,39235
52835,120,278,32607,20228,5.8778e+18,237.886,2752.14,52835,157,151,51501,49975,24931,22872,25022
68899,34,272,42605,26294,5.87589e+18,232.634,3091.87,68899,173,167,58901,49024,9765,17661,11428
64884,149,230,39954,24930,5.87023e+18,147.289,2480.77,64884,104,112,64578,64378,44542,45915,45988
17203,195,250,10759,6444,5.88416e+18,156.882,1614.48,17203,131,119,16927,16798,14387,15519,14940
26918,144,193,16566,10352,5.86964e+18,88.3242,1619.2,26918,79,79,26725,26669,25847,26119,26035
88689,20,328,54989,33700,5.87718e+18,190.192,3870.72,88689,168,178,63966,45573,10096,18321,10785
18861,176,283,11659,7202,5.8721e+18,136.731,1617.1,18861,97,97,18551,18451,13428,12676,11657
27651,121,163,16981,10670,5.87042e+18,108.678,1507.91,27651,78,82,27475,27349,23064,24029,25388
75229,93,232,46371,28858,5.87022e+18,127.547,2848.71,75229,92,97,74790,74489,40568,38361,43018
29564,144,174,18212,11352,5.86946e+18,107.323,1665.48,29564,77,78,29390,29343,28485,29009,29021
84711,45,278,52849,31862,5.88636e+18,221.628,3737.83,84711,199,196,70973,58498,13664,21994,15650
73629,240,273,45320,28309,5.8709e+18,161.93,2759.27,73629,115,128,73356,73318,63742,69268,68712
32911,252,273,20412,12499,5.87391e+18,208.79,2072.07,32911,118,122,32638,32582,32452,32548,32571
10955,164,270,6782,4173,5.87737e+18,92.6673,1277.75,10955,83,82,10685,10653,9960,9940,9597
85338,132,231,52727,32611,5.86997e+18,127.751,3011.79,85338,94,96,85066,84854,60979,56553,55328
32602,160,263,20284,12318,5.88331e+18,211.388,2230.24,32602,158,148,31968,31313,21642,21007,22292
74786,137,327,46358,28428,5.87798e+18,191.083,3591.4,74786,171,178,73450,72131,44205,46225,40521
77318,78,229,47658,29660,5.87028e+18,136.505,2783.63,77318,99,101,76517,75958,33264,32799,33743
81035,147,302,50001,31034,5.87079e+18,165.329,3112.1,81035,114,121,80551,80219,58951,62408,67582
25254,38,155,15597,9657,5.87034e+18,92.229,1504.62,25254,75,76,23346,21116,7538,9605,7954
55907,144,208,34533,21374,5.87006e+18,119.876,2437.92,55907,86,90,55698,55578,43980,46183,44699
41901,71,171,25903,15998,5.87014e+18,96.9015,2009.85,41901,80,83,41598,41237,20854,19869,21519
89927,273,318,55758,34169,5.87863e+18,221.695,3883.24,89927,187,190,89609,89565,77560,83771,80032
27835,24,155,17174,10661,5.87016e+18,79.4446,1585.36,27835,75,78,22254,16042,4587,7199,4744
13482,40,129,8365,5117,5.86913e+18,70.2893,1005.98,13482,69,68,12734,11606,4896,5780,6057
5224,50,133,3211,2013,5.86767e+18,61.83,672.165,5224,58,63,4992,4793,2675,2777,2911
35161,59,159,21715,13446,5.87027e+18,89.9377,1789.48,35161,78,81,34629,33995,14431,14947,17785
65881,192,266,41247,24634,5.8904e+18,223.222,3316.95,65881,192,189,65313,64511,49830,51996,53911
89860,92,232,55470,34390,5.87026e+18,128.411,3103.33,89860,93,99,89374,89050,45473,43129,47895
77151,183,300,47529,29622,5.871e+18,158.698,3006.9,77151,113,118,76792,76639,68459,67129,69503
79874,251,273,49440,30434,5.8709e+18,163.143,2860.34,79874,121,129,79601,79587,73343,76671,76958
79041,23,232,48758,30283,5.87023e+18,133.631,2901.89,79041,91,97,62237,45392,10603,15732,9558
81461,267,276,50384,31077,5.87641e+18,229.378,3361.68,81461,181,179,81185,81151,79662,80229,80910
85060,38,273,52252,32808,5.87119e+18,160.497,2956.74,85060,124,129,79316,73223,13668,23925,16712
79542,7,201,49120,30422,5.87001e+18,124.325,2864.58,79542,89,97,30414,0,3853,5602,3632
97090,80,279,60013,37077,5.87009e+18,174.693,3404.07,97090,104,114,96056,95476,30246,36084,39666
80393,130,286,50681,29712,5.8976e+18,230.723,3812.25,80393,207,203,77065,71828,38144,35592,44269
6584,39,125,4056,2528,5.86783e+18,74.2026,701.524,6584,58,57,6220,5857,2147,2557,2757
33617,145,173,20736,12881,5.86949e+18,102.122,1746.39,33617,79,84,33444,33430,29706,31883,31470
83714,260,426,52450,31264,5.88806e+18,227.536,4450.69,83714,201,212,83278,83173,56111,55817,38694
31908,131,201,19702,12206,5.87032e+18,114.388,1849.26,31908,80,83,31705,31634,25889,26810,24930
92136,51,426,57548,34588,5.88449e+18,205.624,4711.41,92136,191,202,79640,68679,20815,26522,19324
3088,16,114,1897,1191,5.87089e+18,61.4443,460.427,3088,50,49,2344,1831,440,649,651
93587,34,307,57707,35880,5.87309e+18,194.455,3537.76,93587,159,157,83027,70270,15322,24285,17128
85913,234,270,53114,32799,5.87022e+18,184.533,3260.66,85913,107,107,85635,85552,79957,83039,79333
33732,132,255,20816,12916,5.87018e+18,113.142,1882.02,33732,82,86,33458,33400,17781,15258,7239
72285,45,214,44569,27716,5.87015e+18,130.791,2677.19,72285,94,100,69423,66071,16641,24288,23402
52289,213,216,32207,20082,5.87027e+18,133.833,2342.15,52289,88,92,52073,52069,52071,52073,52073
67567,193,220,41744,25823,5.86986e+18,154.158,2747.52,67567,92,94,67347,67304,65171,66347,66701
60063,5,254,37015,23048,5.87013e+18,115.514,2499.04,60063,95,103,17497,0,318,2830,1333
67589,175,293,41625,25964,5.87051e+18,161.949,2787.78,67589,118,126,67215,67000,45758,39500,37064
57733,19,256,35578,22155,5.86988e+18,118.599,2474.18,57733,95,99,42941,28863,8241,9942,7040
43463,74,179,26844,16619,5.87022e+18,97.6403,2039.41,43463,82,87,43070,42767,21070,21156,24150
60414,10,274,37368,23046,5.87624e+18,232.477,2889.57,60414,162,163,31743,21368,5442,7005,2609
75283,205,279,46483,28800,5.8701e+18,154.404,3057.36,75283,109,114,74985,74830,63518,68376,68444
3519,27,76,2180,1339,5.87059e+18,60.8525,450.083,3519,53,56,2794,1955,1107,1195,1536
61023,257,298,37704,23319,5.87065e+18,150.681,2731.85,61023,108,110,60725,60648,57859,59551,57421
45843,97,185,28326,17517,5.86955e+18,113.888,2121.18,45843,84,85,45589,45488,29462,28578,32016
78333,56,286,48583,29750,5.87942e+18,232.703,3458.03,78333,185,182,71396,66108,16046,26039,20984
67930,173,279,41979,25951,5.86995e+18,158.937,2929.66,67930,107,107,67564,67334,57552,56845,60609
80944,166,291,49926,31018,5.87034e+18,185.431,2992.7,80944,112,122,80567,80330,55384,51611,57730
75361,109,298,46530,28831,5.87065e+18,160.23,2974.07,75361,113,117,74711,74035,43038,41383,52286
1296,42,62,795,501,5.85661e+18,43.1559,248.482,1296,38,39,1210,1132,844,818,1050
22629,52,253,14020,8609,5.87131e+18,137.353,1589.26,22629,93,97,21467,20826,5420,8130,7432
84972,121,222,52469,32503,5.87003e+18,138.165,3021.25,84972,93,95,84667,84447,59248,56442,68094
42718,121,426,26797,15921,5.88976e+18,201.648,3349.57,42718,173,177,40794,38257,19756,18461,13622
80666,228,316,49729,30937,5.87306e+18,199.509,3357.56,80666,134,141,80336,80159,75956,76837,75655
63119,94,411,39195,23924,5.8764e+18,159.019,3669.32,63119,157,150,61126,59100,34685,34533,32424
86899,219,302,53523,33376,5.87075e+18,162.866,3193.28,86899,121,129,86576,86454,70525,78844,69064
54501,271,273,33928,20573,5.87863e+18,191.504,2802.31,54501,166,153,54228,54228,54147,54156,54228
31470,204,258,19388,12082,5.87174e+18,175.589,1864.67,31470,105,102,31189,31065,26967,29166,28579
80546,20,270,49873,30673,5.87007e+18,249.088,3438.67,80546,144,149,55311,38622,11203,13503,7264
67522,287,294,41677,25845,5.87029e+18,170.216,2732.43,67522,107,108,67228,67228,67029,67156,67228
79925,16,259,49235,30690,5.87001e+18,143.415,2895.83,79925,101,108,55103,36693,8957,11047,8452
31243,38,272,19316,11927,5.87526e+18,165.793,2085.37,31243,120,127,27715,24549,6069,9558,7507
91331,84,381,56478,34853,5.87079e+18,165.432,3641.5,91331,131,133,89851,88698,38800,44057,43631
47603,235,264,29454,18149,5.87255e+18,197.771,2318.11,47603,120,127,47329,47219,41718,44822,45486
35941,80,258,22148,13793,5.87169e+18,173.688,1980.81,35941,104,110,35051,34351,13713,16390,19833
64087,167,257,39626,24461,5.87018e+18,153.213,2829.97,64087,105,104,63725,63448,50036,47243,53381
55975,270,312,34774,21201,5.88055e+18,204.801,3094.3,55975,167,172,55663,55620,47786,51613,49656
72133,34,275,44410,27723,5.87442e+18,230.17,3018.02,72133,152,158,63726,54440,9291,19389,11374
88225,50,257,54572,33653,5.87018e+18,175.364,3268.29,88225,110,108,84541,78996,19984,27431,19192
45255,57,286,28024,17231,5.87707e+18,216.438,2612.65,45255,155,142,41808,39058,9150,14631,11872
34787,72,300,21804,12983,5.89077e+18,160.095,2630.94,34787,161,159,31032,26674,15085,17712,14150
72740,71,208,44918,27822,5.87021e+18,123.245,2793.54,72740,89,92,72181,71435,30730,30338,35027
40067,74,245,24757,15310,5.87072e+18,121.038,2075.32,40067,87,89,39580,39356,19076,18401,21870
5090,42,71,3122,1968,5.87073e+18,55.8762,511.043,5090,56,58,4834,4416,3275,3040,4009
2127,4,61,1317,810,5.86301e+18,52.9854,318.198,2127,44,46,501,0,9,45,157
38659,42,226,23780,14879,5.86974e+18,121.897,1885.81,38659,90,94,36745,34305,9075,12920,12502
90633,14,222,55965,34668,5.87004e+18,154.079,3152.03,90633,94,97,55182,31930,10296,10686,8175
68210,22,216,42033,26177,5.87006e+18,125.258,2674,68210,91,95,52900,39044,9211,11814,10589
25097,167,248,15448,9649,5.86952e+18,129.269,1636.32,25097,86,90,24849,24768,17487,18467,15137
39234,126,262,24305,14929,5.87858e+18,200.985,2353.09,39234,152,144,38176,36841,19468,18538,18541
34697,87,219,21454,13243,5.86985e+18,128.012,1776.06,34697,85,95,34250,33871,17633,17991,22129
88196,166,328,54656,33540,5.87721e+18,195.298,3857.94,88196,168,179,87379,86521,62367,61625,60998
11475,152,224,7244,4231,5.90095e+18,162.583,1357.64,11475,130,116,11102,10667,8119,8232,9027
18351,52,261,11486,6865,5.89027e+18,170.656,1767.68,18351,134,131,15362,13311,4344,5661,4799
53104,71,217,32811,20293,5.8704e+18,110.756,2411.81,53104,89,84,52672,52165,30279,31257,33069
81743,165,285,50985,30758,5.88202e+18,246.97,3629.1,81743,190,189,80688,79376,52088,49099,54887
8351,241,249,5211,3140,5.8819e+18,143.449,1123.28,8351,87,82,8102,8095,8080,8087,7999
79235,248,303,48784,30451,5.87054e+18,158.517,3049.9,79235,118,124,78932,78850,67873,74307,69423
92060,141,287,57346,34714,5.8843e+18,211.514,3890.61,92060,200,196,90023,87552,49200,46195,54273
21167,71,182,13062,8105,5.87088e+18,83.5055,1430.07,21167,76,80,20867,20685,12958,13586,13501
99457,163,285,61975,37482,5.87963e+18,241.353,3884.7,99457,206,194,98173,96644,61832,56271,63232
60174,183,224,37237,22937,5.86983e+18,151.948,2351.07,60174,102,108,59917,59822,50034,54912,53972
24660,230,273,15397,9263,5.88608e+18,160.931,2071.12,24660,143,138,24387,24346,21778,23050,21902
34311,149,172,21095,13216,5.87013e+18,101.659,1779.24,34311,79,83,34139,34130,31329,32747,32323
64955,351,426,40605,24350,5.88517e+18,196.293,4016.47,64955,185,187,64529,64442,56309,58076,51871
39951,167,269,24802,15149,5.8751e+18,176.711,2272.95,39951,133,131,39476,39081,27279,26082,29292
92011,80,342,56790,35221,5.87043e+18,154.783,3440.09,92011,120,116,90792,90005,34379,39609,42798
47757,187,312,29535,18222,5.8742e+18,164.343,2676.38,47757,133,129,47324,47059,36414,34381,32992
71162,103,239,43841,27321,5.86988e+18,124.871,2651.71,71162,100,108,70702,70221,37631,36814,50319
30808,96,255,19107,11701,5.87467e+18,170.848,1954.25,30808,120,116,29838,28905,13186,12945,12229
89063,200,274,55140,33923,5.87142e+18,189.047,3117.75,89063,141,144,88680,88320,68791,77971,69534
96924,52,231,59848,37076,5.87019e+18,143.4,3198.86,96924,96,100,94370,90169,24701,34905,33939
1635,38,105,1007,628,5.85489e+18,42.5076,330.257,1635,40,40,1491,1400,781,858,893
48710,105,273,30248,18462,5.8748e+18,208.118,2513.72,48710,141,138,47485,46207,22308,21782,20366
34059,145,173,21080,12979,5.87005e+18,95.0004,1818.6,34059,79,79,33886,33847,32021,33126,32526
91148,264,282,56076,35072,5.8738e+18,204.135,3344.91,91148,153,163,90866,90847,83266,87324,86362
54203,122,259,33432,20771,5.87025e+18,137.646,2409.68,54203,95,96,53876,53643,36845,38357,38627
44690,136,197,27634,17056,5.8698e+18,103.874,2160.92,44690,82,83,44493,44409,34323,35690,34218
68228,155,196,42136,26092,5.86982e+18,122.5,2646.61,68228,87,90,68031,67955,60826,64760,65801
52817,59,270,32680,20137,5.87005e+18,220.189,2775.89,52817,130,137,50023,47270,13317,15900,15995
69105,213,313,42662,26443,5.87382e+18,194.428,3185.35,69105,146,144,68689,68402,54042,55111,50791
81071,119,276,50266,30805,5.8793e+18,229.072,3487.19,81071,188,179,78793,75855,37475,37140,34980
58544,283,327,36312,22232,5.87708e+18,161.238,3203.91,58544,151,146,58217,58175,55048,55868,54130
28082,218,239,17344,10738,5.87026e+18,131.923,1856.27,28082,88,86,27843,27842,27827,27838,27842
72558,281,285,45185,27373,5.87947e+18,242.597,3364.15,72558,173,184,72273,72255,70613,71762,71854
89388,76,316,55418,33970,5.87895e+18,224.919,3856.09,89388,186,193,84441,79639,26608,38445,26350
8149,39,74,5079,3070,5.86831e+18,67.1862,676.557,8149,61,64,7514,6738,3793,3832,4835
65066,271,291,40071,24995,5.87064e+18,157.75,2750.76,65066,116,120,64775,64762,57966,61744,61672
76864,91,259,47548,29316,5.87002e+18,155.356,3050.2,76864,104,102,76078,75644,40195,37735,46437
36597,189,328,22837,13760,5.88318e+18,121.5,2725.87,36597,143,140,36234,36114,30010,29515,26492
37410,110,262,23316,14094,5.88509e+18,218.828,2446.7,37410,164,162,35629,33582,16527,16224,17895
34723,35,259,21501,13222,5.86996e+18,142.358,2138.27,34723,99,100,30266,24598,7052,9591,8365
94554,268,271,58489,36065,5.87003e+18,184.869,3512.29,94554,118,120,94283,94283,94267,94267,94283
66314,180,252,41016,25298,5.87016e+18,148.473,2882.86,66314,104,103,66018,65812,58937,58360,61589
61794,47,426,38774,23020,5.89017e+18,227.74,3895.58,61794,190,198,49981,38828,10031,14318,6242
71127,87,262,43846,27281,5.8701e+18,126.169,2760.26,71127,97,102,70545,70095,31429,35131,36703
10538,13,223,6612,3926,5.89915e+18,173.412,1300.12,10538,126,116,4750,1896,463,1070,755
6583,52,150,4056,2527,5.86842e+18,83.0412,716.232,6583,58,60,6310,6142,2572,2863,3120
21143,222,253,13241,7902,5.88698e+18,203.895,1831.4,21143,140,135,20881,20789,19507,20198,20310
81866,189,270,50692,31174,5.86999e+18,240.251,3432.29,81866,141,146,81233,80516,59905,57247,68908
41557,52,226,25567,15990,5.87019e+18,122.559,1942.44,41557,90,94,40381,39177,12022,16230,16904
76300,98,273,47381,28919,5.87451e+18,208.842,3135.35,76300,165,158,74303,72184,29955,31445,30169
66335,195,272,40916,25419,5.87342e+18,210.152,2902.96,66335,147,154,65869,65473,48509,53683,48138
88138,239,274,54549,33589,5.87088e+18,178.006,3023.15,88138,129,132,87859,87783,76033,83104,82759
60639,122,274,37428,23211,5.87384e+18,211.011,2772.98,60639,152,145,59506,58309,29205,29255,33763
51826,79,191,31865,19961,5.87018e+18,107.894,2211.9,51826,87,92,51357,51035,23964,23536,24569
46688,248,342,28768,17920,5.87012e+18,148.11,2560.42,46688,109,108,46346,46204,40102,42139,40505
7792,70,146,4839,2953,5.87028e+18,60.7007,843.569,7792,61,64,7632,7554,4609,4979,4389
91421,158,307,56517,34904,5.87119e+18,233.084,3346.16,91421,130,139,90864,90519,55298,46816,51469
8349,78,404,5206,3143,5.87487e+18,111.771,1419.32,8349,93,89,7618,7102,4053,3947,3934
33911,197,248,20948,12963,5.86984e+18,123.588,2039.13,33911,91,94,33661,33589,28146,30851,31313
63969,121,278,39707,24262,5.8801e+18,211.976,3107.37,63969,180,175,62060,59563,29353,28919,31369
56476,250,281,35211,21265,5.88044e+18,204.426,2967.68,56476,172,171,56188,56148,49335,53328,51372
48549,112,223,29996,18553,5.86984e+18,146.521,2380.96,48549,91,91,48214,48071,31615,29762,30760
20182,114,255,12438,7744,5.87125e+18,128.198,1536.92,20182,90,94,19748,19427,12629,12921,13744
61270,173,257,37735,23535,5.87003e+18,115.641,2526.79,61270,99,100,61013,60946,46631,49564,43457
35347,155,285,22054,13293,5.88067e+18,187.3,2416.02,35347,146,143,34757,34215,24395,24918,25282
3601,82,127,2234,1367,5.86841e+18,50.6332,551.781,3601,50,55,3474,3441,2582,2523,2471
67128,111,199,41376,25752,5.87031e+18,129.992,2609.3,67128,87,89,66838,66589,46112,44495,51912
67851,245,271,41945,25906,5.87e+18,209.779,3015.88,67851,114,115,67576,67477,67279,67421,67104
62526,298,381,38660,23866,5.87092e+18,151.731,3133.21,62526,123,118,62145,62046,58093,60102,56644
49583,52,264,30710,18873,5.87211e+18,191.439,2367.01,49583,124,127,47249,45729,10749,16723,13968
47821,208,274,29545,18276,5.87443e+18,217.931,2515.48,47821,145,139,47455,47173,39425,42897,42200
6084,50,112,3764,2320,5.87035e+18,54.0105,664.245,6084,53,55,5922,5820,3218,3103,3201
93846,208,271,58071,35775,5.8701e+18,231.092,3574.18,93846,133,131,93445,93227,76924,85523,84656
17330,72,235,10962,6368,5.9015e+18,184.537,1693.28,17330,151,135,14654,11598,5367,5277,6245
99834,191,228,61517,38317,5.86986e+18,143.888,3176.35,99834,101,105,99606,99564,93646,95900,97741
38634,42,267,23930,14704,5.87159e+18,164.263,2069.06,38634,101,111,36282,33647,7851,11963,10842
90306,59,294,56769,33537,5.89465e+18,236.412,4054.94,90306,212,206,75050,61150,16380,25486,20415
64374,152,290,40373,24001,5.89206e+18,235.834,3401.4,64374,201,194,62940,60757,35906,34006,39797
2099,105,110,1285,814,5.87177e+18,43.7399,374.539,2099,43,42,1989,1988,1967,1987,1989
24867,82,282,15348,9519,5.87171e+18,109.524,1800.79,24867,97,98,24287,23877,15301,16917,15967
52072,39,301,32131,19941,5.87111e+18,136.383,2551.5,52072,106,107,48276,43879,11163,16705,13351
25850,23,253,15883,9967,5.87192e+18,137.206,1680.25,25850,99,101,21278,16853,3048,6101,3540
89187,206,314,55023,34164,5.87213e+18,202.684,3471.51,89187,141,139,88816,88534,76203,79933,81750
92724,37,281,57000,35724,5.87133e+18,151.319,3179.54,92724,120,128,85737,78243,13923,25449,18730
33886,78,173,20922,12964,5.87052e+18,101.664,1744.15,33886,80,86,33538,33357,17484,17021,19733
60424,224,311,37513,22911,5.87986e+18,194.899,3217.03,60424,173,176,60060,59841,47294,50560,42368
37023,14,158,22917,14106,5.87025e+18,89.8266,1834.65,37023,78,80,22662,13212,3831,5566,4179
4663,22,74,2908,1755,5.87e+18,55.7066,504.813,4663,55,58,3564,2572,1279,1486,1885
22862,85,162,14148,8714,5.87003e+18,97.4884,1370.42,22862,76,79,22604,22427,13390,12580,13978
27826,168,199,17114,10712,5.86945e+18,112.972,1628.63,27826,76,82,27627,27612,23831,26006,24269
37768,231,256,23270,14498,5.87014e+18,115.12,2018.46,37768,88,86,37512,37480,36200,36929,37010
99545,17,286,61836,37709,5.88084e+18,240.634,3936.59,99545,205,197,65994,41807,9842,17888,6364
37149,409,411,23070,14079,5.87674e+18,151.186,2905.1,37149,138,126,36738,36734,36736,36736,36708
20546,15,152,12711,7835,5.86927e+18,69.2037,1376.43,20546,76,77,12961,7542,2462,3435,3173
2366,101,113,1449,917,5.87205e+18,45.6805,412.126,2366,43,44,2253,2250,2190,2205,2140
72751,141,286,45081,27670,5.87813e+18,214.09,3297.42,72751,172,180,71459,70160,40251,39689,44659
28958,209,273,18018,10940,5.87659e+18,160.824,2031.84,28958,122,124,28652,28497,24907,26178,24791
80978,77,301,49864,31114,5.87107e+18,193.569,3091.24,80978,117,121,79687,78809,26895,32852,38800
7508,76,195,4639,2869,5.87249e+18,89.2821,842.542,7508,62,65,7236,7085,3555,3479,3817
50052,190,220,30964,19088,5.87072e+18,155.76,2142.46,50052,101,110,49805,49709,42543,46663,46921
86513,30,274,53273,33240,5.87151e+18,197.538,3125.02,86513,142,150,75459,64186,12158,21239,9671
29328,90,156,18102,11226,5.86985e+18,96.5896,1601.16,29328,78,81,29091,28948,19037,18278,21256
48485,190,262,30313,18172,5.88578e+18,220.437,2772.52,48485,178,172,47981,47373,36092,38685,39864
99168,289,331,61486,37682,5.87459e+18,238.91,3905.8,99168,169,156,98837,98725,96771,96811,97140
25482,171,186,15749,9733,5.86995e+18,84.4165,1675,25482,79,80,25296,25292,25031,25192,24554
66841,135,203,41190,25651,5.87016e+18,127.353,2578.8,66841,92,96,66613,66495,52811,52279,58881
63674,15,274,39234,24440,5.87218e+18,210.89,2732.1,63674,136,145,43516,26419,7598,11366,5187
80130,131,286,49623,30507,5.87743e+18,212.962,3437.69,80130,175,180,78559,76729,40732,39936,45768
96459,138,264,59533,36926,5.87007e+18,143.072,3207.4,96459,103,112,96110,95866,62589,63715,72931
67970,10,290,42041,25929,5.87109e+18,153.368,2807.22,67970,115,125,36434,25385,6142,7858,5012
15646,63,154,9692,5954,5.86951e+18,76.2834,1111.34,15646,68,70,15376,15236,9690,9908,10305
94921,3667,10988,59815,35106,5.78758e+18,430.258,17601.6,94921,794,290,83933,83786,32033,46843,1951
2948,93,128,1830,1118,5.87134e+18,58.0122,505.242,2948,55,57,2820,2808,2671,2652,2579
71794,64,300,44367,27427,5.87106e+18,162.056,2933.97,71794,114,124,70149,68754,21150,26887,23732
9233,145,233,5754,3479,5.88637e+18,152.442,1183.45,9233,105,101,8894,8669,5756,5568,5082
51983,174,181,32102,19881,5.87013e+18,114.491,2269.98,51983,83,86,51802,51794,50576,51443,51385
95322,15,329,59078,36244,5.8774e+18,216.298,4036.38,95322,174,188,59956,33692,9554,14325,7093
73473,83,426,45849,27624,5.88336e+18,189.474,4244.28,73473,182,188,68763,63601,26948,29230,24349
8831,181,206,5597,3234,5.90664e+18,164.428,1162.34,8831,124,111,8617,8509,8019,8113,8451
85997,20,426,53524,32473,5.87922e+18,174.347,4443.94,85997,173,174,56352,36837,10583,15386,9333
15704,198,235,9926,5778,5.89873e+18,185.64,1623.24,15704,147,133,15457,15352,14716,15010,14941
42793,293,426,26593,16200,5.87841e+18,172.888,3216.82,42793,142,140,42367,42330,39368,39236,35166
71196,244,317,44647,26549,5.89075e+18,227.459,3698.19,71196,193,206,70859,70682,56690,59742,55782
62510,189,220,38617,23893,5.86981e+18,157.958,2627.38,62510,89,93,62290,62251,60119,61277,61719
97571,47,411,60468,37103,5.87677e+18,189.888,4436.81,97571,176,179,88365,78832,22287,30239,25299
69970,115,273,43376,26594,5.87342e+18,219.547,2963.02,69970,153,149,68667,67309,34824,33445,36231
51318,134,208,31697,19621,5.87013e+18,121.075,2316.12,51318,84,88,51099,50974,37271,37232,37596
82063,200,230,50631,31432,5.87022e+18,130.105,2964.44,82063,94,97,81833,81827,79011,80386,81077
30965,173,309,19207,11758,5.87538e+18,124.128,2190.37,30965,116,110,30585,30448,25368,24799,23509
80854,302,342,49940,30914,5.87021e+18,155.834,3274.08,80854,117,114,80512,80476,77403,79001,78579
83077,217,230,51255,31822,5.87007e+18,133.657,2984.06,83077,93,99,82847,82845,82353,82543,82553
87369,115,275,53832,33537,5.87639e+18,218.103,3401.36,87369,176,172,85469,83296,40255,37782,40901
37736,144,275,23265,14471,5.87681e+18,202.38,2256.21,37736,130,122,37155,36802,22899,20215,19407
47368,178,254,29179,18189,5.8701e+18,127.889,2214.99,47368,97,99,47114,47055,34497,40149,31578
48618,253,267,29983,18635,5.87265e+18,206.017,2413.31,48618,131,132,48351,48325,46684,47655,48020
5559,58,74,3465,2094,5.86721e+18,63.1642,553.954,5559,57,59,5451,5324,4371,4488,4811
66295,211,266,40732,25563,5.87175e+18,186.783,2645.22,66295,126,123,65989,65775,55531,61219,58216
2894,39,67,1773,1121,5.86604e+18,55.3697,379.65,2894,50,49,2697,2440,1601,1394,1842
99436,225,316,61305,38131,5.87257e+18,199.569,3654.68,99436,145,147,99077,98872,88992,92229,88800
54262,239,273,33777,20485,5.87847e+18,191.399,2790.81,54262,165,153,53979,53910,48071,51596,51258
22102,192,295,13889,8213,5.89439e+18,156.746,2120.05,22102,151,145,21783,21679,16321,16372,14429
3333,116,119,2055,1278,5.86943e+18,64.5815,497.397,3333,56,60,3214,3214,3199,3202,3210
79319,177,285,49021,30298,5.87011e+18,164.564,2917.78,79319,109,115,79006,78815,65149,70242,71377
47708,67,426,29816,17892,5.88509e+18,179.664,3517.63,47708,162,167,42969,37921,15270,17047,14217
38590,17,226,23872,14718,5.86999e+18,126.47,1882.05,38590,89,94,28101,19003,4500,7089,4079
9328,149,229,5760,3568,5.87627e+18,112.793,1062.88,9328,87,80,9071,8982,6748,6908,6935
10561,66,131,6540,4021,5.8695e+18,72.0841,886.29,10561,63,64,10372,10300,5826,5524,6413
15691,119,128,9733,5958,5.86953e+18,69.3946,1063.43,15691,71,73,15563,15562,15547,15558,15521
91078,15,342,56848,34230,5.88493e+18,196.429,4269.27,91078,190,202,52127,27024,7816,11365,6452
7277,105,195,4501,2776,5.87005e+18,89.2744,831.636,7277,68,64,7072,6967,5346,5686,5612
16321,71,242,10063,6258,5.87321e+18,152.811,1374.01,16321,95,95,15558,14983,5085,6724,6301
80095,66,305,50074,30021,5.8892e+18,228.862,3815.41,80095,193,205,70750,61303,18064,27022,19229
89867,99,282,55711,34156,5.87294e+18,206.196,3324.93,89867,153,159,88078,86315,35820,38646,34939
99012,101,285,61828,37184,5.88335e+18,242.484,4016.07,99012,205,200,94325,88967,38656,38916,39598
49003,314,409,30369,18634,5.87108e+18,165.117,2865.38,49003,111,109,48594,48590,48321,48292,47933
70283,134,217,43340,26943,5.87034e+18,122.376,2706.55,70283,90,96,70031,69879,51884,49998,50352
31046,197,256,19221,11825,5.8711e+18,140.072,1843.16,31046,101,103,30756,30649,26776,28557,26457
41914,94,175,25874,16040,5.87034e+18,80.0391,2055.83,41914,83,84,41716,41624,30085,29162,30389
59817,56,215,36878,22939,5.86994e+18,126.116,2507.6,59817,88,92,58517,56673,18297,23430,22121
86498,128,273,53514,32984,5.87106e+18,170.727,2995.52,86498,123,130,85842,85197,44555,41733,43122
25492,150,244,15763,9729,5.87101e+18,86.3432,1633.34,25492,85,82,25248,25189,21408,21251,20490
97797,216,282,60304,37493,5.87289e+18,222.448,3449.36,97797,160,161,97389,96985,80988,88401,82718
99013,68,397,61332,37681,5.87279e+18,207.328,3977.24,99013,155,167,95433,92286,25032,36778,26390
89679,242,282,55569,34110,5.87298e+18,205.757,3314.24,89679,153,151,89384,89304,74963,83434,78508
76725,46,307,47705,29020,5.8829e+18,244.169,3635.14,76725,191,191,66221,56700,12925,20839,13293
84414,7,288,52066,32348,5.87022e+18,145.535,3060.52,84414,105,108,33087,0,4503,5694,2287
8600,165,254,5361,3239,5.88664e+18,141.112,1212.84,8600,101,98,8298,8144,6029,6005,5407
92388,138,325,57271,35117,5.87829e+18,223.224,3974.1,92388,177,191,90762,89235,52478,53353,48355
29848,55,198,18415,11433,5.86948e+18,112.252,1768.82,29848,82,83,29043,27714,10815,11631,8699
74336,57,342,46147,28189,5.8797e+18,171.539,3780.23,74336,165,163,68442,62814,18015,24334,24247
35005,273,283,21970,13035,5.89191e+18,218.056,2516,35005,168,165,34722,34698,34679,34693,34511
16629,61,257,10297,6332,5.86972e+18,127.82,1495.03,16629,87,92,15861,15152,5568,5870,6238
70636,359,381,43704,26932,5.87097e+18,170.805,3216.38,70636,129,134,70255,70239,66410,69031,66869
75024,190,305,46910,28114,5.88926e+18,230.52,3707.55,75024,193,203,74333,73547,49341,48534,43419
61113,125,256,37665,23448,5.8703e+18,129.897,2528.69,61113,96,103,60786,60538,40484,39219,47305
27763,190,218,17077,10686,5.86986e+18,126.111,1595.41,27763,83,90,27545,27491,25348,26617,26651
52018,54,237,32125,19893,5.87027e+18,121.002,2264.69,52018,93,101,50738,49095,11518,17686,19519
68233,233,381,42186,26047,5.871e+18,167.144,3258.47,68233,122,116,67852,67712,62589,61599,62184
56148,26,211,34538,21610,5.86998e+18,129.523,2346.19,56148,88,97,47043,35831,8952,11829,9120
59546,154,196,36788,22758,5.87025e+18,111.009,2509.09,59546,84,86,59350,59296,51461,55503,53697
59313,185,212,36532,22781,5.87025e+18,127.865,2420.23,59313,93,97,59101,59069,57014,58280,58933
43637,118,262,27031,16606,5.871e+18,163.899,2180.72,43637,108,115,43090,42571,22862,22278,21451
19160,110,246,11841,7319,5.87427e+18,180.168,1551.38,19160,109,105,18528,17921,9238,9385,8987
40030,145,226,24763,15267,5.87032e+18,152.353,1928.05,40030,97,101,39722,39507,27593,25825,32481
60097,62,187,37008,23089,5.87005e+18,118.735,2433.74,60097,85,89,59274,58496,21279,24106,26158
65532,225,266,40266,25266,5.87164e+18,182.97,2632.03,65532,120,124,65252,65169,57045,61679,61189
55380,145,306,34325,21055,5.87412e+18,193.605,2867.01,55380,137,143,54645,54140,32821,31952,29669
21222,68,247,13161,8061,5.86963e+18,124.336,1712.5,21222,93,92,20537,19986,9721,9738,10351
66885,60,269,41159,25726,5.87068e+18,158.699,2651.6,66885,114,124,65094,63707,14125,22795,18451
69912,173,211,43171,26741,5.8701e+18,129.034,2738.29,69912,90,92,69701,69675,65198,67758,68168
30465,175,219,18713,11752,5.86996e+18,127.311,1676.2,30465,87,93,30246,30172,26836,28674,28307
44332,270,273,27496,16836,5.8749e+18,193.608,2410.73,44332,138,134,44059,44050,43002,43706,43799
47906,103,265,29633,18273,5.87168e+18,167.667,2277.56,47906,109,120,47220,46605,23417,24554,27994
48723,96,279,30104,18619,5.87049e+18,127.996,2492.62,48723,98,108,48085,47686,22696,20386,24099
81358,64,315,50196,31162,5.87245e+18,167.37,3366.09,81358,139,136,78787,76542,24487,30436,27451
93880,117,282,57744,36136,5.87348e+18,194.318,3358.11,93880,154,153,92601,91047,43952,40928,39150
35212,42,172,21655,13557,5.8703e+18,100.149,1796.13,35212,78,85,33500,30932,8230,11784,11909
50968,98,199,31432,19536,5.87019e+18,94.4116,2269.66,50968,86,91,50690,50515,33540,32101,33659
72828,199,279,44992,27836,5.87014e+18,137.894,3020.24,72828,106,111,72523,72384,62768,65762,67206
19713,28,154,12228,7485,5.86956e+18,92.9148,1290.93,19713,73,73,16412,12236,3590,5674,2700
3958,70,140,2436,1522,5.86677e+18,58.6281,614.128,3958,57,58,3815,3789,2622,2622,2195
1312,28,94,808,504,5.87021e+18,42.0046,283.711,1312,37,36,1139,1024,346,433,165
37106,48,262,23284,13822,5.8937e+18,215.812,2534.79,37106,179,170,29640,22310,6320,9294,8513
74349,181,216,45856,28493,5.86999e+18,133.242,2777.86,74349,92,95,74133,74084,66424,70743,68758
19760,248,254,12244,7516,5.87147e+18,141.424,1515.63,19760,95,97,19506,19501,18944,19350,19281
24367,33,241,15072,9295,5.87052e+18,162.176,1582.53,24367,87,97,21830,18581,3722,6698,5843
27872,8,305,17415,10457,5.88951e+18,154.776,2355.9,27872,152,146,10084,0,1364,1653,756
77307,153,262,47671,29636,5.86998e+18,136.926,2852.94,77307,101,104,77013,76859,58936,56421,67703
15665,61,179,9672,5993,5.87078e+18,77.55,1285.04,15665,80,76,15267,14769,9165,8825,9274
56722,125,197,35041,21681,5.8701e+18,102.081,2464.73,56722,84,87,56507,56413,42608,40962,41099
32818,95,197,20301,12517,5.87003e+18,119.639,1809.08,32818,80,80,32547,32408,20185,18712,20157
26907,112,261,16873,10034,5.89101e+18,207.558,2112.62,26907,160,144,25495,23859,11952,11055,13604
64288,8,266,39576,24712,5.87095e+18,178.923,2594.9,64288,118,126,29703,0,5337,6158,2889
81882,148,301,50446,31436,5.87103e+18,194.022,3115.14,81882,121,119,81388,81090,51707,46651,50188
61279,14,264,37638,23641,5.87178e+18,192.992,2554.53,61279,127,126,40899,24669,5919,9644,4029
27778,49,273,17316,10462,5.8843e+18,153.248,2157.46,27778,143,138,23994,20254,8106,10056,7311
43411,163,219,26845,16566,5.87039e+18,162.971,2004.8,43411,94,103,43136,42980,32973,37371,34162
74672,65,216,46052,28620,5.87012e+18,132.798,2779.34,74672,92,95,73765,72867,27204,30884,31737
55185,82,202,34016,21169,5.87014e+18,117.648,2349.19,55185,86,93,54754,54543,28507,27333,32976
88416,240,281,55207,33209,5.88394e+18,212.396,3780.82,88416,201,191,88105,87921,77802,83730,81829
32951,129,211,20361,12590,5.86999e+18,115.695,1958.76,32951,88,84,32714,32618,26632,26833,26967
10922,36,146,6713,4209,5.86982e+18,91.0264,922.044,10922,63,68,10159,9419,2618,3885,3596
32976,19,261,20717,12259,5.89247e+18,216.356,2379,32976,169,160,20003,10818,2689,5127,3292
6473,32,134,4001,2472,5.86971e+18,76.0528,688.867,6473,58,56,5880,5194,1497,2093,2284
89522,303,307,55828,33694,5.88583e+18,233.36,3981.45,89522,200,203,89215,89204,88463,88958,88710
21317,28,342,13153,8164,5.87028e+18,128.201,1841.13,21317,99,96,17782,13816,3276,5140,3627
2303,141,192,1458,845,5.89488e+18,123.365,580.698,2303,72,64,2098,2003,1652,1669,1842
62019,219,276,38271,23748,5.87415e+18,211.844,2819.11,62019,145,145,61677,61423,50441,56426,46075
20886,46,219,12925,7961,5.8696e+18,107.216,1391.55,20886,79,82,20008,19260,5408,7202,6600
12056,30,135,7457,4599,5.86975e+18,87.3001,994.764,12056,68,69,10486,8491,2735,3727,2960
78178,167,262,48053,30125,5.87072e+18,142.451,2846.98,78178,108,114,77866,77684,54457,52337,59177
36140,81,273,22534,13606,5.88547e+18,194.362,2457.54,36140,160,164,33356,30466,12152,15266,10318
81281,160,232,50138,31143,5.87022e+18,132.122,2950.87,81281,93,98,81043,80940,63442,69531,63709
91159,226,308,56140,35019,5.87319e+18,198.345,3487.01,91159,154,155,90797,90584,71150,78627,65916
56292,54,264,34862,21430,5.87106e+18,159.349,2429.66,56292,112,120,54391,52750,13896,19804,17768
86972,203,328,53792,33180,5.87152e+18,238.037,3360.67,86972,132,137,86561,86337,66040,75324,61315
84375,88,381,52175,32200,5.87054e+18,187.149,3544.03,84375,119,116,83212,82423,36450,35360,36516
46421,90,275,28628,17793,5.87734e+18,231.469,2543.76,46421,144,152,44731,42995,17110,19032,20172
76556,257,278,47064,29492,5.87144e+18,153.781,2905.06,76556,114,123,76278,76277,72881,74700,74996
55472,79,200,34186,21286,5.86998e+18,126.308,2355.77,55472,90,93,54974,54697,25814,26102,28534
11762,173,282,7265,4497,5.87398e+18,140.428,1298.46,11762,89,91,11460,11391,7657,7210,5942
89876,147,285,55903,33973,5.87849e+18,247.143,3676.61,89876,183,187,88517,87107,49340,45856,55503
44899,27,211,27773,17126,5.86999e+18,116.03,2179.91,44899,84,86,37040,27115,7149,10979,7622
81719,22,313,50398,31321,5.87343e+18,192.88,3375.01,81719,150,149,63904,48964,9180,17621,7983
60216,244,269,37593,22623,5.88362e+18,224.991,3061.31,60216,185,183,59933,59812,53892,57179,58364
62759,257,260,38777,23982,5.86983e+18,162.616,2826.24,62759,104,108,62499,62497,62493,62496,62499
11730,14,153,7255,4475,5.87005e+18,86.8858,972.922,11730,66,68,7806,4789,1391,1282,861
54123,249,273,33566,20557,5.87416e+18,190.013,2609.59,54123,140,139,53840,53767,48187,51527,51538
60698,32,311,37676,23022,5.87967e+18,193.099,3227.67,60698,173,176,49334,38718,10042,15509,8266
3534,22,98,2190,1344,5.87e+18,44.9604,489.465,3534,48,48,2851,2175,881,1113,973
15033,228,253,9333,5700,5.88017e+18,193.258,1497.76,15033,109,116,14780,14720,14332,14549,14396
88207,28,222,54468,33739,5.87007e+18,151.492,3114.16,88207,94,97,73298,54189,14393,21820,15564
81706,89,280,50526,31180,5.87023e+18,217.073,3261.94,81706,111,115,80618,79963,32445,29943,35254
42946,144,261,26875,16071,5.88722e+18,225.889,2627.04,42946,172,170,41829,40589,25043,22637,26167
99475,105,270,61569,37906,5.87006e+18,236.534,3811.15,99475,151,157,97449,95705,47737,40158,48735
41411,302,307,25766,15645,5.88416e+18,200.614,2750.6,41411,163,152,41104,41094,41060,41075,40878
52070,57,271,32350,19720,5.88158e+18,215.64,2836.76,52070,166,172,46786,42704,10631,17316,11810
94249,25,376,58240,36009,5.87044e+18,168.678,3696.59,94249,121,114,74275,52405,15610,21867,16738
52836,55,262,32470,20366,5.8716e+18,167.15,2372.1,52836,113,118,51011,49495,13059,18943,15791
87156,121,285,53683,33473,5.87034e+18,137.534,3095.14,87156,104,107,86760,86372,50063,49215,52831
75788,245,260,46812,28976,5.8701e+18,176.42,3103.25,75788,110,111,75527,75462,75452,75498,75242
47812,152,315,29572,18240,5.87336e+18,130.342,2662.71,47812,117,113,47385,47152,42160,41947,41001
16381,114,145,10105,6276,5.86987e+18,82.506,1186.55,16381,70,73,16234,16187,13902,15009,14753
33900,2,199,20916,12984,5.86998e+18,105.031,1830.26,33900,80,85,3082,0,268,0,22
65337,169,270,40170,25167,5.87104e+18,159.911,2624.09,65337,116,121,64977,64722,45041,40142,39409
81321,145,272,50232,31089,5.87486e+18,245.015,3313.08,81321,167,176,80166,79198,44782,40244,41493
41227,146,261,25712,15515,5.88238e+18,208.812,2474.6,41227,160,160,40350,39428,25150,23077,25410
54730,16,265,33689,21041,5.87105e+18,167.081,2415.24,54730,111,120,38833,27061,6961,9038,4085
48227,66,253,29712,18515,5.86995e+18,126.044,2237.85,48227,94,97,47376,46752,12480,19502,18455
21837,52,212,13508,8329,5.86985e+18,113.734,1617.05,21837,83,86,20805,19195,8130,8707,10190
45455,155,262,27950,17505,5.87135e+18,162.771,2215.22,45455,110,114,45069,44802,29557,25288,25262
12035,91,125,7410,4625,5.87073e+18,59.4973,992.226,12035,67,66,11910,11910,10414,10475,9672
51558,98,197,31757,19801,5.87045e+18,118.123,2300.55,51558,84,86,51283,51127,34162,31694,37129
64672,183,286,40732,23940,5.89665e+18,230.871,3418.7,64672,200,191,63996,63048,44389,45715,49635
11937,153,201,7376,4561,5.87114e+18,102.806,1201.25,11937,76,79,11736,11661,10930,11052,11021
43886,152,298,27069,16817,5.87171e+18,133.153,2352.82,43886,101,103,43490,43351,33940,33339,35036
98794,224,282,61218,37576,5.87291e+18,213.77,3453.57,98794,157,161,98431,98148,82863,90908,84844
53348,46,231,32971,20377,5.87041e+18,127.103,2227.7,53348,92,100,51385,49466,11941,17461,17089
63096,277,342,38986,24110,5.87038e+18,134.453,2936.53,63096,113,104,62754,62664,59560,61371,60905
79001,49,290,49526,29475,5.89161e+18,231.715,3737.79,79001,209,200,64272,50330,12745,20078,15270
14422,100,156,8869,5553,5.86925e+18,90.8543,1097.83,14422,68,73,14250,14149,11578,11514,12216
99234,42,224,61283,37951,5.87005e+18,153.392,3286.65,99234,96,101,93406,84682,19903,31531,29775
69312,102,300,42686,26626,5.87122e+18,199.726,2894.73,69312,116,115,68568,67916,31383,30075,23199
55009,10,235,33885,21124,5.87015e+18,121.989,2297.24,55009,94,98,29120,19893,5477,5704,3061
94843,207,411,58700,36143,5.87926e+18,238.351,4344.76,94843,189,199,94173,93536,57323,52240,44127
92802,274,275,57184,35618,5.87622e+18,239.429,3506.54,92802,174,179,92526,92504,92513,92514,92526
15813,151,152,9790,6023,5.86988e+18,67.5969,1220.5,15813,72,75,15661,15661,15660,15660,15661
22526,1430,7442,14092,8434,5.57706e+18,767.197,10351.1,22526,598,229,15084,13649,4363,4265,484
39395,127,288,24284,15111,5.87129e+18,152.83,2234.05,39395,109,113,38916,38542,23550,24049,22207
37837,120,272,23372,14465,5.87506e+18,170.309,2255.44,37837,124,130,36996,36126,22692,23078,23495
6811,101,173,4182,2629,5.87118e+18,71.4873,771.437,6811,61,64,6622,6561,4687,4405,4593
59741,216,260,36911,22830,5.86999e+18,148.663,2756.24,59741,103,107,59467,59387,53332,56755,58030
21505,37,219,13323,8182,5.86994e+18,71.9754,1443.1,21505,79,79,19587,17178,8111,8753,10038
45912,208,270,28450,17462,5.86999e+18,195.948,2501.18,45912,108,107,45609,45467,39760,42789,38780
68684,117,198,42412,26272,5.87015e+18,123.266,2668.54,68684,87,91,68426,68252,47698,45909,51131
58129,108,205,35920,22209,5.87008e+18,126.788,2460.43,58129,85,86,57857,57736,39618,37042,43727
56831,157,286,35289,21542,5.88035e+18,211.552,3000,56831,168,177,55934,54983,36660,34630,34409
71726,121,269,44384,27342,5.87098e+18,161.625,2713.71,71726,116,129,71096,70440,39283,39381,42930
60700,286,305,38028,22672,5.89136e+18,226.387,3383.58,60700,186,195,60395,60352,55561,57985,56249
41194,22,260,25818,15376,5.89087e+18,221.314,2627.01,41194,177,176,26631,16965,3804,7120,3807
52324,68,235,32246,20078,5.8701e+18,120.403,2269.87,52324,94,95,51541,50957,13607,21166,22663
73793,134,271,45663,28130,5.86993e+18,206.852,3135.02,73793,114,118,73149,72502,41104,36222,49426
28158,175,342,17396,10762,5.87019e+18,132.974,2093.2,28158,105,99,27765,27607,21527,21101,22890
72723,336,397,45071,27652,5.87342e+18,202.551,3603.01,72723,149,157,72326,72225,63750,68025,61283
59242,255,266,36474,22768,5.87096e+18,164.651,2493.31,59242,111,122,58976,58973,57621,58051,57852
66422,38,217,40997,25425,5.87003e+18,127.386,2625.65,66422,89,92,61592,56103,13969,20537,17620
41554,175,221,25698,15856,5.87032e+18,134.363,1935.03,41554,91,98,41325,41241,35429,38494,39848
27539,17,174,16988,10551,5.86974e+18,82.5811,1663.16,27539,80,79,18793,11711,3811,4364,3999
31872,161,172,19599,12273,5.86999e+18,104.074,1711.72,31872,78,81,31700,31697,31250,31510,31285
68170,161,215,42013,26157,5.87007e+18,127.596,2656.16,68170,88,94,67955,67844,58332,62699,59896
80689,85,317,49892,30797,5.87315e+18,187.031,3409.5,80689,142,149,78781,77065,31150,35871,35730
95659,113,224,59074,36585,5.86994e+18,141.938,3208.49,95659,94,100,95305,95016,60130,57541,69355
73228,133,341,45124,28104,5.87039e+18,185.345,3029.24,73228,110,118,72719,72377,47240,44574,57112
58015,105,257,35863,22152,5.87039e+18,141.006,2698.28,58015,102,103,57424,57071,31255,27524,29712
11339,18,244,6965,4374,5.87647e+18,87.341,1170.76,11339,80,81,8073,5307,1539,2363,954
22082,115,143,13600,8482,5.86987e+18,75.245,1386.08,22082,70,73,21939,21916,19124,20312,19718
25362,15,149,15662,9700,5.86949e+18,78.7493,1493.85,25362,72,76,16632,9808,3494,3959,3994
27377,139,160,16934,10443,5.86986e+18,97.0117,1583.64,27377,75,77,27217,27179,26596,26629,26908
59875,86,207,36996,22879,5.87008e+18,114.642,2539.61,59875,90,90,59532,59381,32377,31495,34199
2499,4,118,1535,964,5.86732e+18,52.0848,459.163,2499,49,50,594,0,4,101,106
44108,102,266,27164,16944,5.87139e+18,168.156,2188.78,44108,107,114,43427,42834,22755,24404,25206
84127,90,276,52508,31619,5.88726e+18,223.156,3760.62,84127,204,197,78188,70794,28302,31725,32358
15365,69,236,9438,5927,5.87096e+18,87.6935,1205.94,15365,74,77,14978,14721,4231,5778,2271
27101,139,177,16705,10396,5.8701e+18,113.463,1612.73,27101,77,78,26924,26883,25244,26022,24927
72182,52,275,44446,27736,5.87539e+18,208.655,3022.86,72182,155,150,67827,64970,13998,22766,15642
67407,182,256,41523,25884,5.87059e+18,113.487,2694.97,67407,98,102,67151,67092,53353,58906,49255
8739,82,199,5402,3337,5.86898e+18,89.3031,899.27,8739,66,67,8477,8311,4194,4095,4609
50062,408,411,31076,18986,5.87811e+18,179.286,3372.73,50062,155,150,49651,49646,49648,49648,49528
53312,74,264,33026,20286,5.87097e+18,160.249,2372.2,53312,111,119,52157,51340,15566,22143,24220
29258,206,256,18013,11245,5.87025e+18,104.175,1794.25,29258,86,86,29002,28952,27282,28262,27022
69200,9,284,42753,26447,5.87019e+18,161.45,2739.64,69200,104,110,33883,0,5067,6682,3600
53771,320,342,33420,20351,5.87974e+18,151.645,3253.04,53771,154,149,53429,53415,53257,53229,51810
79830,152,225,49273,30557,5.87029e+18,132.236,2942.68,79830,90,92,79598,79432,66721,70822,69658
59502,206,274,36799,22703,5.87638e+18,230.096,2871.53,59502,162,159,59074,58650,48019,52664,49595
97027,240,316,59858,37169,5.87263e+18,187.894,3669.19,97027,148,151,96682,96505,86055,90624,84457
56784,76,279,35080,21704,5.87027e+18,133.844,2681.61,56784,104,109,55853,55347,23435,25772,27342
28014,32,215,17236,10778,5.87048e+18,125.953,1606.68,28014,82,88,25027,21192,5294,7642,6415
80096,32,217,49406,30690,5.87006e+18,137.019,2853.62,80096,92,98,70903,57355,13860,21681,19026
51201,136,198,31658,19543,5.86995e+18,105.778,2337.44,51201,84,87,50997,50913,39899,41186,40000
9243,101,114,5697,3546,5.87064e+18,57.0226,846.156,9243,61,62,9129,9129,8818,8958,8857
28953,182,217,17877,11076,5.87005e+18,122.566,1848.68,28953,85,87,28736,28692,28140,28360,28178
65542,223,269,40296,25246,5.87322e+18,205.493,2750.27,65542,140,134,65243,65071,55461,60991,59219
60882,92,381,37638,23244,5.87109e+18,150.62,3103.25,60882,122,117,59863,59106,33139,33539,34563
2578,34,174,1591,987,5.88849e+18,100.291,539.593,2578,57,56,2077,1696,485,737,369
44995,60,266,27881,17114,5.87348e+18,209.012,2328.42,44995,129,131,42876,41291,9856,15686,13748
39653,95,381,24544,15109,5.87144e+18,188.324,2465.36,39653,117,122,38694,37904,10181,15102,13416
34423,59,315,21352,13071,5.87291e+18,121.563,2298.03,34423,102,101,33097,31812,13243,14314,14167
89630,113,288,55213,34417,5.87001e+18,148.089,3107.91,89630,106,108,89150,88657,39376,40339,38749
63449,19,291,39071,24378,5.8709e+18,158.034,2732.63,63449,115,119,47717,32747,8485,12959,8620
72817,243,276,45568,27249,5.89013e+18,219.123,3536.69,72817,203,197,72522,72378,65862,69106,69264
77115,214,323,48319,28796,5.89006e+18,226.491,3809.32,77115,201,206,76650,76211,52161,54485,50112
6597,5,144,4069,2528,5.8696e+18,58.8101,783.11,6597,62,63,1857,0,61,271,179
75383,50,273,46718,28665,5.87343e+18,203.906,3057.85,75383,150,155,71015,67531,15923,23524,17261
77651,150,300,47987,29664,5.87092e+18,193.71,3037.53,77651,116,122,77185,76890,52562,50549,64707
10457,81,110,6507,3950,5.87102e+18,64.8905,806.318,10457,63,65,10347,10346,7775,8014,7208
52726,241,290,32603,20123,5.8712e+18,152.859,2516.3,52726,112,116,52436,52390,45290,49530,44171
34402,176,196,21174,13228,5.87025e+18,104.912,1868.41,34402,82,88,34206,34194,32314,33462,33286
1990,89,95,1220,770,5.86356e+18,41.4874,357.1,1990,41,43,1895,1893,1870,1886,1877
71292,179,240,44052,27240,5.87017e+18,144.339,2632.18,71292,106,112,71015,70907,58077,64376,59956
21678,265,397,13466,8212,5.87571e+18,159.553,2226.05,21678,120,114,21281,21218,18719,18928,16881
31980,145,411,19885,12095,5.87737e+18,158.706,2739.47,31980,133,124,31358,30754,23214,22477,22105
42113,172,260,26279,15834,5.88613e+18,226.131,2600.51,42113,175,167,41458,40608,28609,29182,30845
70296,245,276,43234,27062,5.87262e+18,206.122,2843.51,70296,139,139,70020,69961,62665,66806,67600
54432,10,194,33609,20823,5.87008e+18,121.99,2363.52,54432,85,86,27356,18408,4282,4518,3285
70644,32,315,43633,27011,5.87235e+18,199.124,3125.14,70644,129,127,61541,50166,10810,16666,14346
56921,176,264,34972,21949,5.87155e+18,164.866,2456.05,56921,115,123,56571,56338,39952,38871,41424
52191,168,285,32503,19688,5.8805e+18,223.863,2861.76,52191,166,159,51552,50833,33857,33353,35256
14252,101,121,8770,5482,5.86984e+18,63.2641,1075.81,14252,67,68,14131,14131,12850,13439,12668
85602,300,301,52677,32925,5.87084e+18,196.466,3152.31,85602,118,123,85301,85301,85300,85301,85296
98093,134,281,60451,37642,5.8721e+18,204.781,3447.83,98093,156,165,96975,95907,52223,52156,55485
85415,199,411,52908,32507,5.87793e+18,196.024,4208.75,85415,179,180,84796,84291,59610,58885,52241
46049,223,258,28429,17620,5.87042e+18,124.214,2222.48,46049,89,90,45791,45764,44568,45181,45493
18383,67,376,11397,6986,5.87253e+18,145.942,1903.87,18383,102,101,17378,16647,6414,6796,6106
67302,164,275,41460,25842,5.87624e+18,218.298,2957.37,67302,159,155,66602,65898,43963,39576,42815
63276,60,251,39165,24111,5.87046e+18,152.998,2456.22,63276,110,113,61805,60682,13773,22626,19508
26956,136,189,16616,10340,5.8696e+18,94.1801,1616.09,26956,82,83,26767,26714,22775,23985,21376
37017,209,285,23024,13993,5.87811e+18,209.938,2393.14,37017,141,137,36688,36499,29753,32682,32146
91861,218,274,56727,35134,5.87433e+18,236.142,3453.69,91861,173,165,91440,90985,75469,83204,76383
14480,15,137,8908,5572,5.87003e+18,68.143,1094.16,14480,68,69,9391,5343,2077,2057,1698
53122,158,273,32977,20145,5.87475e+18,220.209,2650.95,53122,142,147,52466,51931,33343,29192,30442
88574,155,257,54788,33786,5.87011e+18,152.674,3274.5,88574,108,107,88179,87751,65216,57821,68251
3781,121,173,2332,1449,5.86923e+18,61.4732,599.692,3781,54,56,3608,3568,3485,3483,3494
68758,99,376,42528,26230,5.87079e+18,157.002,3234.4,68758,116,110,67865,67278,40225,38294,39575
40966,87,173,25251,15715,5.86938e+18,109.461,1927.68,40966,81,88,40627,40390,22712,21297,25948
37981,15,216,23494,14487,5.87003e+18,110.539,2087.07,37981,88,86,23172,13099,5065,4911,4699
12962,120,123,8066,4896,5.87004e+18,64.541,954.9,12962,65,67,12839,12839,12367,12691,12712
87028,221,270,53625,33403,5.8702e+18,148.12,3013.92,87028,104,110,86758,86686,80479,83773,83901
62298,74,203,38400,23898,5.87013e+18,119.911,2502.06,62298,89,94,61738,61323,28618,27815,30400
72717,198,271,45344,27373,5.88586e+18,228.279,3433.57,72717,200,189,72167,71405,56380,60739,60244
71420,143,295,44743,26677,5.89151e+18,231.964,3584.54,71420,193,201,69462,66841,34157,33616,29555
4765,96,117,2932,1833,5.86826e+18,62.8919,594.633,4765,50,54,4648,4630,4150,4414,4239
63278,221,237,38876,24402,5.87066e+18,136.676,2444.6,63278,98,108,63041,63041,62609,62734,62916
63752,4,260,39288,24464,5.87002e+18,147.235,2611.37,63752,98,102,15061,0,21,1522,1060
58689,218,273,36424,22265,5.87431e+18,214.754,2768.69,58689,140,151,58327,58070,48446,53033,47560
92893,19,303,57244,35649,5.8705e+18,159.745,3302.6,92893,120,126,69413,47129,11994,17203,6429
41864,32,263,26016,15848,5.88142e+18,209.128,2494.48,41864,163,156,33684,26754,5643,10160,5564
46319,5092,12213,29188,17131,5.62894e+18,749.316,17215.7,46319,793,298,34106,33704,18853,19483,4449
90030,8,238,55603,34427,5.87021e+18,159.485,3199.82,90030,96,96,37517,0,5214,6487,3302
13883,187,218,8590,5293,5.87118e+18,100.652,1160.93,13883,76,78,13665,13632,12581,13245,12974
1069,57,74,664,405,5.86081e+18,52.1515,252.57,1069,39,39,983,944,726,719,795
43095,56,265,26623,16472,5.87512e+18,187.703,2380.81,43095,146,141,40083,37978,8798,14357,11286
10211,118,151,6294,3917,5.86902e+18,80.6904,900.748,10211,65,69,10060,10015,9218,9096,9298
70913,261,277,44166,26747,5.87891e+18,228.076,3240,70913,184,173,70633,70570,68350,69647,69749
98969,43,279,61158,37811,5.87011e+18,156.491,3443.25,98969,109,110,93200,84930,21417,31800,28582
45741,163,199,28180,17561,5.87e+18,98.8369,2171.29,45741,85,91,45542,45507,39483,42761,38952
89912,37,307,56056,33856,5.88607e+18,243.795,3994.22,89912,206,201,72218,57171,13220,21019,12096
93367,166,227,57649,35718,5.86993e+18,149.8,3173.35,93367,97,102,93123,93019,75128,83758,75967
46190,105,202,28490,17700,5.87005e+18,99.6205,2188.28,46190,85,91,45928,45755,29216,26970,27833
44904,280,285,27982,16922,5.87961e+18,212.815,2665.21,44904,160,151,44619,44603,44419,44505,44449
74184,19,278,45606,28578,5.87152e+18,156.258,2845.65,74184,114,123,56202,38324,7621,13125,5671
69740,62,212,43070,26670,5.8699e+18,130.81,2672.95,69740,90,97,68764,67867,21330,26532,21679
22481,130,185,13837,8644,5.86982e+18,90.5787,1459.98,22481,77,79,22296,22241,21939,21920,21991
89280,21,301,54945,34335,5.87096e+18,221.164,3234.74,89280,124,128,69859,53046,9972,16449,9193
8126,66,182,5009,3117,5.87088e+18,81.9456,915.831,8126,63,66,7865,7720,3853,3942,3643
29073,159,173,17931,11142,5.86978e+18,108.631,1623.4,29073,76,81,28900,28895,28155,28589,28670
75882,24,279,46879,29003,5.87006e+18,169.91,3014.59,75882,101,107,60479,43648,10287,18640,9569
55021,39,209,33900,21121,5.86985e+18,129.297,2333.8,55021,88,92,51560,47192,11979,17503,12845
69821,55,342,43151,26670,5.87036e+18,155.197,3079.35,69821,115,106,67447,64283,20056,24313,25580
13712,92,139,8430,5282,5.87057e+18,96.0779,1046.32,13712,67,68,13536,13449,10281,9819,11299
11091,62,126,6844,4247,5.86969e+18,66.3754,952.701,11091,62,63,10934,10897,6717,6537,5953
66826,63,307,41507,25319,5.8819e+18,234.56,3360.62,66826,183,175,60820,55194,13916,21639,16296
14054,201,245,8732,5322,5.88157e+18,181.841,1420.44,14054,110,107,13797,13709,12040,12922,12560
60667,253,273,37678,22989,5.87675e+18,229.96,2897.65,60667,158,165,60382,60283,55944,58485,58758
48851,237,266,30025,18826,5.87213e+18,188.467,2310.29,48851,116,119,48583,48521,43514,46358,46720
54591,272,315,33749,20842,5.87157e+18,139.36,2730.62,54591,110,109,54276,54249,53732,53846,53406
37924,15,180,23318,14606,5.86988e+18,114.174,1911.4,37924,83,85,24680,14304,4611,4348,4432
14598,134,137,9046,5552,5.87084e+18,69.4972,1105.57,14598,72,71,14461,14461,14461,14461,14457
32903,154,158,20346,12557,5.86927e+18,92.1229,1733.09,32903,77,79,32745,32745,32743,32742,32741
7815,14,76,4849,2966,5.86697e+18,68.1216,662.471,7815,61,63,4755,2801,1066,1482,1355
75881,186,286,47104,28777,5.88014e+18,240.044,3426.93,75881,186,183,75191,74326,52034,55479,56169
38580,102,192,23838,14742,5.86981e+18,95.128,2019.48,38580,84,84,38368,38254,27491,26009,26971
86111,20,224,53233,32878,5.87011e+18,151.705,3076.18,86111,92,96,62564,44716,11562,17493,10778
32197,166,173,19895,12302,5.87071e+18,102.951,1696.99,32197,78,86,32024,32024,31900,31984,32001
63190,260,264,38806,24384,5.87147e+18,180.27,2575.39,63190,124,126,62926,62926,62335,62701,62924
29172,163,411,18183,10989,5.88792e+18,218.582,2597.98,29172,156,161,28437,27876,12912,12962,7682
63183,207,234,38975,24208,5.8701e+18,121.605,2496.77,63183,95,103,62949,62926,58879,59819,60620
49970,85,266,31420,18550,5.89571e+18,214.464,2944.13,49970,185,182,44957,38901,16456,17445,19425
57256,184,314,35384,21872,5.8728e+18,162.595,2919.48,57256,128,124,56849,56603,51020,50143,49727
63333,58,234,39055,24278,5.86988e+18,121.725,2476.76,63333,95,103,62128,60931,15944,23045,24836
98204,139,376,60685,37519,5.87059e+18,173.441,3717.54,98204,116,114,97639,97132,74413,75941,81771
81882,171,397,50706,31176,5.87159e+18,191.743,3712.52,81882,129,125,81349,80980,66459,70419,70790
58901,264,381,36447,22454,5.87121e+18,179.063,3037.85,58901,128,129,58520,58407,46922,49419,46489
66012,1032,3943,41678,24334,5.85539e+18,240.136,7655.61,66012,272,217,62069,61241,13601,33595,1678
50812,131,266,31217,19595,5.87211e+18,159.052,2329.11,50812,110,117,50301,49895,28814,26403,31771
94285,220,246,58080,36205,5.87e+18,133.868,3101.58,94285,103,107,94039,94039,90668,91134,92970
78941,157,232,48685,30256,5.87021e+18,129.097,2914.34,78941,92,97,78701,78592,63146,68372,63864
14173,77,133,8699,5474,5.8708e+18,78.5952,1032.65,14173,68,70,14000,13937,9694,9494,10020
61405,27,258,37852,23553,5.86976e+18,141.337,2538.34,61405,96,101,52027,40308,9365,14022,11416
94274,154,228,58085,36189,5.87025e+18,144.466,3096.31,94274,99,105,94030,93853,77368,79336,83205
85817,304,308,52832,32985,5.87341e+18,206.113,3372.2,85817,154,155,85509,85509,85047,85384,85508
86762,223,279,53318,33444,5.87117e+18,151.549,3065.85,86762,120,127,86474,86398,72417,80521,74458
92072,93,316,57077,34995,5.87858e+18,221.778,3909.73,92072,187,193,88354,84178,33801,42540,29470
78846,96,327,48833,30013,5.87361e+18,193.763,3431.02,78846,142,133,77507,76088,35650,36049,39266
10307,19,127,6333,3974,5.87052e+18,68.435,882.357,10307,62,62,7682,5151,1667,1763,2042
2407,65,129,1490,917,5.86323e+18,51.5206,473.039,2407,53,52,2278,2236,1686,1754,1562
3222,31,107,1983,1239,5.87018e+18,48.7989,460.121,3222,47,50,2922,2650,886,1195,1058
63221,314,327,39218,24003,5.87648e+18,156.147,3303.56,63221,150,146,62894,62884,62593,62770,61822
29795,86,228,18400,11395,5.86967e+18,130.28,1895.81,29795,87,88,29406,29247,16040,14391,15334
63430,98,302,39117,24313,5.8707e+18,159.209,2806.2,63430,107,114,62653,62039,31371,33030,38466
3412,98,190,2131,1281,5.87237e+18,99.8154,645.55,3412,69,62,3172,2982,1899,1763,1437
26572,245,272,16401,10171,5.87351e+18,179.662,1872.77,26572,103,106,26300,26253,25891,26046,25899
48462,6,182,29846,18616,5.87005e+18,119.278,2177.09,48462,82,85,16301,0,1676,2129,2021
68917,221,272,42666,26251,5.87187e+18,197.89,2758.29,68917,135,133,68614,68442,57159,63690,60352
98122,45,318,60801,37321,5.87813e+18,226.921,3984.52,98122,192,191,87572,77805,17765,28454,18095
74303,143,328,46074,28229,5.87576e+18,168.659,3491.43,74303,150,152,73526,72762,53338,56665,56462
79587,37,303,49169,30418,5.87075e+18,161.538,3081.18,79587,115,126,73250,66487,13649,22037,15596
1809,169,187,1146,663,5.89932e+18,117.512,513.791,1809,65,61,1622,1622,1525,1552,1563
77800,102,270,48173,29627,5.8701e+18,244.47,3351.72,77800,138,145,76133,74785,35413,28905,35467
73841,253,272,45683,28158,5.87095e+18,155.372,2783.6,73841,113,123,73569,73567,68636,71383,71261
18063,79,242,11144,6919,5.87198e+18,146.834,1424.21,18063,92,96,17421,16950,7318,8818,9010
51442,70,250,31789,19653,5.86999e+18,138.134,2541.77,51442,100,102,50563,49601,18615,20592,23419
93991,132,246,57881,36110,5.87022e+18,135.884,3105.93,93991,101,108,93693,93452,65675,64292,73938
2314,45,96,1428,886,5.86784e+18,42.93,383.879,2314,44,44,2204,2157,1176,1072,1142
32775,20,258,20287,12488,5.87758e+18,201.519,2103.61,32775,137,135,24306,17926,3578,6843,2824
